is_deleted;account_id;balance_date;closing_available_balance;closing_balance;closing_balance_national;credit_turn_over;credit_turn_over_national;currency;debet_turn_over;debet_turn_over_national;opening_balance;opening_balance_national;rate
references=account_id:accounts(account_number); actionType = ignore_not_empty

0;KZ75125KZT2069100100;2015-05-11;6;6;6;null;null;KZT;94;94;100;100;1
0;KZ75125KZT2069100100;2015-05-12;21;21;21;15;15;KZT;null;null;6;6;1
0;KZ75125KZT2069100100;2015-05-13;9;9;9;null;null;KZT;12;12;21;21;1
0;KZ75125KZT2069100100;2015-05-14;-41;-41;-41;null;null;KZT;50;50;9;9;1
0;KZ75125KZT2069100100;2015-05-15;-78;-78;-78;null;null;KZT;37;37;-41;-41;1
0;KZ75125KZT2069100100;2015-05-16;-155;-155;-155;null;null;KZT;77;77;-78;-78;1
0;KZ75125KZT2069100100;2015-05-17;-222;-222;-222;null;null;KZT;67;67;-155;-155;1
0;KZ75125KZT2069100100;2015-05-18;-205;-205;-205;17;17;KZT;null;null;-222;-222;1
0;KZ75125KZT2069100100;2015-05-19;-287;-287;-287;null;null;KZT;82;82;-205;-205;1
0;KZ75125KZT2069100100;2015-05-20;-261;-261;-261;26;26;KZT;null;null;-287;-287;1
0;KZ75125KZT2069100100;2015-05-21;-177;-177;-177;84;84;KZT;null;null;-261;-261;1
0;KZ75125KZT2069100100;2015-05-22;-78;-78;-78;99;99;KZT;null;null;-177;-177;1
0;KZ75125KZT2069100100;2015-05-23;-34;-34;-34;44;44;KZT;null;null;-78;-78;1
0;KZ75125KZT2069100100;2015-05-24;7;7;7;41;41;KZT;null;null;-34;-34;1
0;KZ75125KZT2069100100;2015-05-25;102;102;102;95;95;KZT;null;null;7;7;1
0;KZ75125KZT2069100100;2015-05-26;86;86;86;null;null;KZT;16;16;102;102;1
0;KZ75125KZT2069100100;2015-05-27;1;1;1;null;null;KZT;85;85;86;86;1
0;KZ75125KZT2069100100;2015-05-28;-18;-18;-18;null;null;KZT;19;19;1;1;1
0;KZ75125KZT2069100100;2015-05-29;-19;-19;-19;null;null;KZT;1;1;-18;-18;1
0;KZ75125KZT2069100100;2015-05-30;-76;-76;-76;null;null;KZT;57;57;-19;-19;1
0;KZ75125KZT2069100100;2015-05-31;-168;-168;-168;null;null;KZT;92;92;-76;-76;1
0;KZ75125KZT2069100100;2015-06-01;-183;-183;-183;null;null;KZT;15;15;-168;-168;1
0;KZ75125KZT2069100100;2015-06-02;-134;-134;-134;49;49;KZT;null;null;-183;-183;1
0;KZ75125KZT2069100100;2015-06-03;-92;-92;-92;42;42;KZT;null;null;-134;-134;1
0;KZ75125KZT2069100100;2015-06-04;-112;-112;-112;null;null;KZT;20;20;-92;-92;1
0;KZ75125KZT2069100100;2015-06-05;-142;-142;-142;null;null;KZT;30;30;-112;-112;1
0;KZ75125KZT2069100100;2015-06-06;-122;-122;-122;20;20;KZT;null;null;-142;-142;1
0;KZ75125KZT2069100100;2015-06-07;-109;-109;-109;13;13;KZT;null;null;-122;-122;1
0;KZ75125KZT2069100100;2015-06-08;-130;-130;-130;null;null;KZT;21;21;-109;-109;1
0;KZ75125KZT2069100100;2015-06-09;-57;-57;-57;73;73;KZT;null;null;-130;-130;1
0;KZ75125KZT2069100100;2015-06-10;25;25;25;82;82;KZT;null;null;-57;-57;1
0;KZ75125KZT2069100100;2015-06-11;93;93;93;68;68;KZT;null;null;25;25;1
0;KZ75125KZT2069100100;2015-06-12;113;113;113;20;20;KZT;null;null;93;93;1
0;KZ75125KZT2069100100;2015-06-13;41;41;41;null;null;KZT;72;72;113;113;1
0;KZ75125KZT2069100100;2015-06-14;82;82;82;41;41;KZT;null;null;41;41;1
0;KZ75125KZT2069100100;2015-06-15;48;48;48;null;null;KZT;34;34;82;82;1
0;KZ75125KZT2069100100;2015-06-16;52;52;52;4;4;KZT;null;null;48;48;1
0;KZ75125KZT2069100100;2015-06-17;138;138;138;86;86;KZT;null;null;52;52;1
0;KZ75125KZT2069100100;2015-06-18;214;214;214;76;76;KZT;null;null;138;138;1
0;KZ75125KZT2069100100;2015-06-19;129;129;129;null;null;KZT;85;85;214;214;1
0;KZ75125KZT2069100100;2015-06-20;56;56;56;null;null;KZT;73;73;129;129;1
0;KZ75125KZT2069100100;2015-06-21;92;92;92;36;36;KZT;null;null;56;56;1
0;KZ75125KZT2069100100;2015-06-22;43;43;43;null;null;KZT;49;49;92;92;1
0;KZ75125KZT2069100100;2015-06-23;-28;-28;-28;null;null;KZT;71;71;43;43;1
0;KZ75125KZT2069100100;2015-06-24;-21;-21;-21;7;7;KZT;null;null;-28;-28;1
0;KZ75125KZT2069100100;2015-06-25;-13;-13;-13;8;8;KZT;null;null;-21;-21;1
0;KZ75125KZT2069100100;2015-06-26;-25;-25;-25;null;null;KZT;12;12;-13;-13;1
0;KZ75125KZT2069100100;2015-06-27;-66;-66;-66;null;null;KZT;41;41;-25;-25;1
0;KZ75125KZT2069100100;2015-06-28;-98;-98;-98;null;null;KZT;32;32;-66;-66;1
0;KZ75125KZT2069100100;2015-06-29;-148;-148;-148;null;null;KZT;50;50;-98;-98;1
0;KZ75125KZT2069100100;2015-06-30;-51;-51;-51;97;97;KZT;null;null;-148;-148;1
0;KZ75125KZT2069100100;2015-07-01;-9;-9;-9;42;42;KZT;null;null;-51;-51;1
0;KZ75125KZT2069100100;2015-07-02;-94;-94;-94;null;null;KZT;85;85;-9;-9;1
0;KZ75125KZT2069100100;2015-07-03;-36;-36;-36;58;58;KZT;null;null;-94;-94;1
0;KZ75125KZT2069100100;2015-07-04;-8;-8;-8;28;28;KZT;null;null;-36;-36;1
0;KZ75125KZT2069100100;2015-07-05;89;89;89;97;97;KZT;null;null;-8;-8;1
0;KZ75125KZT2069100100;2015-07-06;67;67;67;null;null;KZT;22;22;89;89;1
0;KZ75125KZT2069100100;2015-07-07;4;4;4;null;null;KZT;63;63;67;67;1
0;KZ75125KZT2069100100;2015-07-08;-43;-43;-43;null;null;KZT;47;47;4;4;1
0;KZ75125KZT2069100100;2015-07-09;-142;-142;-142;null;null;KZT;99;99;-43;-43;1
0;KZ75125KZT2069100100;2015-07-10;-201;-201;-201;null;null;KZT;59;59;-142;-142;1
0;KZ75125KZT2069100100;2015-07-11;-158;-158;-158;43;43;KZT;null;null;-201;-201;1
0;KZ75125KZT2069100100;2015-07-12;-171;-171;-171;null;null;KZT;13;13;-158;-158;1
0;KZ75125KZT2069100100;2015-07-13;-260;-260;-260;null;null;KZT;89;89;-171;-171;1
0;KZ75125KZT2069100100;2015-07-14;-340;-340;-340;null;null;KZT;80;80;-260;-260;1
0;KZ75125KZT2069100100;2015-07-15;-422;-422;-422;null;null;KZT;82;82;-340;-340;1
0;KZ75125KZT2069100100;2015-07-16;-517;-517;-517;null;null;KZT;95;95;-422;-422;1
0;KZ75125KZT2069100100;2015-07-17;-569;-569;-569;null;null;KZT;52;52;-517;-517;1
0;KZ75125KZT2069100100;2015-07-18;-521;-521;-521;48;48;KZT;null;null;-569;-569;1
0;KZ75125KZT2069100100;2015-07-19;-612;-612;-612;null;null;KZT;91;91;-521;-521;1
0;KZ75125KZT2069100100;2015-07-20;-647;-647;-647;null;null;KZT;35;35;-612;-612;1
0;KZ75125KZT2069100100;2015-07-21;-744;-744;-744;null;null;KZT;97;97;-647;-647;1
0;KZ75125KZT2069100100;2015-07-22;-664;-664;-664;80;80;KZT;null;null;-744;-744;1
0;KZ75125KZT2069100100;2015-07-23;-699;-699;-699;null;null;KZT;35;35;-664;-664;1
0;KZ75125KZT2069100100;2015-07-24;-679;-679;-679;20;20;KZT;null;null;-699;-699;1
0;KZ75125KZT2069100100;2015-07-25;-593;-593;-593;86;86;KZT;null;null;-679;-679;1
0;KZ75125KZT2069100100;2015-07-26;-534;-534;-534;59;59;KZT;null;null;-593;-593;1
0;KZ75125KZT2069100100;2015-07-27;-515;-515;-515;19;19;KZT;null;null;-534;-534;1
0;KZ75125KZT2069100100;2015-07-28;-446;-446;-446;69;69;KZT;null;null;-515;-515;1
0;KZ75125KZT2069100100;2015-07-29;-397;-397;-397;49;49;KZT;null;null;-446;-446;1
0;KZ75125KZT2069100100;2015-07-30;-397;-397;-397;null;null;KZT;0;0;-397;-397;1
0;KZ75125KZT2069100100;2015-07-31;-445;-445;-445;null;null;KZT;48;48;-397;-397;1
0;KZ75125KZT2069100100;2015-08-01;-422;-422;-422;23;23;KZT;null;null;-445;-445;1
0;KZ75125KZT2069100100;2015-08-02;-416;-416;-416;6;6;KZT;null;null;-422;-422;1
0;KZ75125KZT2069100100;2015-08-03;-387;-387;-387;29;29;KZT;null;null;-416;-416;1
0;KZ75125KZT2069100100;2015-08-04;-436;-436;-436;null;null;KZT;49;49;-387;-387;1
0;KZ75125KZT2069100100;2015-08-05;-388;-388;-388;48;48;KZT;null;null;-436;-436;1
0;KZ75125KZT2069100100;2015-08-06;-330;-330;-330;58;58;KZT;null;null;-388;-388;1
0;KZ75125KZT2069100100;2015-08-07;-262;-262;-262;68;68;KZT;null;null;-330;-330;1
0;KZ75125KZT2069100100;2015-08-08;-224;-224;-224;38;38;KZT;null;null;-262;-262;1
0;KZ75125KZT2069100100;2015-08-09;-236;-236;-236;null;null;KZT;12;12;-224;-224;1
0;KZ75125KZT2069100100;2015-08-10;-227;-227;-227;9;9;KZT;null;null;-236;-236;1
0;KZ75125KZT2069100100;2015-08-11;-256;-256;-256;null;null;KZT;29;29;-227;-227;1
0;KZ75125KZT2069100100;2015-08-12;-254;-254;-254;2;2;KZT;null;null;-256;-256;1
0;KZ75125KZT2069100100;2015-08-13;-352;-352;-352;null;null;KZT;98;98;-254;-254;1
0;KZ75125KZT2069100100;2015-08-14;-294;-294;-294;58;58;KZT;null;null;-352;-352;1
0;KZ75125KZT2069100100;2015-08-15;-290;-290;-290;4;4;KZT;null;null;-294;-294;1
0;KZ75125KZT2069100100;2015-08-16;-337;-337;-337;null;null;KZT;47;47;-290;-290;1
0;KZ75125KZT2069100100;2015-08-17;-401;-401;-401;null;null;KZT;64;64;-337;-337;1
0;KZ75125KZT2069100100;2015-08-18;-458;-458;-458;null;null;KZT;57;57;-401;-401;1
0;KZ75125KZT2069100100;2015-08-19;-416;-416;-416;42;42;KZT;null;null;-458;-458;1
0;KZ75125KZT2069100100;2015-08-20;-471;-471;-471;null;null;KZT;55;55;-416;-416;1
0;KZ75125KZT2069100100;2015-08-21;-521;-521;-521;null;null;KZT;50;50;-471;-471;1
0;KZ75125KZT2069100100;2015-08-22;-479;-479;-479;42;42;KZT;null;null;-521;-521;1
0;KZ75125KZT2069100100;2015-08-23;-430;-430;-430;49;49;KZT;null;null;-479;-479;1
0;KZ75125KZT2069100100;2015-08-24;-367;-367;-367;63;63;KZT;null;null;-430;-430;1
0;KZ75125KZT2069100100;2015-08-25;-446;-446;-446;null;null;KZT;79;79;-367;-367;1
0;KZ75125KZT2069100100;2015-08-26;-539;-539;-539;null;null;KZT;93;93;-446;-446;1
0;KZ75125KZT2069100100;2015-08-27;-557;-557;-557;null;null;KZT;18;18;-539;-539;1
0;KZ75125KZT2069100100;2015-08-28;-464;-464;-464;93;93;KZT;null;null;-557;-557;1
0;KZ75125KZT2069100100;2015-08-29;-560;-560;-560;null;null;KZT;96;96;-464;-464;1
0;KZ75125KZT2069100100;2015-08-30;-488;-488;-488;72;72;KZT;null;null;-560;-560;1
0;KZ75125KZT2069100100;2015-08-31;-508;-508;-508;null;null;KZT;20;20;-488;-488;1
0;KZ75125KZT2069100100;2015-09-01;-593;-593;-593;null;null;KZT;85;85;-508;-508;1
0;KZ75125KZT2069100100;2015-09-02;-522;-522;-522;71;71;KZT;null;null;-593;-593;1
0;KZ75125KZT2069100100;2015-09-03;-466;-466;-466;56;56;KZT;null;null;-522;-522;1
0;KZ75125KZT2069100100;2015-09-04;-480;-480;-480;null;null;KZT;14;14;-466;-466;1
0;KZ75125KZT2069100100;2015-09-05;-558;-558;-558;null;null;KZT;78;78;-480;-480;1
0;KZ75125KZT2069100100;2015-09-06;-648;-648;-648;null;null;KZT;90;90;-558;-558;1
0;KZ75125KZT2069100100;2015-09-07;-580;-580;-580;68;68;KZT;null;null;-648;-648;1
0;KZ75125KZT2069100100;2015-09-08;-485;-485;-485;95;95;KZT;null;null;-580;-580;1
0;KZ75125KZT2069100100;2015-09-09;-576;-576;-576;null;null;KZT;91;91;-485;-485;1
0;KZ75125KZT2069100100;2015-09-10;-672;-672;-672;null;null;KZT;96;96;-576;-576;1
0;KZ75125KZT2069100100;2015-09-11;-610;-610;-610;62;62;KZT;null;null;-672;-672;1
0;KZ75125KZT2069100100;2015-09-12;-667;-667;-667;null;null;KZT;57;57;-610;-610;1
0;KZ75125KZT2069100100;2015-09-13;-662;-662;-662;5;5;KZT;null;null;-667;-667;1
0;KZ75125KZT2069100100;2015-09-14;-644;-644;-644;18;18;KZT;null;null;-662;-662;1
0;KZ75125KZT2069100100;2015-09-15;-554;-554;-554;90;90;KZT;null;null;-644;-644;1
0;KZ75125KZT2069100100;2015-09-16;-594;-594;-594;null;null;KZT;40;40;-554;-554;1
0;KZ75125KZT2069100100;2015-09-17;-691;-691;-691;null;null;KZT;97;97;-594;-594;1
0;KZ75125KZT2069100100;2015-09-18;-630;-630;-630;61;61;KZT;null;null;-691;-691;1
0;KZ75125KZT2069100100;2015-09-19;-591;-591;-591;39;39;KZT;null;null;-630;-630;1
0;KZ75125KZT2069100100;2015-09-20;-685;-685;-685;null;null;KZT;94;94;-591;-591;1
0;KZ75125KZT2069100100;2015-09-21;-669;-669;-669;16;16;KZT;null;null;-685;-685;1
0;KZ75125KZT2069100100;2015-09-22;-717;-717;-717;null;null;KZT;48;48;-669;-669;1
0;KZ75125KZT2069100100;2015-09-23;-676;-676;-676;41;41;KZT;null;null;-717;-717;1
0;KZ75125KZT2069100100;2015-09-24;-714;-714;-714;null;null;KZT;38;38;-676;-676;1
0;KZ75125KZT2069100100;2015-09-25;-795;-795;-795;null;null;KZT;81;81;-714;-714;1
0;KZ75125KZT2069100100;2015-09-26;-704;-704;-704;91;91;KZT;null;null;-795;-795;1
0;KZ75125KZT2069100100;2015-09-27;-675;-675;-675;29;29;KZT;null;null;-704;-704;1
0;KZ75125KZT2069100100;2015-09-28;-667;-667;-667;8;8;KZT;null;null;-675;-675;1
0;KZ75125KZT2069100100;2015-09-29;-599;-599;-599;68;68;KZT;null;null;-667;-667;1
0;KZ75125KZT2069100100;2015-09-30;-698;-698;-698;null;null;KZT;99;99;-599;-599;1
0;KZ75125KZT2069100100;2015-10-01;-704;-704;-704;null;null;KZT;6;6;-698;-698;1
0;KZ75125KZT2069100100;2015-10-02;-724;-724;-724;null;null;KZT;20;20;-704;-704;1
0;KZ75125KZT2069100100;2015-10-03;-709;-709;-709;15;15;KZT;null;null;-724;-724;1
0;KZ75125KZT2069100100;2015-10-04;-786;-786;-786;null;null;KZT;77;77;-709;-709;1
0;KZ75125KZT2069100100;2015-10-05;-861;-861;-861;null;null;KZT;75;75;-786;-786;1
0;KZ75125KZT2069100100;2015-10-06;-836;-836;-836;25;25;KZT;null;null;-861;-861;1
0;KZ75125KZT2069100100;2015-10-07;-842;-842;-842;null;null;KZT;6;6;-836;-836;1
0;KZ75125KZT2069100100;2015-10-08;-886;-886;-886;null;null;KZT;44;44;-842;-842;1
0;KZ75125KZT2069100100;2015-10-09;-918;-918;-918;null;null;KZT;32;32;-886;-886;1
0;KZ75125KZT2069100100;2015-10-10;-1006;-1006;-1006;null;null;KZT;88;88;-918;-918;1
0;KZ75125KZT2069100100;2015-10-11;-966;-966;-966;40;40;KZT;null;null;-1006;-1006;1
0;KZ75125KZT2069100100;2015-10-12;-1020;-1020;-1020;null;null;KZT;54;54;-966;-966;1
0;KZ75125KZT2069100100;2015-10-13;-990;-990;-990;30;30;KZT;null;null;-1020;-1020;1
0;KZ75125KZT2069100100;2015-10-14;-934;-934;-934;56;56;KZT;null;null;-990;-990;1
0;KZ75125KZT2069100100;2015-10-15;-934;-934;-934;null;null;KZT;0;0;-934;-934;1
0;KZ75125KZT2069100100;2015-10-16;-944;-944;-944;null;null;KZT;10;10;-934;-934;1
0;KZ75125KZT2069100100;2015-10-17;-874;-874;-874;70;70;KZT;null;null;-944;-944;1
0;KZ75125KZT2069100100;2015-10-18;-824;-824;-824;50;50;KZT;null;null;-874;-874;1
0;KZ75125KZT2069100100;2015-10-19;-821;-821;-821;3;3;KZT;null;null;-824;-824;1
0;KZ75125KZT2069100100;2015-10-20;-752;-752;-752;69;69;KZT;null;null;-821;-821;1
0;KZ75125KZT2069100100;2015-10-21;-689;-689;-689;63;63;KZT;null;null;-752;-752;1
0;KZ75125KZT2069100100;2015-10-22;-623;-623;-623;66;66;KZT;null;null;-689;-689;1
0;KZ75125KZT2069100100;2015-10-23;-658;-658;-658;null;null;KZT;35;35;-623;-623;1
0;KZ75125KZT2069100100;2015-10-24;-580;-580;-580;78;78;KZT;null;null;-658;-658;1
0;KZ75125KZT2069100100;2015-10-25;-658;-658;-658;null;null;KZT;78;78;-580;-580;1
0;KZ75125KZT2069100100;2015-10-26;-690;-690;-690;null;null;KZT;32;32;-658;-658;1
0;KZ75125KZT2069100100;2015-10-27;-615;-615;-615;75;75;KZT;null;null;-690;-690;1
0;KZ75125KZT2069100100;2015-10-28;-665;-665;-665;null;null;KZT;50;50;-615;-615;1
0;KZ75125KZT2069100100;2015-10-29;-616;-616;-616;49;49;KZT;null;null;-665;-665;1
0;KZ75125KZT2069100100;2015-10-30;-582;-582;-582;34;34;KZT;null;null;-616;-616;1
0;KZ75125KZT2069100100;2015-10-31;-672;-672;-672;null;null;KZT;90;90;-582;-582;1
0;KZ75125KZT2069100100;2015-11-01;-666;-666;-666;6;6;KZT;null;null;-672;-672;1
0;KZ75125KZT2069100100;2015-11-02;-705;-705;-705;null;null;KZT;39;39;-666;-666;1
0;KZ75125KZT2069100100;2015-11-03;-706;-706;-706;null;null;KZT;1;1;-705;-705;1
0;KZ75125KZT2069100100;2015-11-04;-629;-629;-629;77;77;KZT;null;null;-706;-706;1
0;KZ75125KZT2069100100;2015-11-05;-572;-572;-572;57;57;KZT;null;null;-629;-629;1
0;KZ75125KZT2069100100;2015-11-06;-516;-516;-516;56;56;KZT;null;null;-572;-572;1
0;KZ75125KZT2069100100;2015-11-07;-557;-557;-557;null;null;KZT;41;41;-516;-516;1
0;KZ75125KZT2069100100;2015-11-08;-538;-538;-538;19;19;KZT;null;null;-557;-557;1
0;KZ75125KZT2069100100;2015-11-09;-509;-509;-509;29;29;KZT;null;null;-538;-538;1
0;KZ75125KZT2069100100;2015-11-10;-426;-426;-426;83;83;KZT;null;null;-509;-509;1
0;KZ75125KZT2069100100;2015-11-11;-356;-356;-356;70;70;KZT;null;null;-426;-426;1
0;KZ75125KZT2069100100;2015-11-12;-405;-405;-405;null;null;KZT;49;49;-356;-356;1
0;KZ75125KZT2069100100;2015-11-13;-503;-503;-503;null;null;KZT;98;98;-405;-405;1
0;KZ75125KZT2069100100;2015-11-14;-597;-597;-597;null;null;KZT;94;94;-503;-503;1
0;KZ75125KZT2069100100;2015-11-15;-636;-636;-636;null;null;KZT;39;39;-597;-597;1
0;KZ75125KZT2069100100;2015-11-16;-577;-577;-577;59;59;KZT;null;null;-636;-636;1
0;KZ75125KZT2069100100;2015-11-17;-638;-638;-638;null;null;KZT;61;61;-577;-577;1
0;KZ75125KZT2069100100;2015-11-18;-541;-541;-541;97;97;KZT;null;null;-638;-638;1
0;KZ75125KZT2069100100;2015-11-19;-463;-463;-463;78;78;KZT;null;null;-541;-541;1
0;KZ75125KZT2069100100;2015-11-20;-488;-488;-488;null;null;KZT;25;25;-463;-463;1
0;KZ75125KZT2069100100;2015-11-21;-537;-537;-537;null;null;KZT;49;49;-488;-488;1
0;KZ75125KZT2069100100;2015-11-22;-440;-440;-440;97;97;KZT;null;null;-537;-537;1
0;KZ75125KZT2069100100;2015-11-23;-397;-397;-397;43;43;KZT;null;null;-440;-440;1
0;KZ75125KZT2069100100;2015-11-24;-360;-360;-360;37;37;KZT;null;null;-397;-397;1
0;KZ75125KZT2069100100;2015-11-25;-456;-456;-456;null;null;KZT;96;96;-360;-360;1
0;KZ75125KZT2069100100;2015-11-26;-528;-528;-528;null;null;KZT;72;72;-456;-456;1
0;KZ75125KZT2069100100;2015-11-27;-471;-471;-471;57;57;KZT;null;null;-528;-528;1
0;KZ75125KZT2069100100;2015-11-28;-552;-552;-552;null;null;KZT;81;81;-471;-471;1
0;KZ75125KZT2069100100;2015-11-29;-465;-465;-465;87;87;KZT;null;null;-552;-552;1
0;KZ75125KZT2069100100;2015-11-30;-456;-456;-456;9;9;KZT;null;null;-465;-465;1
0;KZ75125KZT2069100100;2015-12-01;-403;-403;-403;53;53;KZT;null;null;-456;-456;1
0;KZ75125KZT2069100100;2015-12-02;-333;-333;-333;70;70;KZT;null;null;-403;-403;1
0;KZ75125KZT2069100100;2015-12-03;-295;-295;-295;38;38;KZT;null;null;-333;-333;1
0;KZ75125KZT2069100100;2015-12-04;-320;-320;-320;null;null;KZT;25;25;-295;-295;1
0;KZ75125KZT2069100100;2015-12-05;-279;-279;-279;41;41;KZT;null;null;-320;-320;1
0;KZ75125KZT2069100100;2015-12-06;-272;-272;-272;7;7;KZT;null;null;-279;-279;1
0;KZ75125KZT2069100100;2015-12-07;-247;-247;-247;25;25;KZT;null;null;-272;-272;1
0;KZ75125KZT2069100100;2015-12-08;-176;-176;-176;71;71;KZT;null;null;-247;-247;1
0;KZ75125KZT2069100100;2015-12-09;-105;-105;-105;71;71;KZT;null;null;-176;-176;1
0;KZ75125KZT2069100100;2015-12-10;-96;-96;-96;9;9;KZT;null;null;-105;-105;1
0;KZ75125KZT2069100100;2015-12-11;-31;-31;-31;65;65;KZT;null;null;-96;-96;1
0;KZ75125KZT2069100100;2015-12-12;39;39;39;70;70;KZT;null;null;-31;-31;1
0;KZ75125KZT2069100100;2015-12-13;2;2;2;null;null;KZT;37;37;39;39;1
0;KZ75125KZT2069100100;2015-12-14;-22;-22;-22;null;null;KZT;24;24;2;2;1
0;KZ75125KZT2069100100;2015-12-15;11;11;11;33;33;KZT;null;null;-22;-22;1
0;KZ75125KZT2069100100;2015-12-16;-75;-75;-75;null;null;KZT;86;86;11;11;1
0;KZ75125KZT2069100100;2015-12-17;-157;-157;-157;null;null;KZT;82;82;-75;-75;1
0;KZ75125KZT2069100100;2015-12-18;-85;-85;-85;72;72;KZT;null;null;-157;-157;1
0;KZ75125KZT2069100100;2015-12-19;-162;-162;-162;null;null;KZT;77;77;-85;-85;1
0;KZ75125KZT2069100100;2015-12-20;-255;-255;-255;null;null;KZT;93;93;-162;-162;1
0;KZ75125KZT2069100100;2015-12-21;-270;-270;-270;null;null;KZT;15;15;-255;-255;1
0;KZ75125KZT2069100100;2015-12-22;-286;-286;-286;null;null;KZT;16;16;-270;-270;1
0;KZ75125KZT2069100100;2015-12-23;-192;-192;-192;94;94;KZT;null;null;-286;-286;1
0;KZ75125KZT2069100100;2015-12-24;-120;-120;-120;72;72;KZT;null;null;-192;-192;1
0;KZ75125KZT2069100100;2015-12-25;-39;-39;-39;81;81;KZT;null;null;-120;-120;1
0;KZ75125KZT2069100100;2015-12-26;-91;-91;-91;null;null;KZT;52;52;-39;-39;1
0;KZ75125KZT2069100100;2015-12-27;-102;-102;-102;null;null;KZT;11;11;-91;-91;1
0;KZ75125KZT2069100100;2015-12-28;-12;-12;-12;90;90;KZT;null;null;-102;-102;1
0;KZ75125KZT2069100100;2015-12-29;-88;-88;-88;null;null;KZT;76;76;-12;-12;1
0;KZ75125KZT2069100100;2015-12-30;-87;-87;-87;1;1;KZT;null;null;-88;-88;1
0;KZ75125KZT2069100100;2015-12-31;-153;-153;-153;null;null;KZT;66;66;-87;-87;1
0;KZ75125KZT2069100100;2016-01-01;-213;-213;-213;null;null;KZT;60;60;-153;-153;1
0;KZ75125KZT2069100100;2016-01-02;-158;-158;-158;55;55;KZT;null;null;-213;-213;1
0;KZ75125KZT2069100100;2016-01-03;-251;-251;-251;null;null;KZT;93;93;-158;-158;1
0;KZ75125KZT2069100100;2016-01-04;-178;-178;-178;73;73;KZT;null;null;-251;-251;1
0;KZ75125KZT2069100100;2016-01-05;-162;-162;-162;16;16;KZT;null;null;-178;-178;1
0;KZ75125KZT2069100100;2016-01-06;-114;-114;-114;48;48;KZT;null;null;-162;-162;1
0;KZ75125KZT2069100100;2016-01-07;-22;-22;-22;92;92;KZT;null;null;-114;-114;1
0;KZ75125KZT2069100100;2016-01-08;-57;-57;-57;null;null;KZT;35;35;-22;-22;1
0;KZ75125KZT2069100100;2016-01-09;10;10;10;67;67;KZT;null;null;-57;-57;1
0;KZ75125KZT2069100100;2016-01-10;96;96;96;86;86;KZT;null;null;10;10;1
0;KZ75125KZT2069100100;2016-01-11;-3;-3;-3;null;null;KZT;99;99;96;96;1
0;KZ75125KZT2069100100;2016-01-12;-56;-56;-56;null;null;KZT;53;53;-3;-3;1
0;KZ75125KZT2069100100;2016-01-13;-62;-62;-62;null;null;KZT;6;6;-56;-56;1
0;KZ75125KZT2069100100;2016-01-14;-52;-52;-52;10;10;KZT;null;null;-62;-62;1
0;KZ75125KZT2069100100;2016-01-15;-123;-123;-123;null;null;KZT;71;71;-52;-52;1
0;KZ75125KZT2069100100;2016-01-16;-62;-62;-62;61;61;KZT;null;null;-123;-123;1
0;KZ75125KZT2069100100;2016-01-17;-69;-69;-69;null;null;KZT;7;7;-62;-62;1
0;KZ75125KZT2069100100;2016-01-18;-37;-37;-37;32;32;KZT;null;null;-69;-69;1
0;KZ75125KZT2069100100;2016-01-19;36;36;36;73;73;KZT;null;null;-37;-37;1
0;KZ75125KZT2069100100;2016-01-20;82;82;82;46;46;KZT;null;null;36;36;1
0;KZ75125KZT2069100100;2016-01-21;2;2;2;null;null;KZT;80;80;82;82;1
0;KZ75125KZT2069100100;2016-01-22;-97;-97;-97;null;null;KZT;99;99;2;2;1
0;KZ75125KZT2069100100;2016-01-23;-28;-28;-28;69;69;KZT;null;null;-97;-97;1
0;KZ75125KZT2069100100;2016-01-24;-101;-101;-101;null;null;KZT;73;73;-28;-28;1
0;KZ75125KZT2069100100;2016-01-25;-107;-107;-107;null;null;KZT;6;6;-101;-101;1
0;KZ75125KZT2069100100;2016-01-26;-73;-73;-73;34;34;KZT;null;null;-107;-107;1
0;KZ75125KZT2069100100;2016-01-27;-110;-110;-110;null;null;KZT;37;37;-73;-73;1
0;KZ75125KZT2069100100;2016-01-28;-52;-52;-52;58;58;KZT;null;null;-110;-110;1
0;KZ75125KZT2069100100;2016-01-29;-6;-6;-6;46;46;KZT;null;null;-52;-52;1
0;KZ75125KZT2069100100;2016-01-30;69;69;69;75;75;KZT;null;null;-6;-6;1
0;KZ75125KZT2069100100;2016-01-31;93;93;93;24;24;KZT;null;null;69;69;1
0;KZ75125KZT2069100100;2016-02-01;149;149;149;56;56;KZT;null;null;93;93;1
0;KZ75125KZT2069100100;2016-02-02;209;209;209;60;60;KZT;null;null;149;149;1
0;KZ75125KZT2069100100;2016-02-03;186;186;186;null;null;KZT;23;23;209;209;1
0;KZ75125KZT2069100100;2016-02-04;115;115;115;null;null;KZT;71;71;186;186;1
0;KZ75125KZT2069100100;2016-02-05;198;198;198;83;83;KZT;null;null;115;115;1
0;KZ75125KZT2069100100;2016-02-06;223;223;223;25;25;KZT;null;null;198;198;1
0;KZ75125KZT2069100100;2016-02-07;291;291;291;68;68;KZT;null;null;223;223;1
0;KZ75125KZT2069100100;2016-02-08;227;227;227;null;null;KZT;64;64;291;291;1
0;KZ75125KZT2069100100;2016-02-09;194;194;194;null;null;KZT;33;33;227;227;1
0;KZ75125KZT2069100100;2016-02-10;175;175;175;null;null;KZT;19;19;194;194;1
0;KZ75125KZT2069100100;2016-02-11;147;147;147;null;null;KZT;28;28;175;175;1
0;KZ75125KZT2069100100;2016-02-12;128;128;128;null;null;KZT;19;19;147;147;1
0;KZ75125KZT2069100100;2016-02-13;124;124;124;null;null;KZT;4;4;128;128;1
0;KZ75125KZT2069100100;2016-02-14;195;195;195;71;71;KZT;null;null;124;124;1
0;KZ75125KZT2069100100;2016-02-15;101;101;101;null;null;KZT;94;94;195;195;1
0;KZ75125KZT2069100100;2016-02-16;105;105;105;4;4;KZT;null;null;101;101;1
0;KZ75125KZT2069100100;2016-02-17;97;97;97;null;null;KZT;8;8;105;105;1
0;KZ75125KZT2069100100;2016-02-18;2;2;2;null;null;KZT;95;95;97;97;1
0;KZ75125KZT2069100100;2016-02-19;-76;-76;-76;null;null;KZT;78;78;2;2;1
0;KZ75125KZT2069100100;2016-02-20;-47;-47;-47;29;29;KZT;null;null;-76;-76;1
0;KZ75125KZT2069100100;2016-02-21;-25;-25;-25;22;22;KZT;null;null;-47;-47;1
0;KZ75125KZT2069100100;2016-02-22;-78;-78;-78;null;null;KZT;53;53;-25;-25;1
0;KZ75125KZT2069100100;2016-02-23;-28;-28;-28;50;50;KZT;null;null;-78;-78;1
0;KZ75125KZT2069100100;2016-02-24;-28;-28;-28;null;null;KZT;0;0;-28;-28;1
0;KZ75125KZT2069100100;2016-02-25;-18;-18;-18;10;10;KZT;null;null;-28;-28;1
0;KZ75125KZT2069100100;2016-02-26;8;8;8;26;26;KZT;null;null;-18;-18;1
0;KZ75125KZT2069100100;2016-02-27;104;104;104;96;96;KZT;null;null;8;8;1
0;KZ75125KZT2069100100;2016-02-28;162;162;162;58;58;KZT;null;null;104;104;1
0;KZ75125KZT2069100100;2016-02-29;188;188;188;26;26;KZT;null;null;162;162;1
0;KZ75125KZT2069100100;2016-03-01;283;283;283;95;95;KZT;null;null;188;188;1
0;KZ75125KZT2069100100;2016-03-02;290;290;290;7;7;KZT;null;null;283;283;1
0;KZ75125KZT2069100100;2016-03-03;353;353;353;63;63;KZT;null;null;290;290;1
0;KZ75125KZT2069100100;2016-03-04;273;273;273;null;null;KZT;80;80;353;353;1
0;KZ75125KZT2069100100;2016-03-05;296;296;296;23;23;KZT;null;null;273;273;1
0;KZ75125KZT2069100100;2016-03-06;388;388;388;92;92;KZT;null;null;296;296;1
0;KZ75125KZT2069100100;2016-03-07;310;310;310;null;null;KZT;78;78;388;388;1
0;KZ75125KZT2069100100;2016-03-08;333;333;333;23;23;KZT;null;null;310;310;1
0;KZ75125KZT2069100100;2016-03-09;255;255;255;null;null;KZT;78;78;333;333;1
0;KZ75125KZT2069100100;2016-03-10;344;344;344;89;89;KZT;null;null;255;255;1
0;KZ75125KZT2069100100;2016-03-11;394;394;394;50;50;KZT;null;null;344;344;1
0;KZ75125KZT2069100100;2016-03-12;492;492;492;98;98;KZT;null;null;394;394;1
0;KZ75125KZT2069100100;2016-03-13;481;481;481;null;null;KZT;11;11;492;492;1
0;KZ75125KZT2069100100;2016-03-14;479;479;479;null;null;KZT;2;2;481;481;1
0;KZ75125KZT2069100100;2016-03-15;441;441;441;null;null;KZT;38;38;479;479;1
0;KZ75125KZT2069100100;2016-03-16;374;374;374;null;null;KZT;67;67;441;441;1
0;KZ75125KZT2069100100;2016-03-17;437;437;437;63;63;KZT;null;null;374;374;1
0;KZ75125KZT2069100100;2016-03-18;534;534;534;97;97;KZT;null;null;437;437;1
0;KZ75125KZT2069100100;2016-03-19;467;467;467;null;null;KZT;67;67;534;534;1
0;KZ75125KZT2069100100;2016-03-20;464;464;464;null;null;KZT;3;3;467;467;1
0;KZ75125KZT2069100100;2016-03-21;476;476;476;12;12;KZT;null;null;464;464;1
0;KZ75125KZT2069100100;2016-03-22;508;508;508;32;32;KZT;null;null;476;476;1
0;KZ75125KZT2069100100;2016-03-23;587;587;587;79;79;KZT;null;null;508;508;1
0;KZ75125KZT2069100100;2016-03-24;570;570;570;null;null;KZT;17;17;587;587;1
0;KZ75125KZT2069100100;2016-03-25;510;510;510;null;null;KZT;60;60;570;570;1
0;KZ75125KZT2069100100;2016-03-26;418;418;418;null;null;KZT;92;92;510;510;1
0;KZ75125KZT2069100100;2016-03-27;416;416;416;null;null;KZT;2;2;418;418;1
0;KZ75125KZT2069100100;2016-03-28;400;400;400;null;null;KZT;16;16;416;416;1
0;KZ75125KZT2069100100;2016-03-29;427;427;427;27;27;KZT;null;null;400;400;1
0;KZ75125KZT2069100100;2016-03-30;419;419;419;null;null;KZT;8;8;427;427;1
0;KZ75125KZT2069100100;2016-03-31;335;335;335;null;null;KZT;84;84;419;419;1
0;KZ75125KZT2069100100;2016-04-01;400;400;400;65;65;KZT;null;null;335;335;1
0;KZ75125KZT2069100100;2016-04-02;315;315;315;null;null;KZT;85;85;400;400;1
0;KZ75125KZT2069100100;2016-04-03;327;327;327;12;12;KZT;null;null;315;315;1
0;KZ75125KZT2069100100;2016-04-04;380;380;380;53;53;KZT;null;null;327;327;1
0;KZ75125KZT2069100100;2016-04-05;467;467;467;87;87;KZT;null;null;380;380;1
0;KZ75125KZT2069100100;2016-04-06;470;470;470;3;3;KZT;null;null;467;467;1
0;KZ75125KZT2069100100;2016-04-07;535;535;535;65;65;KZT;null;null;470;470;1
0;KZ75125KZT2069100100;2016-04-08;630;630;630;95;95;KZT;null;null;535;535;1
0;KZ75125KZT2069100100;2016-04-09;598;598;598;null;null;KZT;32;32;630;630;1
0;KZ75125KZT2069100100;2016-04-10;683;683;683;85;85;KZT;null;null;598;598;1
0;KZ75125KZT2069100100;2016-04-11;601;601;601;null;null;KZT;82;82;683;683;1
0;KZ75125KZT2069100100;2016-04-12;507;507;507;null;null;KZT;94;94;601;601;1
0;KZ75125KZT2069100100;2016-04-13;574;574;574;67;67;KZT;null;null;507;507;1
0;KZ75125KZT2069100100;2016-04-14;547;547;547;null;null;KZT;27;27;574;574;1
0;KZ75125KZT2069100100;2016-04-15;594;594;594;47;47;KZT;null;null;547;547;1
0;KZ75125KZT2069100100;2016-04-16;498;498;498;null;null;KZT;96;96;594;594;1
0;KZ75125KZT2069100100;2016-04-17;565;565;565;67;67;KZT;null;null;498;498;1
0;KZ75125KZT2069100100;2016-04-18;475;475;475;null;null;KZT;90;90;565;565;1
0;KZ75125KZT2069100100;2016-04-19;412;412;412;null;null;KZT;63;63;475;475;1
0;KZ75125KZT2069100100;2016-04-20;395;395;395;null;null;KZT;17;17;412;412;1
0;KZ75125KZT2069100100;2016-04-21;342;342;342;null;null;KZT;53;53;395;395;1
0;KZ75125KZT2069100100;2016-04-22;434;434;434;92;92;KZT;null;null;342;342;1
0;KZ75125KZT2069100100;2016-04-23;448;448;448;14;14;KZT;null;null;434;434;1
0;KZ75125KZT2069100100;2016-04-24;460;460;460;12;12;KZT;null;null;448;448;1
0;KZ75125KZT2069100100;2016-04-25;401;401;401;null;null;KZT;59;59;460;460;1
0;KZ75125KZT2069100100;2016-04-26;389;389;389;null;null;KZT;12;12;401;401;1
0;KZ75125KZT2069100100;2016-04-27;380;380;380;null;null;KZT;9;9;389;389;1
0;KZ75125KZT2069100100;2016-04-28;475;475;475;95;95;KZT;null;null;380;380;1
0;KZ75125KZT2069100100;2016-04-29;429;429;429;null;null;KZT;46;46;475;475;1
0;KZ75125KZT2069100100;2016-04-30;359;359;359;null;null;KZT;70;70;429;429;1
0;KZ75125KZT2069100100;2016-05-01;361;361;361;2;2;KZT;null;null;359;359;1
0;KZ75125KZT2069100100;2016-05-02;325;325;325;null;null;KZT;36;36;361;361;1
0;KZ75125KZT2069100100;2016-05-03;263;263;263;null;null;KZT;62;62;325;325;1
0;KZ75125KZT2069100100;2016-05-04;189;189;189;null;null;KZT;74;74;263;263;1
0;KZ75125KZT2069100100;2016-05-05;234;234;234;45;45;KZT;null;null;189;189;1
0;KZ75125KZT2069100100;2016-05-06;146;146;146;null;null;KZT;88;88;234;234;1
0;KZ75125KZT2069100100;2016-05-07;227;227;227;81;81;KZT;null;null;146;146;1
0;KZ75125KZT2069100100;2016-05-08;275;275;275;48;48;KZT;null;null;227;227;1
0;KZ75125KZT2069100100;2016-05-09;315;315;315;40;40;KZT;null;null;275;275;1
0;KZ75125KZT2069100100;2016-05-10;221;221;221;null;null;KZT;94;94;315;315;1
0;KZ75125KZT2069100100;2016-05-11;317;317;317;96;96;KZT;null;null;221;221;1
0;KZ75125KZT2069100100;2016-05-12;396;396;396;79;79;KZT;null;null;317;317;1
0;KZ75125KZT2069100100;2016-05-13;495;495;495;99;99;KZT;null;null;396;396;1
0;KZ75125KZT2069100100;2016-05-14;505;505;505;10;10;KZT;null;null;495;495;1
0;KZ75125KZT2069100100;2016-05-15;447;447;447;null;null;KZT;58;58;505;505;1
0;KZ75125KZT2069100100;2016-05-16;468;468;468;21;21;KZT;null;null;447;447;1
0;KZ75125KZT2069100100;2016-05-17;442;442;442;null;null;KZT;26;26;468;468;1
0;KZ75125KZT2069100100;2016-05-18;426;426;426;null;null;KZT;16;16;442;442;1
0;KZ75125KZT2069100100;2016-05-19;382;382;382;null;null;KZT;44;44;426;426;1
0;KZ75125KZT2069100100;2016-05-20;395;395;395;13;13;KZT;null;null;382;382;1
0;KZ75125KZT2069100100;2016-05-21;457;457;457;62;62;KZT;null;null;395;395;1
0;KZ75125KZT2069100100;2016-05-22;472;472;472;15;15;KZT;null;null;457;457;1
0;KZ75125KZT2069100100;2016-05-23;464;464;464;null;null;KZT;8;8;472;472;1
0;KZ75125KZT2069100100;2016-05-24;475;475;475;11;11;KZT;null;null;464;464;1
0;KZ75125KZT2069100100;2016-05-25;419;419;419;null;null;KZT;56;56;475;475;1
0;KZ75125KZT2069100100;2016-05-26;429;429;429;10;10;KZT;null;null;419;419;1
0;KZ75125KZT2069100100;2016-05-27;332;332;332;null;null;KZT;97;97;429;429;1
0;KZ75125KZT2069100100;2016-05-28;304;304;304;null;null;KZT;28;28;332;332;1
0;KZ75125KZT2069100100;2016-05-29;225;225;225;null;null;KZT;79;79;304;304;1
0;KZ75125KZT2069100100;2016-05-30;191;191;191;null;null;KZT;34;34;225;225;1
0;KZ75125KZT2069100100;2016-05-31;131;131;131;null;null;KZT;60;60;191;191;1
0;KZ75125KZT2069100100;2016-06-01;98;98;98;null;null;KZT;33;33;131;131;1
0;KZ75125KZT2069100100;2016-06-02;153;153;153;55;55;KZT;null;null;98;98;1
0;KZ75125KZT2069100100;2016-06-03;238;238;238;85;85;KZT;null;null;153;153;1
0;KZ75125KZT2069100100;2016-06-04;201;201;201;null;null;KZT;37;37;238;238;1
0;KZ75125KZT2069100100;2016-06-05;106;106;106;null;null;KZT;95;95;201;201;1
0;KZ75125KZT2069100100;2016-06-06;145;145;145;39;39;KZT;null;null;106;106;1
0;KZ75125KZT2069100100;2016-06-07;65;65;65;null;null;KZT;80;80;145;145;1
0;KZ75125KZT2069100100;2016-06-08;152;152;152;87;87;KZT;null;null;65;65;1
0;KZ75125KZT2069100100;2016-06-09;224;224;224;72;72;KZT;null;null;152;152;1
0;KZ75125KZT2069100100;2016-06-10;215;215;215;null;null;KZT;9;9;224;224;1
0;KZ75125KZT2069100100;2016-06-11;119;119;119;null;null;KZT;96;96;215;215;1
0;KZ75125KZT2069100100;2016-06-12;55;55;55;null;null;KZT;64;64;119;119;1
0;KZ75125KZT2069100100;2016-06-13;84;84;84;29;29;KZT;null;null;55;55;1
0;KZ75125KZT2069100100;2016-06-14;-9;-9;-9;null;null;KZT;93;93;84;84;1
0;KZ75125KZT2069100100;2016-06-15;51;51;51;60;60;KZT;null;null;-9;-9;1
0;KZ75125KZT2069100100;2016-06-16;-32;-32;-32;null;null;KZT;83;83;51;51;1
0;KZ75125KZT2069100100;2016-06-17;-43;-43;-43;null;null;KZT;11;11;-32;-32;1
0;KZ75125KZT2069100100;2016-06-18;-33;-33;-33;10;10;KZT;null;null;-43;-43;1
0;KZ75125KZT2069100100;2016-06-19;-110;-110;-110;null;null;KZT;77;77;-33;-33;1
0;KZ75125KZT2069100100;2016-06-20;-21;-21;-21;89;89;KZT;null;null;-110;-110;1
0;KZ75125KZT2069100100;2016-06-21;-32;-32;-32;null;null;KZT;11;11;-21;-21;1
0;KZ75125KZT2069100100;2016-06-22;12;12;12;44;44;KZT;null;null;-32;-32;1
0;KZ75125KZT2069100100;2016-06-23;3;3;3;null;null;KZT;9;9;12;12;1
0;KZ75125KZT2069100100;2016-06-24;-6;-6;-6;null;null;KZT;9;9;3;3;1
0;KZ75125KZT2069100100;2016-06-25;34;34;34;40;40;KZT;null;null;-6;-6;1
0;KZ75125KZT2069100100;2016-06-26;27;27;27;null;null;KZT;7;7;34;34;1
0;KZ75125KZT2069100100;2016-06-27;53;53;53;26;26;KZT;null;null;27;27;1
0;KZ75125KZT2069100100;2016-06-28;85;85;85;32;32;KZT;null;null;53;53;1
0;KZ75125KZT2069100100;2016-06-29;151;151;151;66;66;KZT;null;null;85;85;1
0;KZ75125KZT2069100100;2016-06-30;74;74;74;null;null;KZT;77;77;151;151;1
0;KZ75125KZT2069100100;2016-07-01;50;50;50;null;null;KZT;24;24;74;74;1
0;KZ75125KZT2069100100;2016-07-02;20;20;20;null;null;KZT;30;30;50;50;1
0;KZ75125KZT2069100100;2016-07-03;-15;-15;-15;null;null;KZT;35;35;20;20;1
0;KZ75125KZT2069100100;2016-07-04;39;39;39;54;54;KZT;null;null;-15;-15;1
0;KZ75125KZT2069100100;2016-07-05;-1;-1;-1;null;null;KZT;40;40;39;39;1
0;KZ75125KZT2069100100;2016-07-06;46;46;46;47;47;KZT;null;null;-1;-1;1
0;KZ75125KZT2069100100;2016-07-07;91;91;91;45;45;KZT;null;null;46;46;1
0;KZ75125KZT2069100100;2016-07-08;164;164;164;73;73;KZT;null;null;91;91;1
0;KZ75125KZT2069100100;2016-07-09;116;116;116;null;null;KZT;48;48;164;164;1
0;KZ75125KZT2069100100;2016-07-10;25;25;25;null;null;KZT;91;91;116;116;1
0;KZ75125KZT2069100100;2016-07-11;121;121;121;96;96;KZT;null;null;25;25;1
0;KZ75125KZT2069100100;2016-07-12;38;38;38;null;null;KZT;83;83;121;121;1
0;KZ75125KZT2069100100;2016-07-13;94;94;94;56;56;KZT;null;null;38;38;1
0;KZ75125KZT2069100100;2016-07-14;132;132;132;38;38;KZT;null;null;94;94;1
0;KZ75125KZT2069100100;2016-07-15;178;178;178;46;46;KZT;null;null;132;132;1
0;KZ75125KZT2069100100;2016-07-16;133;133;133;null;null;KZT;45;45;178;178;1
0;KZ75125KZT2069100100;2016-07-17;62;62;62;null;null;KZT;71;71;133;133;1
0;KZ75125KZT2069100100;2016-07-18;-3;-3;-3;null;null;KZT;65;65;62;62;1
0;KZ75125KZT2069100100;2016-07-19;-99;-99;-99;null;null;KZT;96;96;-3;-3;1
0;KZ75125KZT2069100100;2016-07-20;-70;-70;-70;29;29;KZT;null;null;-99;-99;1
0;KZ75125KZT2069100100;2016-07-21;-13;-13;-13;57;57;KZT;null;null;-70;-70;1
0;KZ75125KZT2069100100;2016-07-22;45;45;45;58;58;KZT;null;null;-13;-13;1
0;KZ75125KZT2069100100;2016-07-23;85;85;85;40;40;KZT;null;null;45;45;1
0;KZ75125KZT2069100100;2016-07-24;157;157;157;72;72;KZT;null;null;85;85;1
0;KZ75125KZT2069100100;2016-07-25;74;74;74;null;null;KZT;83;83;157;157;1
0;KZ75125KZT2069100100;2016-07-26;66;66;66;null;null;KZT;8;8;74;74;1
0;KZ75125KZT2069100100;2016-07-27;93;93;93;27;27;KZT;null;null;66;66;1
0;KZ75125KZT2069100100;2016-07-28;42;42;42;null;null;KZT;51;51;93;93;1
0;KZ75125KZT2069100100;2016-07-29;69;69;69;27;27;KZT;null;null;42;42;1
0;KZ75125KZT2069100100;2016-07-30;129;129;129;60;60;KZT;null;null;69;69;1
0;KZ75125KZT2069100100;2016-07-31;218;218;218;89;89;KZT;null;null;129;129;1
0;KZ75125KZT2069100100;2016-08-01;196;196;196;null;null;KZT;22;22;218;218;1
0;KZ75125KZT2069100100;2016-08-02;109;109;109;null;null;KZT;87;87;196;196;1
0;KZ75125KZT2069100100;2016-08-03;126;126;126;17;17;KZT;null;null;109;109;1
0;KZ75125KZT2069100100;2016-08-04;193;193;193;67;67;KZT;null;null;126;126;1
0;KZ75125KZT2069100100;2016-08-05;260;260;260;67;67;KZT;null;null;193;193;1
0;KZ75125KZT2069100100;2016-08-06;318;318;318;58;58;KZT;null;null;260;260;1
0;KZ75125KZT2069100100;2016-08-07;277;277;277;null;null;KZT;41;41;318;318;1
0;KZ75125KZT2069100100;2016-08-08;353;353;353;76;76;KZT;null;null;277;277;1
0;KZ75125KZT2069100100;2016-08-09;335;335;335;null;null;KZT;18;18;353;353;1
0;KZ75125KZT2069100100;2016-08-10;289;289;289;null;null;KZT;46;46;335;335;1
0;KZ75125KZT2069100100;2016-08-11;259;259;259;null;null;KZT;30;30;289;289;1
0;KZ75125KZT2069100100;2016-08-12;209;209;209;null;null;KZT;50;50;259;259;1
0;KZ75125KZT2069100100;2016-08-13;296;296;296;87;87;KZT;null;null;209;209;1
0;KZ75125KZT2069100100;2016-08-14;394;394;394;98;98;KZT;null;null;296;296;1
0;KZ75125KZT2069100100;2016-08-15;322;322;322;null;null;KZT;72;72;394;394;1
0;KZ75125KZT2069100100;2016-08-16;225;225;225;null;null;KZT;97;97;322;322;1
0;KZ75125KZT2069100100;2016-08-17;315;315;315;90;90;KZT;null;null;225;225;1
0;KZ75125KZT2069100100;2016-08-18;220;220;220;null;null;KZT;95;95;315;315;1
0;KZ75125KZT2069100100;2016-08-19;173;173;173;null;null;KZT;47;47;220;220;1
0;KZ75125KZT2069100100;2016-08-20;194;194;194;21;21;KZT;null;null;173;173;1
0;KZ75125KZT2069100100;2016-08-21;243;243;243;49;49;KZT;null;null;194;194;1
0;KZ75125KZT2069100100;2016-08-22;305;305;305;62;62;KZT;null;null;243;243;1
0;KZ75125KZT2069100100;2016-08-23;243;243;243;null;null;KZT;62;62;305;305;1
0;KZ75125KZT2069100100;2016-08-24;252;252;252;9;9;KZT;null;null;243;243;1
0;KZ75125KZT2069100100;2016-08-25;345;345;345;93;93;KZT;null;null;252;252;1
0;KZ75125KZT2069100100;2016-08-26;406;406;406;61;61;KZT;null;null;345;345;1
0;KZ75125KZT2069100100;2016-08-27;369;369;369;null;null;KZT;37;37;406;406;1
0;KZ75125KZT2069100100;2016-08-28;385;385;385;16;16;KZT;null;null;369;369;1
0;KZ75125KZT2069100100;2016-08-29;375;375;375;null;null;KZT;10;10;385;385;1
0;KZ75125KZT2069100100;2016-08-30;446;446;446;71;71;KZT;null;null;375;375;1
0;KZ75125KZT2069100100;2016-08-31;394;394;394;null;null;KZT;52;52;446;446;1
0;KZ75125KZT2069100100;2016-09-01;296;296;296;null;null;KZT;98;98;394;394;1
0;KZ75125KZT2069100100;2016-09-02;320;320;320;24;24;KZT;null;null;296;296;1
0;KZ75125KZT2069100100;2016-09-03;266;266;266;null;null;KZT;54;54;320;320;1
0;KZ75125KZT2069100100;2016-09-04;266;266;266;null;null;KZT;0;0;266;266;1
0;KZ75125KZT2069100100;2016-09-05;188;188;188;null;null;KZT;78;78;266;266;1
0;KZ75125KZT2069100100;2016-09-06;143;143;143;null;null;KZT;45;45;188;188;1
0;KZ75125KZT2069100100;2016-09-07;45;45;45;null;null;KZT;98;98;143;143;1
0;KZ75125KZT2069100100;2016-09-08;90;90;90;45;45;KZT;null;null;45;45;1
0;KZ75125KZT2069100100;2016-09-09;111;111;111;21;21;KZT;null;null;90;90;1
0;KZ75125KZT2069100100;2016-09-10;135;135;135;24;24;KZT;null;null;111;111;1
0;KZ75125KZT2069100100;2016-09-11;211;211;211;76;76;KZT;null;null;135;135;1
0;KZ75125KZT2069100100;2016-09-12;189;189;189;null;null;KZT;22;22;211;211;1
0;KZ75125KZT2069100100;2016-09-13;198;198;198;9;9;KZT;null;null;189;189;1
0;KZ75125KZT2069100100;2016-09-14;142;142;142;null;null;KZT;56;56;198;198;1
0;KZ75125KZT2069100100;2016-09-15;92;92;92;null;null;KZT;50;50;142;142;1
0;KZ75125KZT2069100100;2016-09-16;169;169;169;77;77;KZT;null;null;92;92;1
0;KZ75125KZT2069100100;2016-09-17;130;130;130;null;null;KZT;39;39;169;169;1
0;KZ75125KZT2069100100;2016-09-18;41;41;41;null;null;KZT;89;89;130;130;1
0;KZ75125KZT2069100100;2016-09-19;32;32;32;null;null;KZT;9;9;41;41;1
0;KZ75125KZT2069100100;2016-09-20;92;92;92;60;60;KZT;null;null;32;32;1
0;KZ75125KZT2069100100;2016-09-21;31;31;31;null;null;KZT;61;61;92;92;1
0;KZ75125KZT2069100100;2016-09-22;28;28;28;null;null;KZT;3;3;31;31;1
0;KZ75125KZT2069100100;2016-09-23;-50;-50;-50;null;null;KZT;78;78;28;28;1
0;KZ75125KZT2069100100;2016-09-24;-106;-106;-106;null;null;KZT;56;56;-50;-50;1
0;KZ75125KZT2069100100;2016-09-25;-51;-51;-51;55;55;KZT;null;null;-106;-106;1
0;KZ75125KZT2069100100;2016-09-26;-44;-44;-44;7;7;KZT;null;null;-51;-51;1
0;KZ75125KZT2069100100;2016-09-27;-44;-44;-44;null;null;KZT;0;0;-44;-44;1
0;KZ75125KZT2069100100;2016-09-28;-68;-68;-68;null;null;KZT;24;24;-44;-44;1
0;KZ75125KZT2069100100;2016-09-29;-151;-151;-151;null;null;KZT;83;83;-68;-68;1
0;KZ75125KZT2069100100;2016-09-30;-248;-248;-248;null;null;KZT;97;97;-151;-151;1
0;KZ75125KZT2069100100;2016-10-01;-197;-197;-197;51;51;KZT;null;null;-248;-248;1
0;KZ75125KZT2069100100;2016-10-02;-203;-203;-203;null;null;KZT;6;6;-197;-197;1
0;KZ75125KZT2069100100;2016-10-03;-145;-145;-145;58;58;KZT;null;null;-203;-203;1
0;KZ75125KZT2069100100;2016-10-04;-129;-129;-129;16;16;KZT;null;null;-145;-145;1
0;KZ75125KZT2069100100;2016-10-05;-88;-88;-88;41;41;KZT;null;null;-129;-129;1
0;KZ75125KZT2069100100;2016-10-06;-65;-65;-65;23;23;KZT;null;null;-88;-88;1
0;KZ75125KZT2069100100;2016-10-07;-153;-153;-153;null;null;KZT;88;88;-65;-65;1
0;KZ75125KZT2069100100;2016-10-08;-96;-96;-96;57;57;KZT;null;null;-153;-153;1
0;KZ75125KZT2069100100;2016-10-09;-149;-149;-149;null;null;KZT;53;53;-96;-96;1
0;KZ75125KZT2069100100;2016-10-10;-133;-133;-133;16;16;KZT;null;null;-149;-149;1
0;KZ75125KZT2069100100;2016-10-11;-121;-121;-121;12;12;KZT;null;null;-133;-133;1
0;KZ75125KZT2069100100;2016-10-12;-122;-122;-122;null;null;KZT;1;1;-121;-121;1
0;KZ75125KZT2069100100;2016-10-13;-77;-77;-77;45;45;KZT;null;null;-122;-122;1
0;KZ75125KZT2069100100;2016-10-14;-53;-53;-53;24;24;KZT;null;null;-77;-77;1
0;KZ75125KZT2069100100;2016-10-15;-56;-56;-56;null;null;KZT;3;3;-53;-53;1
0;KZ75125KZT2069100100;2016-10-16;-18;-18;-18;38;38;KZT;null;null;-56;-56;1
0;KZ75125KZT2069100100;2016-10-17;-48;-48;-48;null;null;KZT;30;30;-18;-18;1
0;KZ75125KZT2069100100;2016-10-18;-90;-90;-90;null;null;KZT;42;42;-48;-48;1
0;KZ75125KZT2069100100;2016-10-19;-144;-144;-144;null;null;KZT;54;54;-90;-90;1
0;KZ75125KZT2069100100;2016-10-20;-197;-197;-197;null;null;KZT;53;53;-144;-144;1
0;KZ75125KZT2069100100;2016-10-21;-159;-159;-159;38;38;KZT;null;null;-197;-197;1
0;KZ75125KZT2069100100;2016-10-22;-112;-112;-112;47;47;KZT;null;null;-159;-159;1
0;KZ75125KZT2069100100;2016-10-23;-167;-167;-167;null;null;KZT;55;55;-112;-112;1
0;KZ75125KZT2069100100;2016-10-24;-256;-256;-256;null;null;KZT;89;89;-167;-167;1
0;KZ75125KZT2069100100;2016-10-25;-301;-301;-301;null;null;KZT;45;45;-256;-256;1
0;KZ75125KZT2069100100;2016-10-26;-367;-367;-367;null;null;KZT;66;66;-301;-301;1
0;KZ75125KZT2069100100;2016-10-27;-366;-366;-366;1;1;KZT;null;null;-367;-367;1
0;KZ75125KZT2069100100;2016-10-28;-464;-464;-464;null;null;KZT;98;98;-366;-366;1
0;KZ75125KZT2069100100;2016-10-29;-545;-545;-545;null;null;KZT;81;81;-464;-464;1
0;KZ75125KZT2069100100;2016-10-30;-515;-515;-515;30;30;KZT;null;null;-545;-545;1
0;KZ75125KZT2069100100;2016-10-31;-492;-492;-492;23;23;KZT;null;null;-515;-515;1
0;KZ75125KZT2069100100;2016-11-01;-536;-536;-536;null;null;KZT;44;44;-492;-492;1
0;KZ75125KZT2069100100;2016-11-02;-462;-462;-462;74;74;KZT;null;null;-536;-536;1
0;KZ75125KZT2069100100;2016-11-03;-459;-459;-459;3;3;KZT;null;null;-462;-462;1
0;KZ75125KZT2069100100;2016-11-04;-545;-545;-545;null;null;KZT;86;86;-459;-459;1
0;KZ75125KZT2069100100;2016-11-05;-529;-529;-529;16;16;KZT;null;null;-545;-545;1
0;KZ75125KZT2069100100;2016-11-06;-493;-493;-493;36;36;KZT;null;null;-529;-529;1
0;KZ75125KZT2069100100;2016-11-07;-428;-428;-428;65;65;KZT;null;null;-493;-493;1
0;KZ75125KZT2069100100;2016-11-08;-395;-395;-395;33;33;KZT;null;null;-428;-428;1
0;KZ75125KZT2069100100;2016-11-09;-463;-463;-463;null;null;KZT;68;68;-395;-395;1
0;KZ75125KZT2069100100;2016-11-10;-521;-521;-521;null;null;KZT;58;58;-463;-463;1
0;KZ75125KZT2069100100;2016-11-11;-556;-556;-556;null;null;KZT;35;35;-521;-521;1
0;KZ75125KZT2069100100;2016-11-12;-598;-598;-598;null;null;KZT;42;42;-556;-556;1
0;KZ75125KZT2069100100;2016-11-13;-593;-593;-593;5;5;KZT;null;null;-598;-598;1
0;KZ75125KZT2069100100;2016-11-14;-592;-592;-592;1;1;KZT;null;null;-593;-593;1
0;KZ75125KZT2069100100;2016-11-15;-649;-649;-649;null;null;KZT;57;57;-592;-592;1
0;KZ75125KZT2069100100;2016-11-16;-626;-626;-626;23;23;KZT;null;null;-649;-649;1
0;KZ75125KZT2069100100;2016-11-17;-592;-592;-592;34;34;KZT;null;null;-626;-626;1
0;KZ75125KZT2069100100;2016-11-18;-521;-521;-521;71;71;KZT;null;null;-592;-592;1
0;KZ75125KZT2069100100;2016-11-19;-609;-609;-609;null;null;KZT;88;88;-521;-521;1
0;KZ75125KZT2069100100;2016-11-20;-633;-633;-633;null;null;KZT;24;24;-609;-609;1
0;KZ75125KZT2069100100;2016-11-21;-549;-549;-549;84;84;KZT;null;null;-633;-633;1
0;KZ75125KZT2069100100;2016-11-22;-603;-603;-603;null;null;KZT;54;54;-549;-549;1
0;KZ75125KZT2069100100;2016-11-23;-582;-582;-582;21;21;KZT;null;null;-603;-603;1
0;KZ75125KZT2069100100;2016-11-24;-553;-553;-553;29;29;KZT;null;null;-582;-582;1
0;KZ75125KZT2069100100;2016-11-25;-548;-548;-548;5;5;KZT;null;null;-553;-553;1
0;KZ75125KZT2069100100;2016-11-26;-461;-461;-461;87;87;KZT;null;null;-548;-548;1
0;KZ75125KZT2069100100;2016-11-27;-509;-509;-509;null;null;KZT;48;48;-461;-461;1
0;KZ75125KZT2069100100;2016-11-28;-593;-593;-593;null;null;KZT;84;84;-509;-509;1
0;KZ75125KZT2069100100;2016-11-29;-648;-648;-648;null;null;KZT;55;55;-593;-593;1
0;KZ75125KZT2069100100;2016-11-30;-671;-671;-671;null;null;KZT;23;23;-648;-648;1
0;KZ75125KZT2069100100;2016-12-01;-727;-727;-727;null;null;KZT;56;56;-671;-671;1
0;KZ75125KZT2069100100;2016-12-02;-738;-738;-738;null;null;KZT;11;11;-727;-727;1
0;KZ75125KZT2069100100;2016-12-03;-718;-718;-718;20;20;KZT;null;null;-738;-738;1
0;KZ75125KZT2069100100;2016-12-04;-620;-620;-620;98;98;KZT;null;null;-718;-718;1
0;KZ75125KZT2069100100;2016-12-05;-523;-523;-523;97;97;KZT;null;null;-620;-620;1
0;KZ75125KZT2069100100;2016-12-06;-557;-557;-557;null;null;KZT;34;34;-523;-523;1
0;KZ75125KZT2069100100;2016-12-07;-600;-600;-600;null;null;KZT;43;43;-557;-557;1
0;KZ75125KZT2069100100;2016-12-08;-651;-651;-651;null;null;KZT;51;51;-600;-600;1
0;KZ75125KZT2069100100;2016-12-09;-718;-718;-718;null;null;KZT;67;67;-651;-651;1
0;KZ75125KZT2069100100;2016-12-10;-681;-681;-681;37;37;KZT;null;null;-718;-718;1
0;KZ75125KZT2069100100;2016-12-11;-756;-756;-756;null;null;KZT;75;75;-681;-681;1
0;KZ75125KZT2069100100;2016-12-12;-835;-835;-835;null;null;KZT;79;79;-756;-756;1
0;KZ75125KZT2069100100;2016-12-13;-800;-800;-800;35;35;KZT;null;null;-835;-835;1
0;KZ75125KZT2069100100;2016-12-14;-754;-754;-754;46;46;KZT;null;null;-800;-800;1
0;KZ75125KZT2069100100;2016-12-15;-689;-689;-689;65;65;KZT;null;null;-754;-754;1
0;KZ75125KZT2069100100;2016-12-16;-720;-720;-720;null;null;KZT;31;31;-689;-689;1
0;KZ75125KZT2069100100;2016-12-17;-808;-808;-808;null;null;KZT;88;88;-720;-720;1
0;KZ75125KZT2069100100;2016-12-18;-725;-725;-725;83;83;KZT;null;null;-808;-808;1
0;KZ75125KZT2069100100;2016-12-19;-771;-771;-771;null;null;KZT;46;46;-725;-725;1
0;KZ75125KZT2069100100;2016-12-20;-691;-691;-691;80;80;KZT;null;null;-771;-771;1
0;KZ75125KZT2069100100;2016-12-21;-592;-592;-592;99;99;KZT;null;null;-691;-691;1
0;KZ75125KZT2069100100;2016-12-22;-559;-559;-559;33;33;KZT;null;null;-592;-592;1
0;KZ75125KZT2069100100;2016-12-23;-508;-508;-508;51;51;KZT;null;null;-559;-559;1
0;KZ75125KZT2069100100;2016-12-24;-418;-418;-418;90;90;KZT;null;null;-508;-508;1
0;KZ75125KZT2069100100;2016-12-25;-338;-338;-338;80;80;KZT;null;null;-418;-418;1
0;KZ75125KZT2069100100;2016-12-26;-392;-392;-392;null;null;KZT;54;54;-338;-338;1
0;KZ75125KZT2069100100;2016-12-27;-415;-415;-415;null;null;KZT;23;23;-392;-392;1
0;KZ75125KZT2069100100;2016-12-28;-439;-439;-439;null;null;KZT;24;24;-415;-415;1
0;KZ75125KZT2069100100;2016-12-29;-409;-409;-409;30;30;KZT;null;null;-439;-439;1
0;KZ75125KZT2069100100;2016-12-30;-455;-455;-455;null;null;KZT;46;46;-409;-409;1
0;KZ75125KZT2069100100;2016-12-31;-531;-531;-531;null;null;KZT;76;76;-455;-455;1
0;KZ75125KZT2069100100;2017-01-01;-629;-629;-629;null;null;KZT;98;98;-531;-531;1
0;KZ75125KZT2069100100;2017-01-02;-559;-559;-559;70;70;KZT;null;null;-629;-629;1
0;KZ75125KZT2069100100;2017-01-03;-524;-524;-524;35;35;KZT;null;null;-559;-559;1
0;KZ75125KZT2069100100;2017-01-04;-583;-583;-583;null;null;KZT;59;59;-524;-524;1
0;KZ75125KZT2069100100;2017-01-05;-564;-564;-564;19;19;KZT;null;null;-583;-583;1
0;KZ75125KZT2069100100;2017-01-06;-592;-592;-592;null;null;KZT;28;28;-564;-564;1
0;KZ75125KZT2069100100;2017-01-07;-530;-530;-530;62;62;KZT;null;null;-592;-592;1
0;KZ75125KZT2069100100;2017-01-08;-493;-493;-493;37;37;KZT;null;null;-530;-530;1
0;KZ75125KZT2069100100;2017-01-09;-550;-550;-550;null;null;KZT;57;57;-493;-493;1
0;KZ75125KZT2069100100;2017-01-10;-510;-510;-510;40;40;KZT;null;null;-550;-550;1
0;KZ75125KZT2069100100;2017-01-11;-509;-509;-509;1;1;KZT;null;null;-510;-510;1
0;KZ75125KZT2069100100;2017-01-12;-489;-489;-489;20;20;KZT;null;null;-509;-509;1
0;KZ75125KZT2069100100;2017-01-13;-437;-437;-437;52;52;KZT;null;null;-489;-489;1
0;KZ75125KZT2069100100;2017-01-14;-476;-476;-476;null;null;KZT;39;39;-437;-437;1
0;KZ75125KZT2069100100;2017-01-15;-551;-551;-551;null;null;KZT;75;75;-476;-476;1
0;KZ75125KZT2069100100;2017-01-16;-568;-568;-568;null;null;KZT;17;17;-551;-551;1
0;KZ75125KZT2069100100;2017-01-17;-577;-577;-577;null;null;KZT;9;9;-568;-568;1
0;KZ75125KZT2069100100;2017-01-18;-665;-665;-665;null;null;KZT;88;88;-577;-577;1
0;KZ75125KZT2069100100;2017-01-19;-664;-664;-664;1;1;KZT;null;null;-665;-665;1
0;KZ75125KZT2069100100;2017-01-20;-597;-597;-597;67;67;KZT;null;null;-664;-664;1
0;KZ75125KZT2069100100;2017-01-21;-651;-651;-651;null;null;KZT;54;54;-597;-597;1
0;KZ75125KZT2069100100;2017-01-22;-569;-569;-569;82;82;KZT;null;null;-651;-651;1
0;KZ75125KZT2069100100;2017-01-23;-476;-476;-476;93;93;KZT;null;null;-569;-569;1
0;KZ75125KZT2069100100;2017-01-24;-540;-540;-540;null;null;KZT;64;64;-476;-476;1
0;KZ75125KZT2069100100;2017-01-25;-508;-508;-508;32;32;KZT;null;null;-540;-540;1
0;KZ75125KZT2069100100;2017-01-26;-484;-484;-484;24;24;KZT;null;null;-508;-508;1
0;KZ75125KZT2069100100;2017-01-27;-574;-574;-574;null;null;KZT;90;90;-484;-484;1
0;KZ75125KZT2069100100;2017-01-28;-611;-611;-611;null;null;KZT;37;37;-574;-574;1
0;KZ75125KZT2069100100;2017-01-29;-635;-635;-635;null;null;KZT;24;24;-611;-611;1
0;KZ75125KZT2069100100;2017-01-30;-593;-593;-593;42;42;KZT;null;null;-635;-635;1
0;KZ75125KZT2069100100;2017-01-31;-545;-545;-545;48;48;KZT;null;null;-593;-593;1
0;KZ75125KZT2069100100;2017-02-01;-507;-507;-507;38;38;KZT;null;null;-545;-545;1
0;KZ75125KZT2069100100;2017-02-02;-460;-460;-460;47;47;KZT;null;null;-507;-507;1
0;KZ75125KZT2069100100;2017-02-03;-365;-365;-365;95;95;KZT;null;null;-460;-460;1
0;KZ75125KZT2069100100;2017-02-04;-331;-331;-331;34;34;KZT;null;null;-365;-365;1
0;KZ75125KZT2069100100;2017-02-05;-375;-375;-375;null;null;KZT;44;44;-331;-331;1
0;KZ75125KZT2069100100;2017-02-06;-371;-371;-371;4;4;KZT;null;null;-375;-375;1
0;KZ75125KZT2069100100;2017-02-07;-359;-359;-359;12;12;KZT;null;null;-371;-371;1
0;KZ75125KZT2069100100;2017-02-08;-307;-307;-307;52;52;KZT;null;null;-359;-359;1
0;KZ75125KZT2069100100;2017-02-09;-325;-325;-325;null;null;KZT;18;18;-307;-307;1
0;KZ75125KZT2069100100;2017-02-10;-371;-371;-371;null;null;KZT;46;46;-325;-325;1
0;KZ75125KZT2069100100;2017-02-11;-305;-305;-305;66;66;KZT;null;null;-371;-371;1
0;KZ75125KZT2069100100;2017-02-12;-334;-334;-334;null;null;KZT;29;29;-305;-305;1
0;KZ75125KZT2069100100;2017-02-13;-419;-419;-419;null;null;KZT;85;85;-334;-334;1
0;KZ75125KZT2069100100;2017-02-14;-478;-478;-478;null;null;KZT;59;59;-419;-419;1
0;KZ75125KZT2069100100;2017-02-15;-452;-452;-452;26;26;KZT;null;null;-478;-478;1
0;KZ75125KZT2069100100;2017-02-16;-358;-358;-358;94;94;KZT;null;null;-452;-452;1
0;KZ75125KZT2069100100;2017-02-17;-301;-301;-301;57;57;KZT;null;null;-358;-358;1
0;KZ75125KZT2069100100;2017-02-18;-390;-390;-390;null;null;KZT;89;89;-301;-301;1
0;KZ75125KZT2069100100;2017-02-19;-357;-357;-357;33;33;KZT;null;null;-390;-390;1
0;KZ75125KZT2069100100;2017-02-20;-334;-334;-334;23;23;KZT;null;null;-357;-357;1
0;KZ75125KZT2069100100;2017-02-21;-283;-283;-283;51;51;KZT;null;null;-334;-334;1
0;KZ75125KZT2069100100;2017-02-22;-283;-283;-283;null;null;KZT;0;0;-283;-283;1
0;KZ75125KZT2069100100;2017-02-23;-222;-222;-222;61;61;KZT;null;null;-283;-283;1
0;KZ75125KZT2069100100;2017-02-24;-123;-123;-123;99;99;KZT;null;null;-222;-222;1
0;KZ75125KZT2069100100;2017-02-25;-156;-156;-156;null;null;KZT;33;33;-123;-123;1
0;KZ75125KZT2069100100;2017-02-26;-111;-111;-111;45;45;KZT;null;null;-156;-156;1
0;KZ75125KZT2069100100;2017-02-27;-183;-183;-183;null;null;KZT;72;72;-111;-111;1
0;KZ75125KZT2069100100;2017-02-28;-223;-223;-223;null;null;KZT;40;40;-183;-183;1
0;KZ75125KZT2069100100;2017-03-01;-272;-272;-272;null;null;KZT;49;49;-223;-223;1
0;KZ75125KZT2069100100;2017-03-02;-301;-301;-301;null;null;KZT;29;29;-272;-272;1
0;KZ75125KZT2069100100;2017-03-03;-307;-307;-307;null;null;KZT;6;6;-301;-301;1
0;KZ75125KZT2069100100;2017-03-04;-263;-263;-263;44;44;KZT;null;null;-307;-307;1
0;KZ75125KZT2069100100;2017-03-05;-328;-328;-328;null;null;KZT;65;65;-263;-263;1
0;KZ75125KZT2069100100;2017-03-06;-229;-229;-229;99;99;KZT;null;null;-328;-328;1
0;KZ75125KZT2069100100;2017-03-07;-177;-177;-177;52;52;KZT;null;null;-229;-229;1
0;KZ75125KZT2069100100;2017-03-08;-156;-156;-156;21;21;KZT;null;null;-177;-177;1
0;KZ75125KZT2069100100;2017-03-09;-185;-185;-185;null;null;KZT;29;29;-156;-156;1
0;KZ75125KZT2069100100;2017-03-10;-106;-106;-106;79;79;KZT;null;null;-185;-185;1
0;KZ75125KZT2069100100;2017-03-11;-50;-50;-50;56;56;KZT;null;null;-106;-106;1
0;KZ75125KZT2069100100;2017-03-12;30;30;30;80;80;KZT;null;null;-50;-50;1
0;KZ75125KZT2069100100;2017-03-13;-35;-35;-35;null;null;KZT;65;65;30;30;1
0;KZ75125KZT2069100100;2017-03-14;-88;-88;-88;null;null;KZT;53;53;-35;-35;1
0;KZ75125KZT2069100100;2017-03-15;-51;-51;-51;37;37;KZT;null;null;-88;-88;1
0;KZ75125KZT2069100100;2017-03-16;-20;-20;-20;31;31;KZT;null;null;-51;-51;1
0;KZ75125KZT2069100100;2017-03-17;-69;-69;-69;null;null;KZT;49;49;-20;-20;1
0;KZ75125KZT2069100100;2017-03-18;-104;-104;-104;null;null;KZT;35;35;-69;-69;1
0;KZ75125KZT2069100100;2017-03-19;-5;-5;-5;99;99;KZT;null;null;-104;-104;1
0;KZ75125KZT2069100100;2017-03-20;-14;-14;-14;null;null;KZT;9;9;-5;-5;1
0;KZ75125KZT2069100100;2017-03-21;44;44;44;58;58;KZT;null;null;-14;-14;1
0;KZ75125KZT2069100100;2017-03-22;38;38;38;null;null;KZT;6;6;44;44;1
0;KZ75125KZT2069100100;2017-03-23;66;66;66;28;28;KZT;null;null;38;38;1
0;KZ75125KZT2069100100;2017-03-24;128;128;128;62;62;KZT;null;null;66;66;1
0;KZ75125KZT2069100100;2017-03-25;101;101;101;null;null;KZT;27;27;128;128;1
0;KZ75125KZT2069100100;2017-03-26;171;171;171;70;70;KZT;null;null;101;101;1
0;KZ75125KZT2069100100;2017-03-27;135;135;135;null;null;KZT;36;36;171;171;1
0;KZ75125KZT2069100100;2017-03-28;125;125;125;null;null;KZT;10;10;135;135;1
0;KZ75125KZT2069100100;2017-03-29;71;71;71;null;null;KZT;54;54;125;125;1
0;KZ75125KZT2069100100;2017-03-30;-13;-13;-13;null;null;KZT;84;84;71;71;1
0;KZ75125KZT2069100100;2017-03-31;-55;-55;-55;null;null;KZT;42;42;-13;-13;1
0;KZ75125KZT2069100100;2017-04-01;-86;-86;-86;null;null;KZT;31;31;-55;-55;1
0;KZ75125KZT2069100100;2017-04-02;-50;-50;-50;36;36;KZT;null;null;-86;-86;1
0;KZ75125KZT2069100100;2017-04-03;-9;-9;-9;41;41;KZT;null;null;-50;-50;1
0;KZ75125KZT2069100100;2017-04-04;-30;-30;-30;null;null;KZT;21;21;-9;-9;1
0;KZ75125KZT2069100100;2017-04-05;60;60;60;90;90;KZT;null;null;-30;-30;1
0;KZ75125KZT2069100100;2017-04-06;61;61;61;1;1;KZT;null;null;60;60;1
0;KZ75125KZT2069100100;2017-04-07;86;86;86;25;25;KZT;null;null;61;61;1
0;KZ75125KZT2069100100;2017-04-08;98;98;98;12;12;KZT;null;null;86;86;1
0;KZ75125KZT2069100100;2017-04-09;61;61;61;null;null;KZT;37;37;98;98;1
0;KZ75125KZT2069100100;2017-04-10;141;141;141;80;80;KZT;null;null;61;61;1
0;KZ75125KZT2069100100;2017-04-11;103;103;103;null;null;KZT;38;38;141;141;1
0;KZ75125KZT2069100100;2017-04-12;106;106;106;3;3;KZT;null;null;103;103;1
0;KZ75125KZT2069100100;2017-04-13;52;52;52;null;null;KZT;54;54;106;106;1
0;KZ75125KZT2069100100;2017-04-14;69;69;69;17;17;KZT;null;null;52;52;1
0;KZ75125KZT2069100100;2017-04-15;104;104;104;35;35;KZT;null;null;69;69;1
0;KZ75125KZT2069100100;2017-04-16;180;180;180;76;76;KZT;null;null;104;104;1
0;KZ75125KZT2069100100;2017-04-17;233;233;233;53;53;KZT;null;null;180;180;1
0;KZ75125KZT2069100100;2017-04-18;137;137;137;null;null;KZT;96;96;233;233;1
0;KZ75125KZT2069100100;2017-04-19;223;223;223;86;86;KZT;null;null;137;137;1
0;KZ75125KZT2069100100;2017-04-20;124;124;124;null;null;KZT;99;99;223;223;1
0;KZ75125KZT2069100100;2017-04-21;209;209;209;85;85;KZT;null;null;124;124;1
0;KZ75125KZT2069100100;2017-04-22;236;236;236;27;27;KZT;null;null;209;209;1
0;KZ75125KZT2069100100;2017-04-23;246;246;246;10;10;KZT;null;null;236;236;1
0;KZ75125KZT2069100100;2017-04-24;167;167;167;null;null;KZT;79;79;246;246;1
0;KZ75125KZT2069100100;2017-04-25;166;166;166;null;null;KZT;1;1;167;167;1
0;KZ75125KZT2069100100;2017-04-26;109;109;109;null;null;KZT;57;57;166;166;1
0;KZ75125KZT2069100100;2017-04-27;145;145;145;36;36;KZT;null;null;109;109;1
0;KZ75125KZT2069100100;2017-04-28;121;121;121;null;null;KZT;24;24;145;145;1
0;KZ75125KZT2069100100;2017-04-29;93;93;93;null;null;KZT;28;28;121;121;1
0;KZ75125KZT2069100100;2017-04-30;11;11;11;null;null;KZT;82;82;93;93;1
0;KZ75125KZT2069100100;2017-05-01;-10;-10;-10;null;null;KZT;21;21;11;11;1
0;KZ75125KZT2069100100;2017-05-02;28;28;28;38;38;KZT;null;null;-10;-10;1
0;KZ75125KZT2069100100;2017-05-03;122;122;122;94;94;KZT;null;null;28;28;1
0;KZ75125KZT2069100100;2017-05-04;57;57;57;null;null;KZT;65;65;122;122;1
0;KZ75125KZT2069100100;2017-05-05;49;49;49;null;null;KZT;8;8;57;57;1
0;KZ75125KZT2069100100;2017-05-06;26;26;26;null;null;KZT;23;23;49;49;1
0;KZ75125KZT2069100100;2017-05-07;101;101;101;75;75;KZT;null;null;26;26;1
0;KZ75125KZT2069100100;2017-05-08;9;9;9;null;null;KZT;92;92;101;101;1
0;KZ75125KZT2069100100;2017-05-09;91;91;91;82;82;KZT;null;null;9;9;1
0;KZ75125KZT2069100100;2017-05-10;105;105;105;14;14;KZT;null;null;91;91;1
0;KZ75125KZT2069100100;2017-05-11;87;87;87;null;null;KZT;18;18;105;105;1
0;KZ75125KZT2069100100;2017-05-12;23;23;23;null;null;KZT;64;64;87;87;1
0;KZ75125KZT2069100100;2017-05-13;-29;-29;-29;null;null;KZT;52;52;23;23;1
0;KZ75125KZT2069100100;2017-05-14;48;48;48;77;77;KZT;null;null;-29;-29;1
0;KZ75125KZT2069100100;2017-05-15;144;144;144;96;96;KZT;null;null;48;48;1
0;KZ75125KZT2069100100;2017-05-16;77;77;77;null;null;KZT;67;67;144;144;1
0;KZ75125KZT2069100100;2017-05-17;128;128;128;51;51;KZT;null;null;77;77;1
0;KZ75125KZT2069100100;2017-05-18;120;120;120;null;null;KZT;8;8;128;128;1
0;KZ75125KZT2069100100;2017-05-19;183;183;183;63;63;KZT;null;null;120;120;1
0;KZ75125KZT2069100100;2017-05-20;199;199;199;16;16;KZT;null;null;183;183;1
0;KZ75125KZT2069100100;2017-05-21;291;291;291;92;92;KZT;null;null;199;199;1
0;KZ75125KZT2069100100;2017-05-22;221;221;221;null;null;KZT;70;70;291;291;1
0;KZ75125KZT2069100100;2017-05-23;276;276;276;55;55;KZT;null;null;221;221;1
0;KZ75125KZT2069100100;2017-05-24;232;232;232;null;null;KZT;44;44;276;276;1
0;KZ75125KZT2069100100;2017-05-25;201;201;201;null;null;KZT;31;31;232;232;1
0;KZ75125KZT2069100100;2017-05-26;256;256;256;55;55;KZT;null;null;201;201;1
0;KZ75125KZT2069100100;2017-05-27;269;269;269;13;13;KZT;null;null;256;256;1
0;KZ75125KZT2069100100;2017-05-28;278;278;278;9;9;KZT;null;null;269;269;1
0;KZ75125KZT2069100100;2017-05-29;322;322;322;44;44;KZT;null;null;278;278;1
0;KZ75125KZT2069100100;2017-05-30;259;259;259;null;null;KZT;63;63;322;322;1
0;KZ75125KZT2069100100;2017-05-31;309;309;309;50;50;KZT;null;null;259;259;1
0;KZ75125KZT2069100100;2017-06-01;212;212;212;null;null;KZT;97;97;309;309;1
0;KZ75125KZT2069100100;2017-06-02;224;224;224;12;12;KZT;null;null;212;212;1
0;KZ75125KZT2069100100;2017-06-03;200;200;200;null;null;KZT;24;24;224;224;1
0;KZ75125KZT2069100100;2017-06-04;291;291;291;91;91;KZT;null;null;200;200;1
0;KZ75125KZT2069100100;2017-06-05;227;227;227;null;null;KZT;64;64;291;291;1
0;KZ75125KZT2069100100;2017-06-06;141;141;141;null;null;KZT;86;86;227;227;1
0;KZ75125KZT2069100100;2017-06-07;46;46;46;null;null;KZT;95;95;141;141;1
0;KZ75125KZT2069100100;2017-06-08;-37;-37;-37;null;null;KZT;83;83;46;46;1
0;KZ75125KZT2069100100;2017-06-09;-48;-48;-48;null;null;KZT;11;11;-37;-37;1
0;KZ75125KZT2069100100;2017-06-10;22;22;22;70;70;KZT;null;null;-48;-48;1
0;KZ75125KZT2069100100;2017-06-11;61;61;61;39;39;KZT;null;null;22;22;1
0;KZ75125KZT2069100100;2017-06-12;85;85;85;24;24;KZT;null;null;61;61;1
0;KZ75125RUB2069100101;2015-05-11;70;70;35;null;null;RUB;30;15;100;50;0.5
0;KZ75125RUB2069100101;2015-05-12;116;116;58;46;23;RUB;null;null;70;35;0.5
0;KZ75125RUB2069100101;2015-05-13;56;56;28;null;null;RUB;60;30;116;58;0.5
0;KZ75125RUB2069100101;2015-05-14;143;143;71.5;87;43.5;RUB;null;null;56;28;0.5
0;KZ75125RUB2069100101;2015-05-15;157;157;78.5;14;7;RUB;null;null;143;71.5;0.5
0;KZ75125RUB2069100101;2015-05-16;116;116;58;null;null;RUB;41;20.5;157;78.5;0.5
0;KZ75125RUB2069100101;2015-05-17;41;41;20.5;null;null;RUB;75;37.5;116;58;0.5
0;KZ75125RUB2069100101;2015-05-18;122;122;61;81;40.5;RUB;null;null;41;20.5;0.5
0;KZ75125RUB2069100101;2015-05-19;201;201;100.5;79;39.5;RUB;null;null;122;61;0.5
0;KZ75125RUB2069100101;2015-05-20;294;294;147;93;46.5;RUB;null;null;201;100.5;0.5
0;KZ75125RUB2069100101;2015-05-21;336;336;168;42;21;RUB;null;null;294;147;0.5
0;KZ75125RUB2069100101;2015-05-22;332;332;166;null;null;RUB;4;2;336;168;0.5
0;KZ75125RUB2069100101;2015-05-23;420;420;210;88;44;RUB;null;null;332;166;0.5
0;KZ75125RUB2069100101;2015-05-24;504;504;252;84;42;RUB;null;null;420;210;0.5
0;KZ75125RUB2069100101;2015-05-25;514;514;257;10;5;RUB;null;null;504;252;0.5
0;KZ75125RUB2069100101;2015-05-26;511;511;255.5;null;null;RUB;3;1.5;514;257;0.5
0;KZ75125RUB2069100101;2015-05-27;419;419;209.5;null;null;RUB;92;46;511;255.5;0.5
0;KZ75125RUB2069100101;2015-05-28;384;384;192;null;null;RUB;35;17.5;419;209.5;0.5
0;KZ75125RUB2069100101;2015-05-29;354;354;177;null;null;RUB;30;15;384;192;0.5
0;KZ75125RUB2069100101;2015-05-30;356;356;178;2;1;RUB;null;null;354;177;0.5
0;KZ75125RUB2069100101;2015-05-31;428;428;214;72;36;RUB;null;null;356;178;0.5
0;KZ75125RUB2069100101;2015-06-01;412;412;206;null;null;RUB;16;8;428;214;0.5
0;KZ75125RUB2069100101;2015-06-02;429;429;214.5;17;8.5;RUB;null;null;412;206;0.5
0;KZ75125RUB2069100101;2015-06-03;495;495;247.5;66;33;RUB;null;null;429;214.5;0.5
0;KZ75125RUB2069100101;2015-06-04;410;410;205;null;null;RUB;85;42.5;495;247.5;0.5
0;KZ75125RUB2069100101;2015-06-05;432;432;216;22;11;RUB;null;null;410;205;0.5
0;KZ75125RUB2069100101;2015-06-06;343;343;171.5;null;null;RUB;89;44.5;432;216;0.5
0;KZ75125RUB2069100101;2015-06-07;442;442;221;99;49.5;RUB;null;null;343;171.5;0.5
0;KZ75125RUB2069100101;2015-06-08;536;536;268;94;47;RUB;null;null;442;221;0.5
0;KZ75125RUB2069100101;2015-06-09;569;569;284.5;33;16.5;RUB;null;null;536;268;0.5
0;KZ75125RUB2069100101;2015-06-10;619;619;309.5;50;25;RUB;null;null;569;284.5;0.5
0;KZ75125RUB2069100101;2015-06-11;599;599;299.5;null;null;RUB;20;10;619;309.5;0.5
0;KZ75125RUB2069100101;2015-06-12;664;664;332;65;32.5;RUB;null;null;599;299.5;0.5
0;KZ75125RUB2069100101;2015-06-13;632;632;316;null;null;RUB;32;16;664;332;0.5
0;KZ75125RUB2069100101;2015-06-14;680;680;340;48;24;RUB;null;null;632;316;0.5
0;KZ75125RUB2069100101;2015-06-15;754;754;377;74;37;RUB;null;null;680;340;0.5
0;KZ75125RUB2069100101;2015-06-16;684;684;342;null;null;RUB;70;35;754;377;0.5
0;KZ75125RUB2069100101;2015-06-17;602;602;301;null;null;RUB;82;41;684;342;0.5
0;KZ75125RUB2069100101;2015-06-18;640;640;320;38;19;RUB;null;null;602;301;0.5
0;KZ75125RUB2069100101;2015-06-19;641;641;320.5;1;0.5;RUB;null;null;640;320;0.5
0;KZ75125RUB2069100101;2015-06-20;609;609;304.5;null;null;RUB;32;16;641;320.5;0.5
0;KZ75125RUB2069100101;2015-06-21;680;680;340;71;35.5;RUB;null;null;609;304.5;0.5
0;KZ75125RUB2069100101;2015-06-22;752;752;376;72;36;RUB;null;null;680;340;0.5
0;KZ75125RUB2069100101;2015-06-23;831;831;415.5;79;39.5;RUB;null;null;752;376;0.5
0;KZ75125RUB2069100101;2015-06-24;929;929;464.5;98;49;RUB;null;null;831;415.5;0.5
0;KZ75125RUB2069100101;2015-06-25;950;950;475;21;10.5;RUB;null;null;929;464.5;0.5
0;KZ75125RUB2069100101;2015-06-26;902;902;451;null;null;RUB;48;24;950;475;0.5
0;KZ75125RUB2069100101;2015-06-27;883;883;441.5;null;null;RUB;19;9.5;902;451;0.5
0;KZ75125RUB2069100101;2015-06-28;932;932;466;49;24.5;RUB;null;null;883;441.5;0.5
0;KZ75125RUB2069100101;2015-06-29;835;835;417.5;null;null;RUB;97;48.5;932;466;0.5
0;KZ75125RUB2069100101;2015-06-30;810;810;405;null;null;RUB;25;12.5;835;417.5;0.5
0;KZ75125RUB2069100101;2015-07-01;812;812;406;2;1;RUB;null;null;810;405;0.5
0;KZ75125RUB2069100101;2015-07-02;792;792;396;null;null;RUB;20;10;812;406;0.5
0;KZ75125RUB2069100101;2015-07-03;821;821;410.5;29;14.5;RUB;null;null;792;396;0.5
0;KZ75125RUB2069100101;2015-07-04;900;900;450;79;39.5;RUB;null;null;821;410.5;0.5
0;KZ75125RUB2069100101;2015-07-05;985;985;492.5;85;42.5;RUB;null;null;900;450;0.5
0;KZ75125RUB2069100101;2015-07-06;976;976;488;null;null;RUB;9;4.5;985;492.5;0.5
0;KZ75125RUB2069100101;2015-07-07;895;895;447.5;null;null;RUB;81;40.5;976;488;0.5
0;KZ75125RUB2069100101;2015-07-08;824;824;412;null;null;RUB;71;35.5;895;447.5;0.5
0;KZ75125RUB2069100101;2015-07-09;891;891;445.5;67;33.5;RUB;null;null;824;412;0.5
0;KZ75125RUB2069100101;2015-07-10;963;963;481.5;72;36;RUB;null;null;891;445.5;0.5
0;KZ75125RUB2069100101;2015-07-11;981;981;490.5;18;9;RUB;null;null;963;481.5;0.5
0;KZ75125RUB2069100101;2015-07-12;1045;1045;522.5;64;32;RUB;null;null;981;490.5;0.5
0;KZ75125RUB2069100101;2015-07-13;1093;1093;546.5;48;24;RUB;null;null;1045;522.5;0.5
0;KZ75125RUB2069100101;2015-07-14;1172;1172;586;79;39.5;RUB;null;null;1093;546.5;0.5
0;KZ75125RUB2069100101;2015-07-15;1126;1126;563;null;null;RUB;46;23;1172;586;0.5
0;KZ75125RUB2069100101;2015-07-16;1201;1201;600.5;75;37.5;RUB;null;null;1126;563;0.5
0;KZ75125RUB2069100101;2015-07-17;1170;1170;585;null;null;RUB;31;15.5;1201;600.5;0.5
0;KZ75125RUB2069100101;2015-07-18;1200;1200;600;30;15;RUB;null;null;1170;585;0.5
0;KZ75125RUB2069100101;2015-07-19;1206;1206;603;6;3;RUB;null;null;1200;600;0.5
0;KZ75125RUB2069100101;2015-07-20;1270;1270;635;64;32;RUB;null;null;1206;603;0.5
0;KZ75125RUB2069100101;2015-07-21;1196;1196;598;null;null;RUB;74;37;1270;635;0.5
0;KZ75125RUB2069100101;2015-07-22;1218;1218;609;22;11;RUB;null;null;1196;598;0.5
0;KZ75125RUB2069100101;2015-07-23;1295;1295;647.5;77;38.5;RUB;null;null;1218;609;0.5
0;KZ75125RUB2069100101;2015-07-24;1198;1198;599;null;null;RUB;97;48.5;1295;647.5;0.5
0;KZ75125RUB2069100101;2015-07-25;1274;1274;637;76;38;RUB;null;null;1198;599;0.5
0;KZ75125RUB2069100101;2015-07-26;1369;1369;684.5;95;47.5;RUB;null;null;1274;637;0.5
0;KZ75125RUB2069100101;2015-07-27;1330;1330;665;null;null;RUB;39;19.5;1369;684.5;0.5
0;KZ75125RUB2069100101;2015-07-28;1362;1362;681;32;16;RUB;null;null;1330;665;0.5
0;KZ75125RUB2069100101;2015-07-29;1402;1402;701;40;20;RUB;null;null;1362;681;0.5
0;KZ75125RUB2069100101;2015-07-30;1382;1382;691;null;null;RUB;20;10;1402;701;0.5
0;KZ75125RUB2069100101;2015-07-31;1342;1342;671;null;null;RUB;40;20;1382;691;0.5
0;KZ75125RUB2069100101;2015-08-01;1300;1300;650;null;null;RUB;42;21;1342;671;0.5
0;KZ75125RUB2069100101;2015-08-02;1399;1399;699.5;99;49.5;RUB;null;null;1300;650;0.5
0;KZ75125RUB2069100101;2015-08-03;1429;1429;714.5;30;15;RUB;null;null;1399;699.5;0.5
0;KZ75125RUB2069100101;2015-08-04;1337;1337;668.5;null;null;RUB;92;46;1429;714.5;0.5
0;KZ75125RUB2069100101;2015-08-05;1343;1343;671.5;6;3;RUB;null;null;1337;668.5;0.5
0;KZ75125RUB2069100101;2015-08-06;1374;1374;687;31;15.5;RUB;null;null;1343;671.5;0.5
0;KZ75125RUB2069100101;2015-08-07;1411;1411;705.5;37;18.5;RUB;null;null;1374;687;0.5
0;KZ75125RUB2069100101;2015-08-08;1328;1328;664;null;null;RUB;83;41.5;1411;705.5;0.5
0;KZ75125RUB2069100101;2015-08-09;1405;1405;702.5;77;38.5;RUB;null;null;1328;664;0.5
0;KZ75125RUB2069100101;2015-08-10;1461;1461;730.5;56;28;RUB;null;null;1405;702.5;0.5
0;KZ75125RUB2069100101;2015-08-11;1373;1373;686.5;null;null;RUB;88;44;1461;730.5;0.5
0;KZ75125RUB2069100101;2015-08-12;1448;1448;724;75;37.5;RUB;null;null;1373;686.5;0.5
0;KZ75125RUB2069100101;2015-08-13;1537;1537;768.5;89;44.5;RUB;null;null;1448;724;0.5
0;KZ75125RUB2069100101;2015-08-14;1505;1505;752.5;null;null;RUB;32;16;1537;768.5;0.5
0;KZ75125RUB2069100101;2015-08-15;1517;1517;758.5;12;6;RUB;null;null;1505;752.5;0.5
0;KZ75125RUB2069100101;2015-08-16;1584;1584;792;67;33.5;RUB;null;null;1517;758.5;0.5
0;KZ75125RUB2069100101;2015-08-17;1547;1547;773.5;null;null;RUB;37;18.5;1584;792;0.5
0;KZ75125RUB2069100101;2015-08-18;1586;1586;793;39;19.5;RUB;null;null;1547;773.5;0.5
0;KZ75125RUB2069100101;2015-08-19;1550;1550;775;null;null;RUB;36;18;1586;793;0.5
0;KZ75125RUB2069100101;2015-08-20;1537;1537;768.5;null;null;RUB;13;6.5;1550;775;0.5
0;KZ75125RUB2069100101;2015-08-21;1630;1630;815;93;46.5;RUB;null;null;1537;768.5;0.5
0;KZ75125RUB2069100101;2015-08-22;1576;1576;788;null;null;RUB;54;27;1630;815;0.5
0;KZ75125RUB2069100101;2015-08-23;1663;1663;831.5;87;43.5;RUB;null;null;1576;788;0.5
0;KZ75125RUB2069100101;2015-08-24;1744;1744;872;81;40.5;RUB;null;null;1663;831.5;0.5
0;KZ75125RUB2069100101;2015-08-25;1740;1740;870;null;null;RUB;4;2;1744;872;0.5
0;KZ75125RUB2069100101;2015-08-26;1654;1654;827;null;null;RUB;86;43;1740;870;0.5
0;KZ75125RUB2069100101;2015-08-27;1747;1747;873.5;93;46.5;RUB;null;null;1654;827;0.5
0;KZ75125RUB2069100101;2015-08-28;1681;1681;840.5;null;null;RUB;66;33;1747;873.5;0.5
0;KZ75125RUB2069100101;2015-08-29;1738;1738;869;57;28.5;RUB;null;null;1681;840.5;0.5
0;KZ75125RUB2069100101;2015-08-30;1776;1776;888;38;19;RUB;null;null;1738;869;0.5
0;KZ75125RUB2069100101;2015-08-31;1835;1835;917.5;59;29.5;RUB;null;null;1776;888;0.5
0;KZ75125RUB2069100101;2015-09-01;1878;1878;939;43;21.5;RUB;null;null;1835;917.5;0.5
0;KZ75125RUB2069100101;2015-09-02;1902;1902;951;24;12;RUB;null;null;1878;939;0.5
0;KZ75125RUB2069100101;2015-09-03;1844;1844;922;null;null;RUB;58;29;1902;951;0.5
0;KZ75125RUB2069100101;2015-09-04;1861;1861;930.5;17;8.5;RUB;null;null;1844;922;0.5
0;KZ75125RUB2069100101;2015-09-05;1947;1947;973.5;86;43;RUB;null;null;1861;930.5;0.5
0;KZ75125RUB2069100101;2015-09-06;2044;2044;1022;97;48.5;RUB;null;null;1947;973.5;0.5
0;KZ75125RUB2069100101;2015-09-07;1956;1956;978;null;null;RUB;88;44;2044;1022;0.5
0;KZ75125RUB2069100101;2015-09-08;1993;1993;996.5;37;18.5;RUB;null;null;1956;978;0.5
0;KZ75125RUB2069100101;2015-09-09;2007;2007;1003.5;14;7;RUB;null;null;1993;996.5;0.5
0;KZ75125RUB2069100101;2015-09-10;1913;1913;956.5;null;null;RUB;94;47;2007;1003.5;0.5
0;KZ75125RUB2069100101;2015-09-11;1900;1900;950;null;null;RUB;13;6.5;1913;956.5;0.5
0;KZ75125RUB2069100101;2015-09-12;1830;1830;915;null;null;RUB;70;35;1900;950;0.5
0;KZ75125RUB2069100101;2015-09-13;1746;1746;873;null;null;RUB;84;42;1830;915;0.5
0;KZ75125RUB2069100101;2015-09-14;1648;1648;824;null;null;RUB;98;49;1746;873;0.5
0;KZ75125RUB2069100101;2015-09-15;1721;1721;860.5;73;36.5;RUB;null;null;1648;824;0.5
0;KZ75125RUB2069100101;2015-09-16;1751;1751;875.5;30;15;RUB;null;null;1721;860.5;0.5
0;KZ75125RUB2069100101;2015-09-17;1677;1677;838.5;null;null;RUB;74;37;1751;875.5;0.5
0;KZ75125RUB2069100101;2015-09-18;1713;1713;856.5;36;18;RUB;null;null;1677;838.5;0.5
0;KZ75125RUB2069100101;2015-09-19;1673;1673;836.5;null;null;RUB;40;20;1713;856.5;0.5
0;KZ75125RUB2069100101;2015-09-20;1585;1585;792.5;null;null;RUB;88;44;1673;836.5;0.5
0;KZ75125RUB2069100101;2015-09-21;1500;1500;750;null;null;RUB;85;42.5;1585;792.5;0.5
0;KZ75125RUB2069100101;2015-09-22;1521;1521;760.5;21;10.5;RUB;null;null;1500;750;0.5
0;KZ75125RUB2069100101;2015-09-23;1495;1495;747.5;null;null;RUB;26;13;1521;760.5;0.5
0;KZ75125RUB2069100101;2015-09-24;1484;1484;742;null;null;RUB;11;5.5;1495;747.5;0.5
0;KZ75125RUB2069100101;2015-09-25;1552;1552;776;68;34;RUB;null;null;1484;742;0.5
0;KZ75125RUB2069100101;2015-09-26;1518;1518;759;null;null;RUB;34;17;1552;776;0.5
0;KZ75125RUB2069100101;2015-09-27;1605;1605;802.5;87;43.5;RUB;null;null;1518;759;0.5
0;KZ75125RUB2069100101;2015-09-28;1531;1531;765.5;null;null;RUB;74;37;1605;802.5;0.5
0;KZ75125RUB2069100101;2015-09-29;1536;1536;768;5;2.5;RUB;null;null;1531;765.5;0.5
0;KZ75125RUB2069100101;2015-09-30;1519;1519;759.5;null;null;RUB;17;8.5;1536;768;0.5
0;KZ75125RUB2069100101;2015-10-01;1536;1536;768;17;8.5;RUB;null;null;1519;759.5;0.5
0;KZ75125RUB2069100101;2015-10-02;1562;1562;781;26;13;RUB;null;null;1536;768;0.5
0;KZ75125RUB2069100101;2015-10-03;1490;1490;745;null;null;RUB;72;36;1562;781;0.5
0;KZ75125RUB2069100101;2015-10-04;1504;1504;752;14;7;RUB;null;null;1490;745;0.5
0;KZ75125RUB2069100101;2015-10-05;1460;1460;730;null;null;RUB;44;22;1504;752;0.5
0;KZ75125RUB2069100101;2015-10-06;1554;1554;777;94;47;RUB;null;null;1460;730;0.5
0;KZ75125RUB2069100101;2015-10-07;1635;1635;817.5;81;40.5;RUB;null;null;1554;777;0.5
0;KZ75125RUB2069100101;2015-10-08;1701;1701;850.5;66;33;RUB;null;null;1635;817.5;0.5
0;KZ75125RUB2069100101;2015-10-09;1715;1715;857.5;14;7;RUB;null;null;1701;850.5;0.5
0;KZ75125RUB2069100101;2015-10-10;1809;1809;904.5;94;47;RUB;null;null;1715;857.5;0.5
0;KZ75125RUB2069100101;2015-10-11;1731;1731;865.5;null;null;RUB;78;39;1809;904.5;0.5
0;KZ75125RUB2069100101;2015-10-12;1827;1827;913.5;96;48;RUB;null;null;1731;865.5;0.5
0;KZ75125RUB2069100101;2015-10-13;1826;1826;913;null;null;RUB;1;0.5;1827;913.5;0.5
0;KZ75125RUB2069100101;2015-10-14;1842;1842;921;16;8;RUB;null;null;1826;913;0.5
0;KZ75125RUB2069100101;2015-10-15;1851;1851;925.5;9;4.5;RUB;null;null;1842;921;0.5
0;KZ75125RUB2069100101;2015-10-16;1926;1926;963;75;37.5;RUB;null;null;1851;925.5;0.5
0;KZ75125RUB2069100101;2015-10-17;1951;1951;975.5;25;12.5;RUB;null;null;1926;963;0.5
0;KZ75125RUB2069100101;2015-10-18;1888;1888;944;null;null;RUB;63;31.5;1951;975.5;0.5
0;KZ75125RUB2069100101;2015-10-19;1975;1975;987.5;87;43.5;RUB;null;null;1888;944;0.5
0;KZ75125RUB2069100101;2015-10-20;1946;1946;973;null;null;RUB;29;14.5;1975;987.5;0.5
0;KZ75125RUB2069100101;2015-10-21;1859;1859;929.5;null;null;RUB;87;43.5;1946;973;0.5
0;KZ75125RUB2069100101;2015-10-22;1765;1765;882.5;null;null;RUB;94;47;1859;929.5;0.5
0;KZ75125RUB2069100101;2015-10-23;1781;1781;890.5;16;8;RUB;null;null;1765;882.5;0.5
0;KZ75125RUB2069100101;2015-10-24;1819;1819;909.5;38;19;RUB;null;null;1781;890.5;0.5
0;KZ75125RUB2069100101;2015-10-25;1844;1844;922;25;12.5;RUB;null;null;1819;909.5;0.5
0;KZ75125RUB2069100101;2015-10-26;1915;1915;957.5;71;35.5;RUB;null;null;1844;922;0.5
0;KZ75125RUB2069100101;2015-10-27;1903;1903;951.5;null;null;RUB;12;6;1915;957.5;0.5
0;KZ75125RUB2069100101;2015-10-28;1903;1903;951.5;null;null;RUB;0;0;1903;951.5;0.5
0;KZ75125RUB2069100101;2015-10-29;1835;1835;917.5;null;null;RUB;68;34;1903;951.5;0.5
0;KZ75125RUB2069100101;2015-10-30;1843;1843;921.5;8;4;RUB;null;null;1835;917.5;0.5
0;KZ75125RUB2069100101;2015-10-31;1937;1937;968.5;94;47;RUB;null;null;1843;921.5;0.5
0;KZ75125RUB2069100101;2015-11-01;2011;2011;1005.5;74;37;RUB;null;null;1937;968.5;0.5
0;KZ75125RUB2069100101;2015-11-02;2056;2056;1028;45;22.5;RUB;null;null;2011;1005.5;0.5
0;KZ75125RUB2069100101;2015-11-03;2036;2036;1018;null;null;RUB;20;10;2056;1028;0.5
0;KZ75125RUB2069100101;2015-11-04;2000;2000;1000;null;null;RUB;36;18;2036;1018;0.5
0;KZ75125RUB2069100101;2015-11-05;1987;1987;993.5;null;null;RUB;13;6.5;2000;1000;0.5
0;KZ75125RUB2069100101;2015-11-06;1955;1955;977.5;null;null;RUB;32;16;1987;993.5;0.5
0;KZ75125RUB2069100101;2015-11-07;1959;1959;979.5;4;2;RUB;null;null;1955;977.5;0.5
0;KZ75125RUB2069100101;2015-11-08;2013;2013;1006.5;54;27;RUB;null;null;1959;979.5;0.5
0;KZ75125RUB2069100101;2015-11-09;2080;2080;1040;67;33.5;RUB;null;null;2013;1006.5;0.5
0;KZ75125RUB2069100101;2015-11-10;1997;1997;998.5;null;null;RUB;83;41.5;2080;1040;0.5
0;KZ75125RUB2069100101;2015-11-11;2090;2090;1045;93;46.5;RUB;null;null;1997;998.5;0.5
0;KZ75125RUB2069100101;2015-11-12;2015;2015;1007.5;null;null;RUB;75;37.5;2090;1045;0.5
0;KZ75125RUB2069100101;2015-11-13;2030;2030;1015;15;7.5;RUB;null;null;2015;1007.5;0.5
0;KZ75125RUB2069100101;2015-11-14;2075;2075;1037.5;45;22.5;RUB;null;null;2030;1015;0.5
0;KZ75125RUB2069100101;2015-11-15;1997;1997;998.5;null;null;RUB;78;39;2075;1037.5;0.5
0;KZ75125RUB2069100101;2015-11-16;1945;1945;972.5;null;null;RUB;52;26;1997;998.5;0.5
0;KZ75125RUB2069100101;2015-11-17;2014;2014;1007;69;34.5;RUB;null;null;1945;972.5;0.5
0;KZ75125RUB2069100101;2015-11-18;1990;1990;995;null;null;RUB;24;12;2014;1007;0.5
0;KZ75125RUB2069100101;2015-11-19;2079;2079;1039.5;89;44.5;RUB;null;null;1990;995;0.5
0;KZ75125RUB2069100101;2015-11-20;2164;2164;1082;85;42.5;RUB;null;null;2079;1039.5;0.5
0;KZ75125RUB2069100101;2015-11-21;2159;2159;1079.5;null;null;RUB;5;2.5;2164;1082;0.5
0;KZ75125RUB2069100101;2015-11-22;2099;2099;1049.5;null;null;RUB;60;30;2159;1079.5;0.5
0;KZ75125RUB2069100101;2015-11-23;2070;2070;1035;null;null;RUB;29;14.5;2099;1049.5;0.5
0;KZ75125RUB2069100101;2015-11-24;2069;2069;1034.5;null;null;RUB;1;0.5;2070;1035;0.5
0;KZ75125RUB2069100101;2015-11-25;2046;2046;1023;null;null;RUB;23;11.5;2069;1034.5;0.5
0;KZ75125RUB2069100101;2015-11-26;2000;2000;1000;null;null;RUB;46;23;2046;1023;0.5
0;KZ75125RUB2069100101;2015-11-27;1986;1986;993;null;null;RUB;14;7;2000;1000;0.5
0;KZ75125RUB2069100101;2015-11-28;1932;1932;966;null;null;RUB;54;27;1986;993;0.5
0;KZ75125RUB2069100101;2015-11-29;1873;1873;936.5;null;null;RUB;59;29.5;1932;966;0.5
0;KZ75125RUB2069100101;2015-11-30;1801;1801;900.5;null;null;RUB;72;36;1873;936.5;0.5
0;KZ75125RUB2069100101;2015-12-01;1761;1761;880.5;null;null;RUB;40;20;1801;900.5;0.5
0;KZ75125RUB2069100101;2015-12-02;1822;1822;911;61;30.5;RUB;null;null;1761;880.5;0.5
0;KZ75125RUB2069100101;2015-12-03;1734;1734;867;null;null;RUB;88;44;1822;911;0.5
0;KZ75125RUB2069100101;2015-12-04;1647;1647;823.5;null;null;RUB;87;43.5;1734;867;0.5
0;KZ75125RUB2069100101;2015-12-05;1679;1679;839.5;32;16;RUB;null;null;1647;823.5;0.5
0;KZ75125RUB2069100101;2015-12-06;1717;1717;858.5;38;19;RUB;null;null;1679;839.5;0.5
0;KZ75125RUB2069100101;2015-12-07;1676;1676;838;null;null;RUB;41;20.5;1717;858.5;0.5
0;KZ75125RUB2069100101;2015-12-08;1759;1759;879.5;83;41.5;RUB;null;null;1676;838;0.5
0;KZ75125RUB2069100101;2015-12-09;1718;1718;859;null;null;RUB;41;20.5;1759;879.5;0.5
0;KZ75125RUB2069100101;2015-12-10;1767;1767;883.5;49;24.5;RUB;null;null;1718;859;0.5
0;KZ75125RUB2069100101;2015-12-11;1725;1725;862.5;null;null;RUB;42;21;1767;883.5;0.5
0;KZ75125RUB2069100101;2015-12-12;1667;1667;833.5;null;null;RUB;58;29;1725;862.5;0.5
0;KZ75125RUB2069100101;2015-12-13;1671;1671;835.5;4;2;RUB;null;null;1667;833.5;0.5
0;KZ75125RUB2069100101;2015-12-14;1687;1687;843.5;16;8;RUB;null;null;1671;835.5;0.5
0;KZ75125RUB2069100101;2015-12-15;1594;1594;797;null;null;RUB;93;46.5;1687;843.5;0.5
0;KZ75125RUB2069100101;2015-12-16;1523;1523;761.5;null;null;RUB;71;35.5;1594;797;0.5
0;KZ75125RUB2069100101;2015-12-17;1516;1516;758;null;null;RUB;7;3.5;1523;761.5;0.5
0;KZ75125RUB2069100101;2015-12-18;1556;1556;778;40;20;RUB;null;null;1516;758;0.5
0;KZ75125RUB2069100101;2015-12-19;1506;1506;753;null;null;RUB;50;25;1556;778;0.5
0;KZ75125RUB2069100101;2015-12-20;1493;1493;746.5;null;null;RUB;13;6.5;1506;753;0.5
0;KZ75125RUB2069100101;2015-12-21;1472;1472;736;null;null;RUB;21;10.5;1493;746.5;0.5
0;KZ75125RUB2069100101;2015-12-22;1386;1386;693;null;null;RUB;86;43;1472;736;0.5
0;KZ75125RUB2069100101;2015-12-23;1348;1348;674;null;null;RUB;38;19;1386;693;0.5
0;KZ75125RUB2069100101;2015-12-24;1289;1289;644.5;null;null;RUB;59;29.5;1348;674;0.5
0;KZ75125RUB2069100101;2015-12-25;1223;1223;611.5;null;null;RUB;66;33;1289;644.5;0.5
0;KZ75125RUB2069100101;2015-12-26;1237;1237;618.5;14;7;RUB;null;null;1223;611.5;0.5
0;KZ75125RUB2069100101;2015-12-27;1335;1335;667.5;98;49;RUB;null;null;1237;618.5;0.5
0;KZ75125RUB2069100101;2015-12-28;1363;1363;681.5;28;14;RUB;null;null;1335;667.5;0.5
0;KZ75125RUB2069100101;2015-12-29;1277;1277;638.5;null;null;RUB;86;43;1363;681.5;0.5
0;KZ75125RUB2069100101;2015-12-30;1339;1339;669.5;62;31;RUB;null;null;1277;638.5;0.5
0;KZ75125RUB2069100101;2015-12-31;1339;1339;669.5;null;null;RUB;0;0;1339;669.5;0.5
0;KZ75125RUB2069100101;2016-01-01;1404;1404;702;65;32.5;RUB;null;null;1339;669.5;0.5
0;KZ75125RUB2069100101;2016-01-02;1462;1462;731;58;29;RUB;null;null;1404;702;0.5
0;KZ75125RUB2069100101;2016-01-03;1492;1492;746;30;15;RUB;null;null;1462;731;0.5
0;KZ75125RUB2069100101;2016-01-04;1537;1537;768.5;45;22.5;RUB;null;null;1492;746;0.5
0;KZ75125RUB2069100101;2016-01-05;1609;1609;804.5;72;36;RUB;null;null;1537;768.5;0.5
0;KZ75125RUB2069100101;2016-01-06;1614;1614;807;5;2.5;RUB;null;null;1609;804.5;0.5
0;KZ75125RUB2069100101;2016-01-07;1602;1602;801;null;null;RUB;12;6;1614;807;0.5
0;KZ75125RUB2069100101;2016-01-08;1696;1696;848;94;47;RUB;null;null;1602;801;0.5
0;KZ75125RUB2069100101;2016-01-09;1707;1707;853.5;11;5.5;RUB;null;null;1696;848;0.5
0;KZ75125RUB2069100101;2016-01-10;1669;1669;834.5;null;null;RUB;38;19;1707;853.5;0.5
0;KZ75125RUB2069100101;2016-01-11;1754;1754;877;85;42.5;RUB;null;null;1669;834.5;0.5
0;KZ75125RUB2069100101;2016-01-12;1771;1771;885.5;17;8.5;RUB;null;null;1754;877;0.5
0;KZ75125RUB2069100101;2016-01-13;1834;1834;917;63;31.5;RUB;null;null;1771;885.5;0.5
0;KZ75125RUB2069100101;2016-01-14;1879;1879;939.5;45;22.5;RUB;null;null;1834;917;0.5
0;KZ75125RUB2069100101;2016-01-15;1943;1943;971.5;64;32;RUB;null;null;1879;939.5;0.5
0;KZ75125RUB2069100101;2016-01-16;1889;1889;944.5;null;null;RUB;54;27;1943;971.5;0.5
0;KZ75125RUB2069100101;2016-01-17;1872;1872;936;null;null;RUB;17;8.5;1889;944.5;0.5
0;KZ75125RUB2069100101;2016-01-18;1844;1844;922;null;null;RUB;28;14;1872;936;0.5
0;KZ75125RUB2069100101;2016-01-19;1817;1817;908.5;null;null;RUB;27;13.5;1844;922;0.5
0;KZ75125RUB2069100101;2016-01-20;1794;1794;897;null;null;RUB;23;11.5;1817;908.5;0.5
0;KZ75125RUB2069100101;2016-01-21;1696;1696;848;null;null;RUB;98;49;1794;897;0.5
0;KZ75125RUB2069100101;2016-01-22;1741;1741;870.5;45;22.5;RUB;null;null;1696;848;0.5
0;KZ75125RUB2069100101;2016-01-23;1705;1705;852.5;null;null;RUB;36;18;1741;870.5;0.5
0;KZ75125RUB2069100101;2016-01-24;1758;1758;879;53;26.5;RUB;null;null;1705;852.5;0.5
0;KZ75125RUB2069100101;2016-01-25;1687;1687;843.5;null;null;RUB;71;35.5;1758;879;0.5
0;KZ75125RUB2069100101;2016-01-26;1758;1758;879;71;35.5;RUB;null;null;1687;843.5;0.5
0;KZ75125RUB2069100101;2016-01-27;1843;1843;921.5;85;42.5;RUB;null;null;1758;879;0.5
0;KZ75125RUB2069100101;2016-01-28;1788;1788;894;null;null;RUB;55;27.5;1843;921.5;0.5
0;KZ75125RUB2069100101;2016-01-29;1759;1759;879.5;null;null;RUB;29;14.5;1788;894;0.5
0;KZ75125RUB2069100101;2016-01-30;1819;1819;909.5;60;30;RUB;null;null;1759;879.5;0.5
0;KZ75125RUB2069100101;2016-01-31;1781;1781;890.5;null;null;RUB;38;19;1819;909.5;0.5
0;KZ75125RUB2069100101;2016-02-01;1722;1722;861;null;null;RUB;59;29.5;1781;890.5;0.5
0;KZ75125RUB2069100101;2016-02-02;1786;1786;893;64;32;RUB;null;null;1722;861;0.5
0;KZ75125RUB2069100101;2016-02-03;1751;1751;875.5;null;null;RUB;35;17.5;1786;893;0.5
0;KZ75125RUB2069100101;2016-02-04;1725;1725;862.5;null;null;RUB;26;13;1751;875.5;0.5
0;KZ75125RUB2069100101;2016-02-05;1628;1628;814;null;null;RUB;97;48.5;1725;862.5;0.5
0;KZ75125RUB2069100101;2016-02-06;1668;1668;834;40;20;RUB;null;null;1628;814;0.5
0;KZ75125RUB2069100101;2016-02-07;1645;1645;822.5;null;null;RUB;23;11.5;1668;834;0.5
0;KZ75125RUB2069100101;2016-02-08;1698;1698;849;53;26.5;RUB;null;null;1645;822.5;0.5
0;KZ75125RUB2069100101;2016-02-09;1636;1636;818;null;null;RUB;62;31;1698;849;0.5
0;KZ75125RUB2069100101;2016-02-10;1679;1679;839.5;43;21.5;RUB;null;null;1636;818;0.5
0;KZ75125RUB2069100101;2016-02-11;1668;1668;834;null;null;RUB;11;5.5;1679;839.5;0.5
0;KZ75125RUB2069100101;2016-02-12;1767;1767;883.5;99;49.5;RUB;null;null;1668;834;0.5
0;KZ75125RUB2069100101;2016-02-13;1687;1687;843.5;null;null;RUB;80;40;1767;883.5;0.5
0;KZ75125RUB2069100101;2016-02-14;1757;1757;878.5;70;35;RUB;null;null;1687;843.5;0.5
0;KZ75125RUB2069100101;2016-02-15;1847;1847;923.5;90;45;RUB;null;null;1757;878.5;0.5
0;KZ75125RUB2069100101;2016-02-16;1885;1885;942.5;38;19;RUB;null;null;1847;923.5;0.5
0;KZ75125RUB2069100101;2016-02-17;1825;1825;912.5;null;null;RUB;60;30;1885;942.5;0.5
0;KZ75125RUB2069100101;2016-02-18;1847;1847;923.5;22;11;RUB;null;null;1825;912.5;0.5
0;KZ75125RUB2069100101;2016-02-19;1875;1875;937.5;28;14;RUB;null;null;1847;923.5;0.5
0;KZ75125RUB2069100101;2016-02-20;1785;1785;892.5;null;null;RUB;90;45;1875;937.5;0.5
0;KZ75125RUB2069100101;2016-02-21;1815;1815;907.5;30;15;RUB;null;null;1785;892.5;0.5
0;KZ75125RUB2069100101;2016-02-22;1883;1883;941.5;68;34;RUB;null;null;1815;907.5;0.5
0;KZ75125RUB2069100101;2016-02-23;1835;1835;917.5;null;null;RUB;48;24;1883;941.5;0.5
0;KZ75125RUB2069100101;2016-02-24;1843;1843;921.5;8;4;RUB;null;null;1835;917.5;0.5
0;KZ75125RUB2069100101;2016-02-25;1792;1792;896;null;null;RUB;51;25.5;1843;921.5;0.5
0;KZ75125RUB2069100101;2016-02-26;1719;1719;859.5;null;null;RUB;73;36.5;1792;896;0.5
0;KZ75125RUB2069100101;2016-02-27;1736;1736;868;17;8.5;RUB;null;null;1719;859.5;0.5
0;KZ75125RUB2069100101;2016-02-28;1700;1700;850;null;null;RUB;36;18;1736;868;0.5
0;KZ75125RUB2069100101;2016-02-29;1724;1724;862;24;12;RUB;null;null;1700;850;0.5
0;KZ75125RUB2069100101;2016-03-01;1757;1757;878.5;33;16.5;RUB;null;null;1724;862;0.5
0;KZ75125RUB2069100101;2016-03-02;1740;1740;870;null;null;RUB;17;8.5;1757;878.5;0.5
0;KZ75125RUB2069100101;2016-03-03;1664;1664;832;null;null;RUB;76;38;1740;870;0.5
0;KZ75125RUB2069100101;2016-03-04;1763;1763;881.5;99;49.5;RUB;null;null;1664;832;0.5
0;KZ75125RUB2069100101;2016-03-05;1793;1793;896.5;30;15;RUB;null;null;1763;881.5;0.5
0;KZ75125RUB2069100101;2016-03-06;1874;1874;937;81;40.5;RUB;null;null;1793;896.5;0.5
0;KZ75125RUB2069100101;2016-03-07;1812;1812;906;null;null;RUB;62;31;1874;937;0.5
0;KZ75125RUB2069100101;2016-03-08;1753;1753;876.5;null;null;RUB;59;29.5;1812;906;0.5
0;KZ75125RUB2069100101;2016-03-09;1788;1788;894;35;17.5;RUB;null;null;1753;876.5;0.5
0;KZ75125RUB2069100101;2016-03-10;1859;1859;929.5;71;35.5;RUB;null;null;1788;894;0.5
0;KZ75125RUB2069100101;2016-03-11;1857;1857;928.5;null;null;RUB;2;1;1859;929.5;0.5
0;KZ75125RUB2069100101;2016-03-12;1758;1758;879;null;null;RUB;99;49.5;1857;928.5;0.5
0;KZ75125RUB2069100101;2016-03-13;1831;1831;915.5;73;36.5;RUB;null;null;1758;879;0.5
0;KZ75125RUB2069100101;2016-03-14;1846;1846;923;15;7.5;RUB;null;null;1831;915.5;0.5
0;KZ75125RUB2069100101;2016-03-15;1785;1785;892.5;null;null;RUB;61;30.5;1846;923;0.5
0;KZ75125RUB2069100101;2016-03-16;1731;1731;865.5;null;null;RUB;54;27;1785;892.5;0.5
0;KZ75125RUB2069100101;2016-03-17;1696;1696;848;null;null;RUB;35;17.5;1731;865.5;0.5
0;KZ75125RUB2069100101;2016-03-18;1623;1623;811.5;null;null;RUB;73;36.5;1696;848;0.5
0;KZ75125RUB2069100101;2016-03-19;1699;1699;849.5;76;38;RUB;null;null;1623;811.5;0.5
0;KZ75125RUB2069100101;2016-03-20;1772;1772;886;73;36.5;RUB;null;null;1699;849.5;0.5
0;KZ75125RUB2069100101;2016-03-21;1699;1699;849.5;null;null;RUB;73;36.5;1772;886;0.5
0;KZ75125RUB2069100101;2016-03-22;1751;1751;875.5;52;26;RUB;null;null;1699;849.5;0.5
0;KZ75125RUB2069100101;2016-03-23;1799;1799;899.5;48;24;RUB;null;null;1751;875.5;0.5
0;KZ75125RUB2069100101;2016-03-24;1897;1897;948.5;98;49;RUB;null;null;1799;899.5;0.5
0;KZ75125RUB2069100101;2016-03-25;1800;1800;900;null;null;RUB;97;48.5;1897;948.5;0.5
0;KZ75125RUB2069100101;2016-03-26;1899;1899;949.5;99;49.5;RUB;null;null;1800;900;0.5
0;KZ75125RUB2069100101;2016-03-27;1935;1935;967.5;36;18;RUB;null;null;1899;949.5;0.5
0;KZ75125RUB2069100101;2016-03-28;1963;1963;981.5;28;14;RUB;null;null;1935;967.5;0.5
0;KZ75125RUB2069100101;2016-03-29;1885;1885;942.5;null;null;RUB;78;39;1963;981.5;0.5
0;KZ75125RUB2069100101;2016-03-30;1796;1796;898;null;null;RUB;89;44.5;1885;942.5;0.5
0;KZ75125RUB2069100101;2016-03-31;1845;1845;922.5;49;24.5;RUB;null;null;1796;898;0.5
0;KZ75125RUB2069100101;2016-04-01;1805;1805;902.5;null;null;RUB;40;20;1845;922.5;0.5
0;KZ75125RUB2069100101;2016-04-02;1739;1739;869.5;null;null;RUB;66;33;1805;902.5;0.5
0;KZ75125RUB2069100101;2016-04-03;1716;1716;858;null;null;RUB;23;11.5;1739;869.5;0.5
0;KZ75125RUB2069100101;2016-04-04;1795;1795;897.5;79;39.5;RUB;null;null;1716;858;0.5
0;KZ75125RUB2069100101;2016-04-05;1855;1855;927.5;60;30;RUB;null;null;1795;897.5;0.5
0;KZ75125RUB2069100101;2016-04-06;1826;1826;913;null;null;RUB;29;14.5;1855;927.5;0.5
0;KZ75125RUB2069100101;2016-04-07;1800;1800;900;null;null;RUB;26;13;1826;913;0.5
0;KZ75125RUB2069100101;2016-04-08;1724;1724;862;null;null;RUB;76;38;1800;900;0.5
0;KZ75125RUB2069100101;2016-04-09;1777;1777;888.5;53;26.5;RUB;null;null;1724;862;0.5
0;KZ75125RUB2069100101;2016-04-10;1851;1851;925.5;74;37;RUB;null;null;1777;888.5;0.5
0;KZ75125RUB2069100101;2016-04-11;1767;1767;883.5;null;null;RUB;84;42;1851;925.5;0.5
0;KZ75125RUB2069100101;2016-04-12;1826;1826;913;59;29.5;RUB;null;null;1767;883.5;0.5
0;KZ75125RUB2069100101;2016-04-13;1827;1827;913.5;1;0.5;RUB;null;null;1826;913;0.5
0;KZ75125RUB2069100101;2016-04-14;1905;1905;952.5;78;39;RUB;null;null;1827;913.5;0.5
0;KZ75125RUB2069100101;2016-04-15;2002;2002;1001;97;48.5;RUB;null;null;1905;952.5;0.5
0;KZ75125RUB2069100101;2016-04-16;2001;2001;1000.5;null;null;RUB;1;0.5;2002;1001;0.5
0;KZ75125RUB2069100101;2016-04-17;2055;2055;1027.5;54;27;RUB;null;null;2001;1000.5;0.5
0;KZ75125RUB2069100101;2016-04-18;2080;2080;1040;25;12.5;RUB;null;null;2055;1027.5;0.5
0;KZ75125RUB2069100101;2016-04-19;2045;2045;1022.5;null;null;RUB;35;17.5;2080;1040;0.5
0;KZ75125RUB2069100101;2016-04-20;2060;2060;1030;15;7.5;RUB;null;null;2045;1022.5;0.5
0;KZ75125RUB2069100101;2016-04-21;1972;1972;986;null;null;RUB;88;44;2060;1030;0.5
0;KZ75125RUB2069100101;2016-04-22;2043;2043;1021.5;71;35.5;RUB;null;null;1972;986;0.5
0;KZ75125RUB2069100101;2016-04-23;2040;2040;1020;null;null;RUB;3;1.5;2043;1021.5;0.5
0;KZ75125RUB2069100101;2016-04-24;2066;2066;1033;26;13;RUB;null;null;2040;1020;0.5
0;KZ75125RUB2069100101;2016-04-25;2065;2065;1032.5;null;null;RUB;1;0.5;2066;1033;0.5
0;KZ75125RUB2069100101;2016-04-26;1976;1976;988;null;null;RUB;89;44.5;2065;1032.5;0.5
0;KZ75125RUB2069100101;2016-04-27;1987;1987;993.5;11;5.5;RUB;null;null;1976;988;0.5
0;KZ75125RUB2069100101;2016-04-28;1928;1928;964;null;null;RUB;59;29.5;1987;993.5;0.5
0;KZ75125RUB2069100101;2016-04-29;1971;1971;985.5;43;21.5;RUB;null;null;1928;964;0.5
0;KZ75125RUB2069100101;2016-04-30;2032;2032;1016;61;30.5;RUB;null;null;1971;985.5;0.5
0;KZ75125RUB2069100101;2016-05-01;2032;2032;1016;null;null;RUB;0;0;2032;1016;0.5
0;KZ75125RUB2069100101;2016-05-02;1990;1990;995;null;null;RUB;42;21;2032;1016;0.5
0;KZ75125RUB2069100101;2016-05-03;2066;2066;1033;76;38;RUB;null;null;1990;995;0.5
0;KZ75125RUB2069100101;2016-05-04;2103;2103;1051.5;37;18.5;RUB;null;null;2066;1033;0.5
0;KZ75125RUB2069100101;2016-05-05;2010;2010;1005;null;null;RUB;93;46.5;2103;1051.5;0.5
0;KZ75125RUB2069100101;2016-05-06;2071;2071;1035.5;61;30.5;RUB;null;null;2010;1005;0.5
0;KZ75125RUB2069100101;2016-05-07;2052;2052;1026;null;null;RUB;19;9.5;2071;1035.5;0.5
0;KZ75125RUB2069100101;2016-05-08;2012;2012;1006;null;null;RUB;40;20;2052;1026;0.5
0;KZ75125RUB2069100101;2016-05-09;2038;2038;1019;26;13;RUB;null;null;2012;1006;0.5
0;KZ75125RUB2069100101;2016-05-10;2052;2052;1026;14;7;RUB;null;null;2038;1019;0.5
0;KZ75125RUB2069100101;2016-05-11;2081;2081;1040.5;29;14.5;RUB;null;null;2052;1026;0.5
0;KZ75125RUB2069100101;2016-05-12;2004;2004;1002;null;null;RUB;77;38.5;2081;1040.5;0.5
0;KZ75125RUB2069100101;2016-05-13;1933;1933;966.5;null;null;RUB;71;35.5;2004;1002;0.5
0;KZ75125RUB2069100101;2016-05-14;1901;1901;950.5;null;null;RUB;32;16;1933;966.5;0.5
0;KZ75125RUB2069100101;2016-05-15;1953;1953;976.5;52;26;RUB;null;null;1901;950.5;0.5
0;KZ75125RUB2069100101;2016-05-16;1997;1997;998.5;44;22;RUB;null;null;1953;976.5;0.5
0;KZ75125RUB2069100101;2016-05-17;2088;2088;1044;91;45.5;RUB;null;null;1997;998.5;0.5
0;KZ75125RUB2069100101;2016-05-18;2008;2008;1004;null;null;RUB;80;40;2088;1044;0.5
0;KZ75125RUB2069100101;2016-05-19;2010;2010;1005;2;1;RUB;null;null;2008;1004;0.5
0;KZ75125RUB2069100101;2016-05-20;1921;1921;960.5;null;null;RUB;89;44.5;2010;1005;0.5
0;KZ75125RUB2069100101;2016-05-21;1919;1919;959.5;null;null;RUB;2;1;1921;960.5;0.5
0;KZ75125RUB2069100101;2016-05-22;1879;1879;939.5;null;null;RUB;40;20;1919;959.5;0.5
0;KZ75125RUB2069100101;2016-05-23;1924;1924;962;45;22.5;RUB;null;null;1879;939.5;0.5
0;KZ75125RUB2069100101;2016-05-24;1954;1954;977;30;15;RUB;null;null;1924;962;0.5
0;KZ75125RUB2069100101;2016-05-25;2016;2016;1008;62;31;RUB;null;null;1954;977;0.5
0;KZ75125RUB2069100101;2016-05-26;1987;1987;993.5;null;null;RUB;29;14.5;2016;1008;0.5
0;KZ75125RUB2069100101;2016-05-27;1952;1952;976;null;null;RUB;35;17.5;1987;993.5;0.5
0;KZ75125RUB2069100101;2016-05-28;1912;1912;956;null;null;RUB;40;20;1952;976;0.5
0;KZ75125RUB2069100101;2016-05-29;1852;1852;926;null;null;RUB;60;30;1912;956;0.5
0;KZ75125RUB2069100101;2016-05-30;1903;1903;951.5;51;25.5;RUB;null;null;1852;926;0.5
0;KZ75125RUB2069100101;2016-05-31;1928;1928;964;25;12.5;RUB;null;null;1903;951.5;0.5
0;KZ75125RUB2069100101;2016-06-01;1842;1842;921;null;null;RUB;86;43;1928;964;0.5
0;KZ75125RUB2069100101;2016-06-02;1936;1936;968;94;47;RUB;null;null;1842;921;0.5
0;KZ75125RUB2069100101;2016-06-03;1872;1872;936;null;null;RUB;64;32;1936;968;0.5
0;KZ75125RUB2069100101;2016-06-04;1923;1923;961.5;51;25.5;RUB;null;null;1872;936;0.5
0;KZ75125RUB2069100101;2016-06-05;1913;1913;956.5;null;null;RUB;10;5;1923;961.5;0.5
0;KZ75125RUB2069100101;2016-06-06;2009;2009;1004.5;96;48;RUB;null;null;1913;956.5;0.5
0;KZ75125RUB2069100101;2016-06-07;1910;1910;955;null;null;RUB;99;49.5;2009;1004.5;0.5
0;KZ75125RUB2069100101;2016-06-08;1874;1874;937;null;null;RUB;36;18;1910;955;0.5
0;KZ75125RUB2069100101;2016-06-09;1823;1823;911.5;null;null;RUB;51;25.5;1874;937;0.5
0;KZ75125RUB2069100101;2016-06-10;1791;1791;895.5;null;null;RUB;32;16;1823;911.5;0.5
0;KZ75125RUB2069100101;2016-06-11;1749;1749;874.5;null;null;RUB;42;21;1791;895.5;0.5
0;KZ75125RUB2069100101;2016-06-12;1804;1804;902;55;27.5;RUB;null;null;1749;874.5;0.5
0;KZ75125RUB2069100101;2016-06-13;1883;1883;941.5;79;39.5;RUB;null;null;1804;902;0.5
0;KZ75125RUB2069100101;2016-06-14;1950;1950;975;67;33.5;RUB;null;null;1883;941.5;0.5
0;KZ75125RUB2069100101;2016-06-15;1949;1949;974.5;null;null;RUB;1;0.5;1950;975;0.5
0;KZ75125RUB2069100101;2016-06-16;2041;2041;1020.5;92;46;RUB;null;null;1949;974.5;0.5
0;KZ75125RUB2069100101;2016-06-17;1982;1982;991;null;null;RUB;59;29.5;2041;1020.5;0.5
0;KZ75125RUB2069100101;2016-06-18;2018;2018;1009;36;18;RUB;null;null;1982;991;0.5
0;KZ75125RUB2069100101;2016-06-19;1940;1940;970;null;null;RUB;78;39;2018;1009;0.5
0;KZ75125RUB2069100101;2016-06-20;1850;1850;925;null;null;RUB;90;45;1940;970;0.5
0;KZ75125RUB2069100101;2016-06-21;1871;1871;935.5;21;10.5;RUB;null;null;1850;925;0.5
0;KZ75125RUB2069100101;2016-06-22;1879;1879;939.5;8;4;RUB;null;null;1871;935.5;0.5
0;KZ75125RUB2069100101;2016-06-23;1780;1780;890;null;null;RUB;99;49.5;1879;939.5;0.5
0;KZ75125RUB2069100101;2016-06-24;1777;1777;888.5;null;null;RUB;3;1.5;1780;890;0.5
0;KZ75125RUB2069100101;2016-06-25;1680;1680;840;null;null;RUB;97;48.5;1777;888.5;0.5
0;KZ75125RUB2069100101;2016-06-26;1623;1623;811.5;null;null;RUB;57;28.5;1680;840;0.5
0;KZ75125RUB2069100101;2016-06-27;1624;1624;812;1;0.5;RUB;null;null;1623;811.5;0.5
0;KZ75125RUB2069100101;2016-06-28;1697;1697;848.5;73;36.5;RUB;null;null;1624;812;0.5
0;KZ75125RUB2069100101;2016-06-29;1695;1695;847.5;null;null;RUB;2;1;1697;848.5;0.5
0;KZ75125RUB2069100101;2016-06-30;1642;1642;821;null;null;RUB;53;26.5;1695;847.5;0.5
0;KZ75125RUB2069100101;2016-07-01;1563;1563;781.5;null;null;RUB;79;39.5;1642;821;0.5
0;KZ75125RUB2069100101;2016-07-02;1608;1608;804;45;22.5;RUB;null;null;1563;781.5;0.5
0;KZ75125RUB2069100101;2016-07-03;1566;1566;783;null;null;RUB;42;21;1608;804;0.5
0;KZ75125RUB2069100101;2016-07-04;1638;1638;819;72;36;RUB;null;null;1566;783;0.5
0;KZ75125RUB2069100101;2016-07-05;1568;1568;784;null;null;RUB;70;35;1638;819;0.5
0;KZ75125RUB2069100101;2016-07-06;1568;1568;784;null;null;RUB;0;0;1568;784;0.5
0;KZ75125RUB2069100101;2016-07-07;1563;1563;781.5;null;null;RUB;5;2.5;1568;784;0.5
0;KZ75125RUB2069100101;2016-07-08;1616;1616;808;53;26.5;RUB;null;null;1563;781.5;0.5
0;KZ75125RUB2069100101;2016-07-09;1590;1590;795;null;null;RUB;26;13;1616;808;0.5
0;KZ75125RUB2069100101;2016-07-10;1671;1671;835.5;81;40.5;RUB;null;null;1590;795;0.5
0;KZ75125RUB2069100101;2016-07-11;1704;1704;852;33;16.5;RUB;null;null;1671;835.5;0.5
0;KZ75125RUB2069100101;2016-07-12;1730;1730;865;26;13;RUB;null;null;1704;852;0.5
0;KZ75125RUB2069100101;2016-07-13;1721;1721;860.5;null;null;RUB;9;4.5;1730;865;0.5
0;KZ75125RUB2069100101;2016-07-14;1793;1793;896.5;72;36;RUB;null;null;1721;860.5;0.5
0;KZ75125RUB2069100101;2016-07-15;1823;1823;911.5;30;15;RUB;null;null;1793;896.5;0.5
0;KZ75125RUB2069100101;2016-07-16;1851;1851;925.5;28;14;RUB;null;null;1823;911.5;0.5
0;KZ75125RUB2069100101;2016-07-17;1942;1942;971;91;45.5;RUB;null;null;1851;925.5;0.5
0;KZ75125RUB2069100101;2016-07-18;2020;2020;1010;78;39;RUB;null;null;1942;971;0.5
0;KZ75125RUB2069100101;2016-07-19;1967;1967;983.5;null;null;RUB;53;26.5;2020;1010;0.5
0;KZ75125RUB2069100101;2016-07-20;1950;1950;975;null;null;RUB;17;8.5;1967;983.5;0.5
0;KZ75125RUB2069100101;2016-07-21;1953;1953;976.5;3;1.5;RUB;null;null;1950;975;0.5
0;KZ75125RUB2069100101;2016-07-22;2028;2028;1014;75;37.5;RUB;null;null;1953;976.5;0.5
0;KZ75125RUB2069100101;2016-07-23;1931;1931;965.5;null;null;RUB;97;48.5;2028;1014;0.5
0;KZ75125RUB2069100101;2016-07-24;1960;1960;980;29;14.5;RUB;null;null;1931;965.5;0.5
0;KZ75125RUB2069100101;2016-07-25;1960;1960;980;null;null;RUB;0;0;1960;980;0.5
0;KZ75125RUB2069100101;2016-07-26;1921;1921;960.5;null;null;RUB;39;19.5;1960;980;0.5
0;KZ75125RUB2069100101;2016-07-27;1829;1829;914.5;null;null;RUB;92;46;1921;960.5;0.5
0;KZ75125RUB2069100101;2016-07-28;1739;1739;869.5;null;null;RUB;90;45;1829;914.5;0.5
0;KZ75125RUB2069100101;2016-07-29;1734;1734;867;null;null;RUB;5;2.5;1739;869.5;0.5
0;KZ75125RUB2069100101;2016-07-30;1666;1666;833;null;null;RUB;68;34;1734;867;0.5
0;KZ75125RUB2069100101;2016-07-31;1686;1686;843;20;10;RUB;null;null;1666;833;0.5
0;KZ75125RUB2069100101;2016-08-01;1708;1708;854;22;11;RUB;null;null;1686;843;0.5
0;KZ75125RUB2069100101;2016-08-02;1669;1669;834.5;null;null;RUB;39;19.5;1708;854;0.5
0;KZ75125RUB2069100101;2016-08-03;1697;1697;848.5;28;14;RUB;null;null;1669;834.5;0.5
0;KZ75125RUB2069100101;2016-08-04;1637;1637;818.5;null;null;RUB;60;30;1697;848.5;0.5
0;KZ75125RUB2069100101;2016-08-05;1662;1662;831;25;12.5;RUB;null;null;1637;818.5;0.5
0;KZ75125RUB2069100101;2016-08-06;1761;1761;880.5;99;49.5;RUB;null;null;1662;831;0.5
0;KZ75125RUB2069100101;2016-08-07;1789;1789;894.5;28;14;RUB;null;null;1761;880.5;0.5
0;KZ75125RUB2069100101;2016-08-08;1742;1742;871;null;null;RUB;47;23.5;1789;894.5;0.5
0;KZ75125RUB2069100101;2016-08-09;1804;1804;902;62;31;RUB;null;null;1742;871;0.5
0;KZ75125RUB2069100101;2016-08-10;1804;1804;902;null;null;RUB;0;0;1804;902;0.5
0;KZ75125RUB2069100101;2016-08-11;1860;1860;930;56;28;RUB;null;null;1804;902;0.5
0;KZ75125RUB2069100101;2016-08-12;1825;1825;912.5;null;null;RUB;35;17.5;1860;930;0.5
0;KZ75125RUB2069100101;2016-08-13;1781;1781;890.5;null;null;RUB;44;22;1825;912.5;0.5
0;KZ75125RUB2069100101;2016-08-14;1702;1702;851;null;null;RUB;79;39.5;1781;890.5;0.5
0;KZ75125RUB2069100101;2016-08-15;1682;1682;841;null;null;RUB;20;10;1702;851;0.5
0;KZ75125RUB2069100101;2016-08-16;1623;1623;811.5;null;null;RUB;59;29.5;1682;841;0.5
0;KZ75125RUB2069100101;2016-08-17;1710;1710;855;87;43.5;RUB;null;null;1623;811.5;0.5
0;KZ75125RUB2069100101;2016-08-18;1712;1712;856;2;1;RUB;null;null;1710;855;0.5
0;KZ75125RUB2069100101;2016-08-19;1731;1731;865.5;19;9.5;RUB;null;null;1712;856;0.5
0;KZ75125RUB2069100101;2016-08-20;1658;1658;829;null;null;RUB;73;36.5;1731;865.5;0.5
0;KZ75125RUB2069100101;2016-08-21;1724;1724;862;66;33;RUB;null;null;1658;829;0.5
0;KZ75125RUB2069100101;2016-08-22;1705;1705;852.5;null;null;RUB;19;9.5;1724;862;0.5
0;KZ75125RUB2069100101;2016-08-23;1758;1758;879;53;26.5;RUB;null;null;1705;852.5;0.5
0;KZ75125RUB2069100101;2016-08-24;1662;1662;831;null;null;RUB;96;48;1758;879;0.5
0;KZ75125RUB2069100101;2016-08-25;1714;1714;857;52;26;RUB;null;null;1662;831;0.5
0;KZ75125RUB2069100101;2016-08-26;1812;1812;906;98;49;RUB;null;null;1714;857;0.5
0;KZ75125RUB2069100101;2016-08-27;1824;1824;912;12;6;RUB;null;null;1812;906;0.5
0;KZ75125RUB2069100101;2016-08-28;1841;1841;920.5;17;8.5;RUB;null;null;1824;912;0.5
0;KZ75125RUB2069100101;2016-08-29;1798;1798;899;null;null;RUB;43;21.5;1841;920.5;0.5
0;KZ75125RUB2069100101;2016-08-30;1774;1774;887;null;null;RUB;24;12;1798;899;0.5
0;KZ75125RUB2069100101;2016-08-31;1772;1772;886;null;null;RUB;2;1;1774;887;0.5
0;KZ75125RUB2069100101;2016-09-01;1867;1867;933.5;95;47.5;RUB;null;null;1772;886;0.5
0;KZ75125RUB2069100101;2016-09-02;1923;1923;961.5;56;28;RUB;null;null;1867;933.5;0.5
0;KZ75125RUB2069100101;2016-09-03;1849;1849;924.5;null;null;RUB;74;37;1923;961.5;0.5
0;KZ75125RUB2069100101;2016-09-04;1863;1863;931.5;14;7;RUB;null;null;1849;924.5;0.5
0;KZ75125RUB2069100101;2016-09-05;1938;1938;969;75;37.5;RUB;null;null;1863;931.5;0.5
0;KZ75125RUB2069100101;2016-09-06;2004;2004;1002;66;33;RUB;null;null;1938;969;0.5
0;KZ75125RUB2069100101;2016-09-07;1991;1991;995.5;null;null;RUB;13;6.5;2004;1002;0.5
0;KZ75125RUB2069100101;2016-09-08;2006;2006;1003;15;7.5;RUB;null;null;1991;995.5;0.5
0;KZ75125RUB2069100101;2016-09-09;2045;2045;1022.5;39;19.5;RUB;null;null;2006;1003;0.5
0;KZ75125RUB2069100101;2016-09-10;2055;2055;1027.5;10;5;RUB;null;null;2045;1022.5;0.5
0;KZ75125RUB2069100101;2016-09-11;2145;2145;1072.5;90;45;RUB;null;null;2055;1027.5;0.5
0;KZ75125RUB2069100101;2016-09-12;2123;2123;1061.5;null;null;RUB;22;11;2145;1072.5;0.5
0;KZ75125RUB2069100101;2016-09-13;2036;2036;1018;null;null;RUB;87;43.5;2123;1061.5;0.5
0;KZ75125RUB2069100101;2016-09-14;2123;2123;1061.5;87;43.5;RUB;null;null;2036;1018;0.5
0;KZ75125RUB2069100101;2016-09-15;2180;2180;1090;57;28.5;RUB;null;null;2123;1061.5;0.5
0;KZ75125RUB2069100101;2016-09-16;2274;2274;1137;94;47;RUB;null;null;2180;1090;0.5
0;KZ75125RUB2069100101;2016-09-17;2270;2270;1135;null;null;RUB;4;2;2274;1137;0.5
0;KZ75125RUB2069100101;2016-09-18;2273;2273;1136.5;3;1.5;RUB;null;null;2270;1135;0.5
0;KZ75125RUB2069100101;2016-09-19;2193;2193;1096.5;null;null;RUB;80;40;2273;1136.5;0.5
0;KZ75125RUB2069100101;2016-09-20;2159;2159;1079.5;null;null;RUB;34;17;2193;1096.5;0.5
0;KZ75125RUB2069100101;2016-09-21;2118;2118;1059;null;null;RUB;41;20.5;2159;1079.5;0.5
0;KZ75125RUB2069100101;2016-09-22;2158;2158;1079;40;20;RUB;null;null;2118;1059;0.5
0;KZ75125RUB2069100101;2016-09-23;2134;2134;1067;null;null;RUB;24;12;2158;1079;0.5
0;KZ75125RUB2069100101;2016-09-24;2097;2097;1048.5;null;null;RUB;37;18.5;2134;1067;0.5
0;KZ75125RUB2069100101;2016-09-25;2180;2180;1090;83;41.5;RUB;null;null;2097;1048.5;0.5
0;KZ75125RUB2069100101;2016-09-26;2165;2165;1082.5;null;null;RUB;15;7.5;2180;1090;0.5
0;KZ75125RUB2069100101;2016-09-27;2068;2068;1034;null;null;RUB;97;48.5;2165;1082.5;0.5
0;KZ75125RUB2069100101;2016-09-28;2019;2019;1009.5;null;null;RUB;49;24.5;2068;1034;0.5
0;KZ75125RUB2069100101;2016-09-29;2072;2072;1036;53;26.5;RUB;null;null;2019;1009.5;0.5
0;KZ75125RUB2069100101;2016-09-30;2062;2062;1031;null;null;RUB;10;5;2072;1036;0.5
0;KZ75125RUB2069100101;2016-10-01;2040;2040;1020;null;null;RUB;22;11;2062;1031;0.5
0;KZ75125RUB2069100101;2016-10-02;2011;2011;1005.5;null;null;RUB;29;14.5;2040;1020;0.5
0;KZ75125RUB2069100101;2016-10-03;2038;2038;1019;27;13.5;RUB;null;null;2011;1005.5;0.5
0;KZ75125RUB2069100101;2016-10-04;2095;2095;1047.5;57;28.5;RUB;null;null;2038;1019;0.5
0;KZ75125RUB2069100101;2016-10-05;2146;2146;1073;51;25.5;RUB;null;null;2095;1047.5;0.5
0;KZ75125RUB2069100101;2016-10-06;2218;2218;1109;72;36;RUB;null;null;2146;1073;0.5
0;KZ75125RUB2069100101;2016-10-07;2315;2315;1157.5;97;48.5;RUB;null;null;2218;1109;0.5
0;KZ75125RUB2069100101;2016-10-08;2296;2296;1148;null;null;RUB;19;9.5;2315;1157.5;0.5
0;KZ75125RUB2069100101;2016-10-09;2228;2228;1114;null;null;RUB;68;34;2296;1148;0.5
0;KZ75125RUB2069100101;2016-10-10;2290;2290;1145;62;31;RUB;null;null;2228;1114;0.5
0;KZ75125RUB2069100101;2016-10-11;2229;2229;1114.5;null;null;RUB;61;30.5;2290;1145;0.5
0;KZ75125RUB2069100101;2016-10-12;2307;2307;1153.5;78;39;RUB;null;null;2229;1114.5;0.5
0;KZ75125RUB2069100101;2016-10-13;2356;2356;1178;49;24.5;RUB;null;null;2307;1153.5;0.5
0;KZ75125RUB2069100101;2016-10-14;2433;2433;1216.5;77;38.5;RUB;null;null;2356;1178;0.5
0;KZ75125RUB2069100101;2016-10-15;2514;2514;1257;81;40.5;RUB;null;null;2433;1216.5;0.5
0;KZ75125RUB2069100101;2016-10-16;2572;2572;1286;58;29;RUB;null;null;2514;1257;0.5
0;KZ75125RUB2069100101;2016-10-17;2560;2560;1280;null;null;RUB;12;6;2572;1286;0.5
0;KZ75125RUB2069100101;2016-10-18;2613;2613;1306.5;53;26.5;RUB;null;null;2560;1280;0.5
0;KZ75125RUB2069100101;2016-10-19;2613;2613;1306.5;null;null;RUB;0;0;2613;1306.5;0.5
0;KZ75125RUB2069100101;2016-10-20;2569;2569;1284.5;null;null;RUB;44;22;2613;1306.5;0.5
0;KZ75125RUB2069100101;2016-10-21;2489;2489;1244.5;null;null;RUB;80;40;2569;1284.5;0.5
0;KZ75125RUB2069100101;2016-10-22;2532;2532;1266;43;21.5;RUB;null;null;2489;1244.5;0.5
0;KZ75125RUB2069100101;2016-10-23;2439;2439;1219.5;null;null;RUB;93;46.5;2532;1266;0.5
0;KZ75125RUB2069100101;2016-10-24;2486;2486;1243;47;23.5;RUB;null;null;2439;1219.5;0.5
0;KZ75125RUB2069100101;2016-10-25;2447;2447;1223.5;null;null;RUB;39;19.5;2486;1243;0.5
0;KZ75125RUB2069100101;2016-10-26;2509;2509;1254.5;62;31;RUB;null;null;2447;1223.5;0.5
0;KZ75125RUB2069100101;2016-10-27;2481;2481;1240.5;null;null;RUB;28;14;2509;1254.5;0.5
0;KZ75125RUB2069100101;2016-10-28;2541;2541;1270.5;60;30;RUB;null;null;2481;1240.5;0.5
0;KZ75125RUB2069100101;2016-10-29;2539;2539;1269.5;null;null;RUB;2;1;2541;1270.5;0.5
0;KZ75125RUB2069100101;2016-10-30;2539;2539;1269.5;null;null;RUB;0;0;2539;1269.5;0.5
0;KZ75125RUB2069100101;2016-10-31;2557;2557;1278.5;18;9;RUB;null;null;2539;1269.5;0.5
0;KZ75125RUB2069100101;2016-11-01;2619;2619;1309.5;62;31;RUB;null;null;2557;1278.5;0.5
0;KZ75125RUB2069100101;2016-11-02;2568;2568;1284;null;null;RUB;51;25.5;2619;1309.5;0.5
0;KZ75125RUB2069100101;2016-11-03;2583;2583;1291.5;15;7.5;RUB;null;null;2568;1284;0.5
0;KZ75125RUB2069100101;2016-11-04;2664;2664;1332;81;40.5;RUB;null;null;2583;1291.5;0.5
0;KZ75125RUB2069100101;2016-11-05;2693;2693;1346.5;29;14.5;RUB;null;null;2664;1332;0.5
0;KZ75125RUB2069100101;2016-11-06;2729;2729;1364.5;36;18;RUB;null;null;2693;1346.5;0.5
0;KZ75125RUB2069100101;2016-11-07;2787;2787;1393.5;58;29;RUB;null;null;2729;1364.5;0.5
0;KZ75125RUB2069100101;2016-11-08;2746;2746;1373;null;null;RUB;41;20.5;2787;1393.5;0.5
0;KZ75125RUB2069100101;2016-11-09;2673;2673;1336.5;null;null;RUB;73;36.5;2746;1373;0.5
0;KZ75125RUB2069100101;2016-11-10;2612;2612;1306;null;null;RUB;61;30.5;2673;1336.5;0.5
0;KZ75125RUB2069100101;2016-11-11;2600;2600;1300;null;null;RUB;12;6;2612;1306;0.5
0;KZ75125RUB2069100101;2016-11-12;2525;2525;1262.5;null;null;RUB;75;37.5;2600;1300;0.5
0;KZ75125RUB2069100101;2016-11-13;2593;2593;1296.5;68;34;RUB;null;null;2525;1262.5;0.5
0;KZ75125RUB2069100101;2016-11-14;2508;2508;1254;null;null;RUB;85;42.5;2593;1296.5;0.5
0;KZ75125RUB2069100101;2016-11-15;2468;2468;1234;null;null;RUB;40;20;2508;1254;0.5
0;KZ75125RUB2069100101;2016-11-16;2439;2439;1219.5;null;null;RUB;29;14.5;2468;1234;0.5
0;KZ75125RUB2069100101;2016-11-17;2404;2404;1202;null;null;RUB;35;17.5;2439;1219.5;0.5
0;KZ75125RUB2069100101;2016-11-18;2409;2409;1204.5;5;2.5;RUB;null;null;2404;1202;0.5
0;KZ75125RUB2069100101;2016-11-19;2381;2381;1190.5;null;null;RUB;28;14;2409;1204.5;0.5
0;KZ75125RUB2069100101;2016-11-20;2401;2401;1200.5;20;10;RUB;null;null;2381;1190.5;0.5
0;KZ75125RUB2069100101;2016-11-21;2350;2350;1175;null;null;RUB;51;25.5;2401;1200.5;0.5
0;KZ75125RUB2069100101;2016-11-22;2431;2431;1215.5;81;40.5;RUB;null;null;2350;1175;0.5
0;KZ75125RUB2069100101;2016-11-23;2374;2374;1187;null;null;RUB;57;28.5;2431;1215.5;0.5
0;KZ75125RUB2069100101;2016-11-24;2424;2424;1212;50;25;RUB;null;null;2374;1187;0.5
0;KZ75125RUB2069100101;2016-11-25;2475;2475;1237.5;51;25.5;RUB;null;null;2424;1212;0.5
0;KZ75125RUB2069100101;2016-11-26;2427;2427;1213.5;null;null;RUB;48;24;2475;1237.5;0.5
0;KZ75125RUB2069100101;2016-11-27;2390;2390;1195;null;null;RUB;37;18.5;2427;1213.5;0.5
0;KZ75125RUB2069100101;2016-11-28;2360;2360;1180;null;null;RUB;30;15;2390;1195;0.5
0;KZ75125RUB2069100101;2016-11-29;2458;2458;1229;98;49;RUB;null;null;2360;1180;0.5
0;KZ75125RUB2069100101;2016-11-30;2384;2384;1192;null;null;RUB;74;37;2458;1229;0.5
0;KZ75125RUB2069100101;2016-12-01;2343;2343;1171.5;null;null;RUB;41;20.5;2384;1192;0.5
0;KZ75125RUB2069100101;2016-12-02;2430;2430;1215;87;43.5;RUB;null;null;2343;1171.5;0.5
0;KZ75125RUB2069100101;2016-12-03;2501;2501;1250.5;71;35.5;RUB;null;null;2430;1215;0.5
0;KZ75125RUB2069100101;2016-12-04;2600;2600;1300;99;49.5;RUB;null;null;2501;1250.5;0.5
0;KZ75125RUB2069100101;2016-12-05;2647;2647;1323.5;47;23.5;RUB;null;null;2600;1300;0.5
0;KZ75125RUB2069100101;2016-12-06;2598;2598;1299;null;null;RUB;49;24.5;2647;1323.5;0.5
0;KZ75125RUB2069100101;2016-12-07;2685;2685;1342.5;87;43.5;RUB;null;null;2598;1299;0.5
0;KZ75125RUB2069100101;2016-12-08;2765;2765;1382.5;80;40;RUB;null;null;2685;1342.5;0.5
0;KZ75125RUB2069100101;2016-12-09;2797;2797;1398.5;32;16;RUB;null;null;2765;1382.5;0.5
0;KZ75125RUB2069100101;2016-12-10;2781;2781;1390.5;null;null;RUB;16;8;2797;1398.5;0.5
0;KZ75125RUB2069100101;2016-12-11;2773;2773;1386.5;null;null;RUB;8;4;2781;1390.5;0.5
0;KZ75125RUB2069100101;2016-12-12;2767;2767;1383.5;null;null;RUB;6;3;2773;1386.5;0.5
0;KZ75125RUB2069100101;2016-12-13;2830;2830;1415;63;31.5;RUB;null;null;2767;1383.5;0.5
0;KZ75125RUB2069100101;2016-12-14;2823;2823;1411.5;null;null;RUB;7;3.5;2830;1415;0.5
0;KZ75125RUB2069100101;2016-12-15;2815;2815;1407.5;null;null;RUB;8;4;2823;1411.5;0.5
0;KZ75125RUB2069100101;2016-12-16;2776;2776;1388;null;null;RUB;39;19.5;2815;1407.5;0.5
0;KZ75125RUB2069100101;2016-12-17;2846;2846;1423;70;35;RUB;null;null;2776;1388;0.5
0;KZ75125RUB2069100101;2016-12-18;2935;2935;1467.5;89;44.5;RUB;null;null;2846;1423;0.5
0;KZ75125RUB2069100101;2016-12-19;2922;2922;1461;null;null;RUB;13;6.5;2935;1467.5;0.5
0;KZ75125RUB2069100101;2016-12-20;2915;2915;1457.5;null;null;RUB;7;3.5;2922;1461;0.5
0;KZ75125RUB2069100101;2016-12-21;2958;2958;1479;43;21.5;RUB;null;null;2915;1457.5;0.5
0;KZ75125RUB2069100101;2016-12-22;3039;3039;1519.5;81;40.5;RUB;null;null;2958;1479;0.5
0;KZ75125RUB2069100101;2016-12-23;3090;3090;1545;51;25.5;RUB;null;null;3039;1519.5;0.5
0;KZ75125RUB2069100101;2016-12-24;3136;3136;1568;46;23;RUB;null;null;3090;1545;0.5
0;KZ75125RUB2069100101;2016-12-25;3191;3191;1595.5;55;27.5;RUB;null;null;3136;1568;0.5
0;KZ75125RUB2069100101;2016-12-26;3149;3149;1574.5;null;null;RUB;42;21;3191;1595.5;0.5
0;KZ75125RUB2069100101;2016-12-27;3062;3062;1531;null;null;RUB;87;43.5;3149;1574.5;0.5
0;KZ75125RUB2069100101;2016-12-28;3108;3108;1554;46;23;RUB;null;null;3062;1531;0.5
0;KZ75125RUB2069100101;2016-12-29;3207;3207;1603.5;99;49.5;RUB;null;null;3108;1554;0.5
0;KZ75125RUB2069100101;2016-12-30;3221;3221;1610.5;14;7;RUB;null;null;3207;1603.5;0.5
0;KZ75125RUB2069100101;2016-12-31;3230;3230;1615;9;4.5;RUB;null;null;3221;1610.5;0.5
0;KZ75125RUB2069100101;2017-01-01;3136;3136;1568;null;null;RUB;94;47;3230;1615;0.5
0;KZ75125RUB2069100101;2017-01-02;3138;3138;1569;2;1;RUB;null;null;3136;1568;0.5
0;KZ75125RUB2069100101;2017-01-03;3183;3183;1591.5;45;22.5;RUB;null;null;3138;1569;0.5
0;KZ75125RUB2069100101;2017-01-04;3276;3276;1638;93;46.5;RUB;null;null;3183;1591.5;0.5
0;KZ75125RUB2069100101;2017-01-05;3192;3192;1596;null;null;RUB;84;42;3276;1638;0.5
0;KZ75125RUB2069100101;2017-01-06;3251;3251;1625.5;59;29.5;RUB;null;null;3192;1596;0.5
0;KZ75125RUB2069100101;2017-01-07;3227;3227;1613.5;null;null;RUB;24;12;3251;1625.5;0.5
0;KZ75125RUB2069100101;2017-01-08;3257;3257;1628.5;30;15;RUB;null;null;3227;1613.5;0.5
0;KZ75125RUB2069100101;2017-01-09;3224;3224;1612;null;null;RUB;33;16.5;3257;1628.5;0.5
0;KZ75125RUB2069100101;2017-01-10;3138;3138;1569;null;null;RUB;86;43;3224;1612;0.5
0;KZ75125RUB2069100101;2017-01-11;3203;3203;1601.5;65;32.5;RUB;null;null;3138;1569;0.5
0;KZ75125RUB2069100101;2017-01-12;3197;3197;1598.5;null;null;RUB;6;3;3203;1601.5;0.5
0;KZ75125RUB2069100101;2017-01-13;3225;3225;1612.5;28;14;RUB;null;null;3197;1598.5;0.5
0;KZ75125RUB2069100101;2017-01-14;3242;3242;1621;17;8.5;RUB;null;null;3225;1612.5;0.5
0;KZ75125RUB2069100101;2017-01-15;3287;3287;1643.5;45;22.5;RUB;null;null;3242;1621;0.5
0;KZ75125RUB2069100101;2017-01-16;3188;3188;1594;null;null;RUB;99;49.5;3287;1643.5;0.5
0;KZ75125RUB2069100101;2017-01-17;3133;3133;1566.5;null;null;RUB;55;27.5;3188;1594;0.5
0;KZ75125RUB2069100101;2017-01-18;3155;3155;1577.5;22;11;RUB;null;null;3133;1566.5;0.5
0;KZ75125RUB2069100101;2017-01-19;3076;3076;1538;null;null;RUB;79;39.5;3155;1577.5;0.5
0;KZ75125RUB2069100101;2017-01-20;3121;3121;1560.5;45;22.5;RUB;null;null;3076;1538;0.5
0;KZ75125RUB2069100101;2017-01-21;3069;3069;1534.5;null;null;RUB;52;26;3121;1560.5;0.5
0;KZ75125RUB2069100101;2017-01-22;3075;3075;1537.5;6;3;RUB;null;null;3069;1534.5;0.5
0;KZ75125RUB2069100101;2017-01-23;2984;2984;1492;null;null;RUB;91;45.5;3075;1537.5;0.5
0;KZ75125RUB2069100101;2017-01-24;2885;2885;1442.5;null;null;RUB;99;49.5;2984;1492;0.5
0;KZ75125RUB2069100101;2017-01-25;2911;2911;1455.5;26;13;RUB;null;null;2885;1442.5;0.5
0;KZ75125RUB2069100101;2017-01-26;2972;2972;1486;61;30.5;RUB;null;null;2911;1455.5;0.5
0;KZ75125RUB2069100101;2017-01-27;2983;2983;1491.5;11;5.5;RUB;null;null;2972;1486;0.5
0;KZ75125RUB2069100101;2017-01-28;2902;2902;1451;null;null;RUB;81;40.5;2983;1491.5;0.5
0;KZ75125RUB2069100101;2017-01-29;2821;2821;1410.5;null;null;RUB;81;40.5;2902;1451;0.5
0;KZ75125RUB2069100101;2017-01-30;2869;2869;1434.5;48;24;RUB;null;null;2821;1410.5;0.5
0;KZ75125RUB2069100101;2017-01-31;2949;2949;1474.5;80;40;RUB;null;null;2869;1434.5;0.5
0;KZ75125RUB2069100101;2017-02-01;2908;2908;1454;null;null;RUB;41;20.5;2949;1474.5;0.5
0;KZ75125RUB2069100101;2017-02-02;2914;2914;1457;6;3;RUB;null;null;2908;1454;0.5
0;KZ75125RUB2069100101;2017-02-03;2842;2842;1421;null;null;RUB;72;36;2914;1457;0.5
0;KZ75125RUB2069100101;2017-02-04;2818;2818;1409;null;null;RUB;24;12;2842;1421;0.5
0;KZ75125RUB2069100101;2017-02-05;2795;2795;1397.5;null;null;RUB;23;11.5;2818;1409;0.5
0;KZ75125RUB2069100101;2017-02-06;2798;2798;1399;3;1.5;RUB;null;null;2795;1397.5;0.5
0;KZ75125RUB2069100101;2017-02-07;2702;2702;1351;null;null;RUB;96;48;2798;1399;0.5
0;KZ75125RUB2069100101;2017-02-08;2718;2718;1359;16;8;RUB;null;null;2702;1351;0.5
0;KZ75125RUB2069100101;2017-02-09;2684;2684;1342;null;null;RUB;34;17;2718;1359;0.5
0;KZ75125RUB2069100101;2017-02-10;2684;2684;1342;null;null;RUB;0;0;2684;1342;0.5
0;KZ75125RUB2069100101;2017-02-11;2683;2683;1341.5;null;null;RUB;1;0.5;2684;1342;0.5
0;KZ75125RUB2069100101;2017-02-12;2607;2607;1303.5;null;null;RUB;76;38;2683;1341.5;0.5
0;KZ75125RUB2069100101;2017-02-13;2538;2538;1269;null;null;RUB;69;34.5;2607;1303.5;0.5
0;KZ75125RUB2069100101;2017-02-14;2482;2482;1241;null;null;RUB;56;28;2538;1269;0.5
0;KZ75125RUB2069100101;2017-02-15;2549;2549;1274.5;67;33.5;RUB;null;null;2482;1241;0.5
0;KZ75125RUB2069100101;2017-02-16;2471;2471;1235.5;null;null;RUB;78;39;2549;1274.5;0.5
0;KZ75125RUB2069100101;2017-02-17;2445;2445;1222.5;null;null;RUB;26;13;2471;1235.5;0.5
0;KZ75125RUB2069100101;2017-02-18;2450;2450;1225;5;2.5;RUB;null;null;2445;1222.5;0.5
0;KZ75125RUB2069100101;2017-02-19;2423;2423;1211.5;null;null;RUB;27;13.5;2450;1225;0.5
0;KZ75125RUB2069100101;2017-02-20;2357;2357;1178.5;null;null;RUB;66;33;2423;1211.5;0.5
0;KZ75125RUB2069100101;2017-02-21;2282;2282;1141;null;null;RUB;75;37.5;2357;1178.5;0.5
0;KZ75125RUB2069100101;2017-02-22;2244;2244;1122;null;null;RUB;38;19;2282;1141;0.5
0;KZ75125RUB2069100101;2017-02-23;2282;2282;1141;38;19;RUB;null;null;2244;1122;0.5
0;KZ75125RUB2069100101;2017-02-24;2208;2208;1104;null;null;RUB;74;37;2282;1141;0.5
0;KZ75125RUB2069100101;2017-02-25;2249;2249;1124.5;41;20.5;RUB;null;null;2208;1104;0.5
0;KZ75125RUB2069100101;2017-02-26;2314;2314;1157;65;32.5;RUB;null;null;2249;1124.5;0.5
0;KZ75125RUB2069100101;2017-02-27;2277;2277;1138.5;null;null;RUB;37;18.5;2314;1157;0.5
0;KZ75125RUB2069100101;2017-02-28;2267;2267;1133.5;null;null;RUB;10;5;2277;1138.5;0.5
0;KZ75125RUB2069100101;2017-03-01;2223;2223;1111.5;null;null;RUB;44;22;2267;1133.5;0.5
0;KZ75125RUB2069100101;2017-03-02;2180;2180;1090;null;null;RUB;43;21.5;2223;1111.5;0.5
0;KZ75125RUB2069100101;2017-03-03;2275;2275;1137.5;95;47.5;RUB;null;null;2180;1090;0.5
0;KZ75125RUB2069100101;2017-03-04;2217;2217;1108.5;null;null;RUB;58;29;2275;1137.5;0.5
0;KZ75125RUB2069100101;2017-03-05;2187;2187;1093.5;null;null;RUB;30;15;2217;1108.5;0.5
0;KZ75125RUB2069100101;2017-03-06;2162;2162;1081;null;null;RUB;25;12.5;2187;1093.5;0.5
0;KZ75125RUB2069100101;2017-03-07;2215;2215;1107.5;53;26.5;RUB;null;null;2162;1081;0.5
0;KZ75125RUB2069100101;2017-03-08;2215;2215;1107.5;null;null;RUB;0;0;2215;1107.5;0.5
0;KZ75125RUB2069100101;2017-03-09;2194;2194;1097;null;null;RUB;21;10.5;2215;1107.5;0.5
0;KZ75125RUB2069100101;2017-03-10;2193;2193;1096.5;null;null;RUB;1;0.5;2194;1097;0.5
0;KZ75125RUB2069100101;2017-03-11;2117;2117;1058.5;null;null;RUB;76;38;2193;1096.5;0.5
0;KZ75125RUB2069100101;2017-03-12;2089;2089;1044.5;null;null;RUB;28;14;2117;1058.5;0.5
0;KZ75125RUB2069100101;2017-03-13;2066;2066;1033;null;null;RUB;23;11.5;2089;1044.5;0.5
0;KZ75125RUB2069100101;2017-03-14;2057;2057;1028.5;null;null;RUB;9;4.5;2066;1033;0.5
0;KZ75125RUB2069100101;2017-03-15;1979;1979;989.5;null;null;RUB;78;39;2057;1028.5;0.5
0;KZ75125RUB2069100101;2017-03-16;1977;1977;988.5;null;null;RUB;2;1;1979;989.5;0.5
0;KZ75125RUB2069100101;2017-03-17;2064;2064;1032;87;43.5;RUB;null;null;1977;988.5;0.5
0;KZ75125RUB2069100101;2017-03-18;2131;2131;1065.5;67;33.5;RUB;null;null;2064;1032;0.5
0;KZ75125RUB2069100101;2017-03-19;2151;2151;1075.5;20;10;RUB;null;null;2131;1065.5;0.5
0;KZ75125RUB2069100101;2017-03-20;2230;2230;1115;79;39.5;RUB;null;null;2151;1075.5;0.5
0;KZ75125RUB2069100101;2017-03-21;2275;2275;1137.5;45;22.5;RUB;null;null;2230;1115;0.5
0;KZ75125RUB2069100101;2017-03-22;2284;2284;1142;9;4.5;RUB;null;null;2275;1137.5;0.5
0;KZ75125RUB2069100101;2017-03-23;2324;2324;1162;40;20;RUB;null;null;2284;1142;0.5
0;KZ75125RUB2069100101;2017-03-24;2373;2373;1186.5;49;24.5;RUB;null;null;2324;1162;0.5
0;KZ75125RUB2069100101;2017-03-25;2404;2404;1202;31;15.5;RUB;null;null;2373;1186.5;0.5
0;KZ75125RUB2069100101;2017-03-26;2457;2457;1228.5;53;26.5;RUB;null;null;2404;1202;0.5
0;KZ75125RUB2069100101;2017-03-27;2375;2375;1187.5;null;null;RUB;82;41;2457;1228.5;0.5
0;KZ75125RUB2069100101;2017-03-28;2471;2471;1235.5;96;48;RUB;null;null;2375;1187.5;0.5
0;KZ75125RUB2069100101;2017-03-29;2396;2396;1198;null;null;RUB;75;37.5;2471;1235.5;0.5
0;KZ75125RUB2069100101;2017-03-30;2345;2345;1172.5;null;null;RUB;51;25.5;2396;1198;0.5
0;KZ75125RUB2069100101;2017-03-31;2321;2321;1160.5;null;null;RUB;24;12;2345;1172.5;0.5
0;KZ75125RUB2069100101;2017-04-01;2405;2405;1202.5;84;42;RUB;null;null;2321;1160.5;0.5
0;KZ75125RUB2069100101;2017-04-02;2349;2349;1174.5;null;null;RUB;56;28;2405;1202.5;0.5
0;KZ75125RUB2069100101;2017-04-03;2408;2408;1204;59;29.5;RUB;null;null;2349;1174.5;0.5
0;KZ75125RUB2069100101;2017-04-04;2461;2461;1230.5;53;26.5;RUB;null;null;2408;1204;0.5
0;KZ75125RUB2069100101;2017-04-05;2435;2435;1217.5;null;null;RUB;26;13;2461;1230.5;0.5
0;KZ75125RUB2069100101;2017-04-06;2424;2424;1212;null;null;RUB;11;5.5;2435;1217.5;0.5
0;KZ75125RUB2069100101;2017-04-07;2522;2522;1261;98;49;RUB;null;null;2424;1212;0.5
0;KZ75125RUB2069100101;2017-04-08;2494;2494;1247;null;null;RUB;28;14;2522;1261;0.5
0;KZ75125RUB2069100101;2017-04-09;2559;2559;1279.5;65;32.5;RUB;null;null;2494;1247;0.5
0;KZ75125RUB2069100101;2017-04-10;2617;2617;1308.5;58;29;RUB;null;null;2559;1279.5;0.5
0;KZ75125RUB2069100101;2017-04-11;2536;2536;1268;null;null;RUB;81;40.5;2617;1308.5;0.5
0;KZ75125RUB2069100101;2017-04-12;2570;2570;1285;34;17;RUB;null;null;2536;1268;0.5
0;KZ75125RUB2069100101;2017-04-13;2514;2514;1257;null;null;RUB;56;28;2570;1285;0.5
0;KZ75125RUB2069100101;2017-04-14;2558;2558;1279;44;22;RUB;null;null;2514;1257;0.5
0;KZ75125RUB2069100101;2017-04-15;2649;2649;1324.5;91;45.5;RUB;null;null;2558;1279;0.5
0;KZ75125RUB2069100101;2017-04-16;2712;2712;1356;63;31.5;RUB;null;null;2649;1324.5;0.5
0;KZ75125RUB2069100101;2017-04-17;2714;2714;1357;2;1;RUB;null;null;2712;1356;0.5
0;KZ75125RUB2069100101;2017-04-18;2701;2701;1350.5;null;null;RUB;13;6.5;2714;1357;0.5
0;KZ75125RUB2069100101;2017-04-19;2776;2776;1388;75;37.5;RUB;null;null;2701;1350.5;0.5
0;KZ75125RUB2069100101;2017-04-20;2788;2788;1394;12;6;RUB;null;null;2776;1388;0.5
0;KZ75125RUB2069100101;2017-04-21;2716;2716;1358;null;null;RUB;72;36;2788;1394;0.5
0;KZ75125RUB2069100101;2017-04-22;2714;2714;1357;null;null;RUB;2;1;2716;1358;0.5
0;KZ75125RUB2069100101;2017-04-23;2667;2667;1333.5;null;null;RUB;47;23.5;2714;1357;0.5
0;KZ75125RUB2069100101;2017-04-24;2659;2659;1329.5;null;null;RUB;8;4;2667;1333.5;0.5
0;KZ75125RUB2069100101;2017-04-25;2610;2610;1305;null;null;RUB;49;24.5;2659;1329.5;0.5
0;KZ75125RUB2069100101;2017-04-26;2621;2621;1310.5;11;5.5;RUB;null;null;2610;1305;0.5
0;KZ75125RUB2069100101;2017-04-27;2664;2664;1332;43;21.5;RUB;null;null;2621;1310.5;0.5
0;KZ75125RUB2069100101;2017-04-28;2690;2690;1345;26;13;RUB;null;null;2664;1332;0.5
0;KZ75125RUB2069100101;2017-04-29;2711;2711;1355.5;21;10.5;RUB;null;null;2690;1345;0.5
0;KZ75125RUB2069100101;2017-04-30;2666;2666;1333;null;null;RUB;45;22.5;2711;1355.5;0.5
0;KZ75125RUB2069100101;2017-05-01;2632;2632;1316;null;null;RUB;34;17;2666;1333;0.5
0;KZ75125RUB2069100101;2017-05-02;2696;2696;1348;64;32;RUB;null;null;2632;1316;0.5
0;KZ75125RUB2069100101;2017-05-03;2681;2681;1340.5;null;null;RUB;15;7.5;2696;1348;0.5
0;KZ75125RUB2069100101;2017-05-04;2590;2590;1295;null;null;RUB;91;45.5;2681;1340.5;0.5
0;KZ75125RUB2069100101;2017-05-05;2664;2664;1332;74;37;RUB;null;null;2590;1295;0.5
0;KZ75125RUB2069100101;2017-05-06;2596;2596;1298;null;null;RUB;68;34;2664;1332;0.5
0;KZ75125RUB2069100101;2017-05-07;2609;2609;1304.5;13;6.5;RUB;null;null;2596;1298;0.5
0;KZ75125RUB2069100101;2017-05-08;2596;2596;1298;null;null;RUB;13;6.5;2609;1304.5;0.5
0;KZ75125RUB2069100101;2017-05-09;2534;2534;1267;null;null;RUB;62;31;2596;1298;0.5
0;KZ75125RUB2069100101;2017-05-10;2483;2483;1241.5;null;null;RUB;51;25.5;2534;1267;0.5
0;KZ75125RUB2069100101;2017-05-11;2468;2468;1234;null;null;RUB;15;7.5;2483;1241.5;0.5
0;KZ75125RUB2069100101;2017-05-12;2486;2486;1243;18;9;RUB;null;null;2468;1234;0.5
0;KZ75125RUB2069100101;2017-05-13;2456;2456;1228;null;null;RUB;30;15;2486;1243;0.5
0;KZ75125RUB2069100101;2017-05-14;2507;2507;1253.5;51;25.5;RUB;null;null;2456;1228;0.5
0;KZ75125RUB2069100101;2017-05-15;2573;2573;1286.5;66;33;RUB;null;null;2507;1253.5;0.5
0;KZ75125RUB2069100101;2017-05-16;2593;2593;1296.5;20;10;RUB;null;null;2573;1286.5;0.5
0;KZ75125RUB2069100101;2017-05-17;2673;2673;1336.5;80;40;RUB;null;null;2593;1296.5;0.5
0;KZ75125RUB2069100101;2017-05-18;2689;2689;1344.5;16;8;RUB;null;null;2673;1336.5;0.5
0;KZ75125RUB2069100101;2017-05-19;2620;2620;1310;null;null;RUB;69;34.5;2689;1344.5;0.5
0;KZ75125RUB2069100101;2017-05-20;2609;2609;1304.5;null;null;RUB;11;5.5;2620;1310;0.5
0;KZ75125RUB2069100101;2017-05-21;2570;2570;1285;null;null;RUB;39;19.5;2609;1304.5;0.5
0;KZ75125RUB2069100101;2017-05-22;2475;2475;1237.5;null;null;RUB;95;47.5;2570;1285;0.5
0;KZ75125RUB2069100101;2017-05-23;2484;2484;1242;9;4.5;RUB;null;null;2475;1237.5;0.5
0;KZ75125RUB2069100101;2017-05-24;2470;2470;1235;null;null;RUB;14;7;2484;1242;0.5
0;KZ75125RUB2069100101;2017-05-25;2471;2471;1235.5;1;0.5;RUB;null;null;2470;1235;0.5
0;KZ75125RUB2069100101;2017-05-26;2422;2422;1211;null;null;RUB;49;24.5;2471;1235.5;0.5
0;KZ75125RUB2069100101;2017-05-27;2471;2471;1235.5;49;24.5;RUB;null;null;2422;1211;0.5
0;KZ75125RUB2069100101;2017-05-28;2487;2487;1243.5;16;8;RUB;null;null;2471;1235.5;0.5
0;KZ75125RUB2069100101;2017-05-29;2571;2571;1285.5;84;42;RUB;null;null;2487;1243.5;0.5
0;KZ75125RUB2069100101;2017-05-30;2582;2582;1291;11;5.5;RUB;null;null;2571;1285.5;0.5
0;KZ75125RUB2069100101;2017-05-31;2664;2664;1332;82;41;RUB;null;null;2582;1291;0.5
0;KZ75125RUB2069100101;2017-06-01;2651;2651;1325.5;null;null;RUB;13;6.5;2664;1332;0.5
0;KZ75125RUB2069100101;2017-06-02;2571;2571;1285.5;null;null;RUB;80;40;2651;1325.5;0.5
0;KZ75125RUB2069100101;2017-06-03;2499;2499;1249.5;null;null;RUB;72;36;2571;1285.5;0.5
0;KZ75125RUB2069100101;2017-06-04;2496;2496;1248;null;null;RUB;3;1.5;2499;1249.5;0.5
0;KZ75125RUB2069100101;2017-06-05;2406;2406;1203;null;null;RUB;90;45;2496;1248;0.5
0;KZ75125RUB2069100101;2017-06-06;2496;2496;1248;90;45;RUB;null;null;2406;1203;0.5
0;KZ75125RUB2069100101;2017-06-07;2547;2547;1273.5;51;25.5;RUB;null;null;2496;1248;0.5
0;KZ75125RUB2069100101;2017-06-08;2616;2616;1308;69;34.5;RUB;null;null;2547;1273.5;0.5
0;KZ75125RUB2069100101;2017-06-09;2543;2543;1271.5;null;null;RUB;73;36.5;2616;1308;0.5
0;KZ75125RUB2069100101;2017-06-10;2637;2637;1318.5;94;47;RUB;null;null;2543;1271.5;0.5
0;KZ75125RUB2069100101;2017-06-11;2605;2605;1302.5;null;null;RUB;32;16;2637;1318.5;0.5
0;KZ75125RUB2069100101;2017-06-12;2524;2524;1262;null;null;RUB;81;40.5;2605;1302.5;0.5
0;KZ75125USD2069100102;2015-05-11;188;188;94;88;44;USD;null;null;100;50;0.5
0;KZ75125USD2069100102;2015-05-12;186;186;93;null;null;USD;2;1;188;94;0.5
0;KZ75125USD2069100102;2015-05-13;261;261;130.5;75;37.5;USD;null;null;186;93;0.5
0;KZ75125USD2069100102;2015-05-14;231;231;115.5;null;null;USD;30;15;261;130.5;0.5
0;KZ75125USD2069100102;2015-05-15;279;279;139.5;48;24;USD;null;null;231;115.5;0.5
0;KZ75125USD2069100102;2015-05-16;378;378;189;99;49.5;USD;null;null;279;139.5;0.5
0;KZ75125USD2069100102;2015-05-17;473;473;236.5;95;47.5;USD;null;null;378;189;0.5
0;KZ75125USD2069100102;2015-05-18;570;570;285;97;48.5;USD;null;null;473;236.5;0.5
0;KZ75125USD2069100102;2015-05-19;518;518;259;null;null;USD;52;26;570;285;0.5
0;KZ75125USD2069100102;2015-05-20;561;561;280.5;43;21.5;USD;null;null;518;259;0.5
0;KZ75125USD2069100102;2015-05-21;484;484;242;null;null;USD;77;38.5;561;280.5;0.5
0;KZ75125USD2069100102;2015-05-22;518;518;259;34;17;USD;null;null;484;242;0.5
0;KZ75125USD2069100102;2015-05-23;445;445;222.5;null;null;USD;73;36.5;518;259;0.5
0;KZ75125USD2069100102;2015-05-24;443;443;221.5;null;null;USD;2;1;445;222.5;0.5
0;KZ75125USD2069100102;2015-05-25;431;431;215.5;null;null;USD;12;6;443;221.5;0.5
0;KZ75125USD2069100102;2015-05-26;528;528;264;97;48.5;USD;null;null;431;215.5;0.5
0;KZ75125USD2069100102;2015-05-27;546;546;273;18;9;USD;null;null;528;264;0.5
0;KZ75125USD2069100102;2015-05-28;586;586;293;40;20;USD;null;null;546;273;0.5
0;KZ75125USD2069100102;2015-05-29;667;667;333.5;81;40.5;USD;null;null;586;293;0.5
0;KZ75125USD2069100102;2015-05-30;702;702;351;35;17.5;USD;null;null;667;333.5;0.5
0;KZ75125USD2069100102;2015-05-31;771;771;385.5;69;34.5;USD;null;null;702;351;0.5
0;KZ75125USD2069100102;2015-06-01;755;755;377.5;null;null;USD;16;8;771;385.5;0.5
0;KZ75125USD2069100102;2015-06-02;790;790;395;35;17.5;USD;null;null;755;377.5;0.5
0;KZ75125USD2069100102;2015-06-03;812;812;406;22;11;USD;null;null;790;395;0.5
0;KZ75125USD2069100102;2015-06-04;834;834;417;22;11;USD;null;null;812;406;0.5
0;KZ75125USD2069100102;2015-06-05;813;813;406.5;null;null;USD;21;10.5;834;417;0.5
0;KZ75125USD2069100102;2015-06-06;831;831;415.5;18;9;USD;null;null;813;406.5;0.5
0;KZ75125USD2069100102;2015-06-07;903;903;451.5;72;36;USD;null;null;831;415.5;0.5
0;KZ75125USD2069100102;2015-06-08;867;867;433.5;null;null;USD;36;18;903;451.5;0.5
0;KZ75125USD2069100102;2015-06-09;903;903;451.5;36;18;USD;null;null;867;433.5;0.5
0;KZ75125USD2069100102;2015-06-10;937;937;468.5;34;17;USD;null;null;903;451.5;0.5
0;KZ75125USD2069100102;2015-06-11;863;863;431.5;null;null;USD;74;37;937;468.5;0.5
0;KZ75125USD2069100102;2015-06-12;834;834;417;null;null;USD;29;14.5;863;431.5;0.5
0;KZ75125USD2069100102;2015-06-13;827;827;413.5;null;null;USD;7;3.5;834;417;0.5
0;KZ75125USD2069100102;2015-06-14;743;743;371.5;null;null;USD;84;42;827;413.5;0.5
0;KZ75125USD2069100102;2015-06-15;840;840;420;97;48.5;USD;null;null;743;371.5;0.5
0;KZ75125USD2069100102;2015-06-16;873;873;436.5;33;16.5;USD;null;null;840;420;0.5
0;KZ75125USD2069100102;2015-06-17;908;908;454;35;17.5;USD;null;null;873;436.5;0.5
0;KZ75125USD2069100102;2015-06-18;810;810;405;null;null;USD;98;49;908;454;0.5
0;KZ75125USD2069100102;2015-06-19;859;859;429.5;49;24.5;USD;null;null;810;405;0.5
0;KZ75125USD2069100102;2015-06-20;774;774;387;null;null;USD;85;42.5;859;429.5;0.5
0;KZ75125USD2069100102;2015-06-21;818;818;409;44;22;USD;null;null;774;387;0.5
0;KZ75125USD2069100102;2015-06-22;773;773;386.5;null;null;USD;45;22.5;818;409;0.5
0;KZ75125USD2069100102;2015-06-23;733;733;366.5;null;null;USD;40;20;773;386.5;0.5
0;KZ75125USD2069100102;2015-06-24;765;765;382.5;32;16;USD;null;null;733;366.5;0.5
0;KZ75125USD2069100102;2015-06-25;768;768;384;3;1.5;USD;null;null;765;382.5;0.5
0;KZ75125USD2069100102;2015-06-26;701;701;350.5;null;null;USD;67;33.5;768;384;0.5
0;KZ75125USD2069100102;2015-06-27;750;750;375;49;24.5;USD;null;null;701;350.5;0.5
0;KZ75125USD2069100102;2015-06-28;724;724;362;null;null;USD;26;13;750;375;0.5
0;KZ75125USD2069100102;2015-06-29;643;643;321.5;null;null;USD;81;40.5;724;362;0.5
0;KZ75125USD2069100102;2015-06-30;614;614;307;null;null;USD;29;14.5;643;321.5;0.5
0;KZ75125USD2069100102;2015-07-01;672;672;336;58;29;USD;null;null;614;307;0.5
0;KZ75125USD2069100102;2015-07-02;716;716;358;44;22;USD;null;null;672;336;0.5
0;KZ75125USD2069100102;2015-07-03;735;735;367.5;19;9.5;USD;null;null;716;358;0.5
0;KZ75125USD2069100102;2015-07-04;657;657;328.5;null;null;USD;78;39;735;367.5;0.5
0;KZ75125USD2069100102;2015-07-05;644;644;322;null;null;USD;13;6.5;657;328.5;0.5
0;KZ75125USD2069100102;2015-07-06;603;603;301.5;null;null;USD;41;20.5;644;322;0.5
0;KZ75125USD2069100102;2015-07-07;588;588;294;null;null;USD;15;7.5;603;301.5;0.5
0;KZ75125USD2069100102;2015-07-08;526;526;263;null;null;USD;62;31;588;294;0.5
0;KZ75125USD2069100102;2015-07-09;615;615;307.5;89;44.5;USD;null;null;526;263;0.5
0;KZ75125USD2069100102;2015-07-10;525;525;262.5;null;null;USD;90;45;615;307.5;0.5
0;KZ75125USD2069100102;2015-07-11;494;494;247;null;null;USD;31;15.5;525;262.5;0.5
0;KZ75125USD2069100102;2015-07-12;421;421;210.5;null;null;USD;73;36.5;494;247;0.5
0;KZ75125USD2069100102;2015-07-13;361;361;180.5;null;null;USD;60;30;421;210.5;0.5
0;KZ75125USD2069100102;2015-07-14;291;291;145.5;null;null;USD;70;35;361;180.5;0.5
0;KZ75125USD2069100102;2015-07-15;335;335;167.5;44;22;USD;null;null;291;145.5;0.5
0;KZ75125USD2069100102;2015-07-16;316;316;158;null;null;USD;19;9.5;335;167.5;0.5
0;KZ75125USD2069100102;2015-07-17;398;398;199;82;41;USD;null;null;316;158;0.5
0;KZ75125USD2069100102;2015-07-18;362;362;181;null;null;USD;36;18;398;199;0.5
0;KZ75125USD2069100102;2015-07-19;322;322;161;null;null;USD;40;20;362;181;0.5
0;KZ75125USD2069100102;2015-07-20;252;252;126;null;null;USD;70;35;322;161;0.5
0;KZ75125USD2069100102;2015-07-21;161;161;80.5;null;null;USD;91;45.5;252;126;0.5
0;KZ75125USD2069100102;2015-07-22;247;247;123.5;86;43;USD;null;null;161;80.5;0.5
0;KZ75125USD2069100102;2015-07-23;244;244;122;null;null;USD;3;1.5;247;123.5;0.5
0;KZ75125USD2069100102;2015-07-24;332;332;166;88;44;USD;null;null;244;122;0.5
0;KZ75125USD2069100102;2015-07-25;257;257;128.5;null;null;USD;75;37.5;332;166;0.5
0;KZ75125USD2069100102;2015-07-26;249;249;124.5;null;null;USD;8;4;257;128.5;0.5
0;KZ75125USD2069100102;2015-07-27;345;345;172.5;96;48;USD;null;null;249;124.5;0.5
0;KZ75125USD2069100102;2015-07-28;401;401;200.5;56;28;USD;null;null;345;172.5;0.5
0;KZ75125USD2069100102;2015-07-29;381;381;190.5;null;null;USD;20;10;401;200.5;0.5
0;KZ75125USD2069100102;2015-07-30;418;418;209;37;18.5;USD;null;null;381;190.5;0.5
0;KZ75125USD2069100102;2015-07-31;361;361;180.5;null;null;USD;57;28.5;418;209;0.5
0;KZ75125USD2069100102;2015-08-01;301;301;150.5;null;null;USD;60;30;361;180.5;0.5
0;KZ75125USD2069100102;2015-08-02;344;344;172;43;21.5;USD;null;null;301;150.5;0.5
0;KZ75125USD2069100102;2015-08-03;334;334;167;null;null;USD;10;5;344;172;0.5
0;KZ75125USD2069100102;2015-08-04;264;264;132;null;null;USD;70;35;334;167;0.5
0;KZ75125USD2069100102;2015-08-05;174;174;87;null;null;USD;90;45;264;132;0.5
0;KZ75125USD2069100102;2015-08-06;87;87;43.5;null;null;USD;87;43.5;174;87;0.5
0;KZ75125USD2069100102;2015-08-07;39;39;19.5;null;null;USD;48;24;87;43.5;0.5
0;KZ75125USD2069100102;2015-08-08;12;12;6;null;null;USD;27;13.5;39;19.5;0.5
0;KZ75125USD2069100102;2015-08-09;92;92;46;80;40;USD;null;null;12;6;0.5
0;KZ75125USD2069100102;2015-08-10;68;68;34;null;null;USD;24;12;92;46;0.5
0;KZ75125USD2069100102;2015-08-11;8;8;4;null;null;USD;60;30;68;34;0.5
0;KZ75125USD2069100102;2015-08-12;-36;-36;-18;null;null;USD;44;22;8;4;0.5
0;KZ75125USD2069100102;2015-08-13;-48;-48;-24;null;null;USD;12;6;-36;-18;0.5
0;KZ75125USD2069100102;2015-08-14;-36;-36;-18;12;6;USD;null;null;-48;-24;0.5
0;KZ75125USD2069100102;2015-08-15;-106;-106;-53;null;null;USD;70;35;-36;-18;0.5
0;KZ75125USD2069100102;2015-08-16;-159;-159;-79.5;null;null;USD;53;26.5;-106;-53;0.5
0;KZ75125USD2069100102;2015-08-17;-161;-161;-80.5;null;null;USD;2;1;-159;-79.5;0.5
0;KZ75125USD2069100102;2015-08-18;-196;-196;-98;null;null;USD;35;17.5;-161;-80.5;0.5
0;KZ75125USD2069100102;2015-08-19;-114;-114;-57;82;41;USD;null;null;-196;-98;0.5
0;KZ75125USD2069100102;2015-08-20;-105;-105;-52.5;9;4.5;USD;null;null;-114;-57;0.5
0;KZ75125USD2069100102;2015-08-21;-72;-72;-36;33;16.5;USD;null;null;-105;-52.5;0.5
0;KZ75125USD2069100102;2015-08-22;-94;-94;-47;null;null;USD;22;11;-72;-36;0.5
0;KZ75125USD2069100102;2015-08-23;-85;-85;-42.5;9;4.5;USD;null;null;-94;-47;0.5
0;KZ75125USD2069100102;2015-08-24;-72;-72;-36;13;6.5;USD;null;null;-85;-42.5;0.5
0;KZ75125USD2069100102;2015-08-25;-61;-61;-30.5;11;5.5;USD;null;null;-72;-36;0.5
0;KZ75125USD2069100102;2015-08-26;-34;-34;-17;27;13.5;USD;null;null;-61;-30.5;0.5
0;KZ75125USD2069100102;2015-08-27;-29;-29;-14.5;5;2.5;USD;null;null;-34;-17;0.5
0;KZ75125USD2069100102;2015-08-28;-6;-6;-3;23;11.5;USD;null;null;-29;-14.5;0.5
0;KZ75125USD2069100102;2015-08-29;-14;-14;-7;null;null;USD;8;4;-6;-3;0.5
0;KZ75125USD2069100102;2015-08-30;29;29;14.5;43;21.5;USD;null;null;-14;-7;0.5
0;KZ75125USD2069100102;2015-08-31;59;59;29.5;30;15;USD;null;null;29;14.5;0.5
0;KZ75125USD2069100102;2015-09-01;145;145;72.5;86;43;USD;null;null;59;29.5;0.5
0;KZ75125USD2069100102;2015-09-02;177;177;88.5;32;16;USD;null;null;145;72.5;0.5
0;KZ75125USD2069100102;2015-09-03;121;121;60.5;null;null;USD;56;28;177;88.5;0.5
0;KZ75125USD2069100102;2015-09-04;42;42;21;null;null;USD;79;39.5;121;60.5;0.5
0;KZ75125USD2069100102;2015-09-05;114;114;57;72;36;USD;null;null;42;21;0.5
0;KZ75125USD2069100102;2015-09-06;26;26;13;null;null;USD;88;44;114;57;0.5
0;KZ75125USD2069100102;2015-09-07;69;69;34.5;43;21.5;USD;null;null;26;13;0.5
0;KZ75125USD2069100102;2015-09-08;144;144;72;75;37.5;USD;null;null;69;34.5;0.5
0;KZ75125USD2069100102;2015-09-09;56;56;28;null;null;USD;88;44;144;72;0.5
0;KZ75125USD2069100102;2015-09-10;63;63;31.5;7;3.5;USD;null;null;56;28;0.5
0;KZ75125USD2069100102;2015-09-11;147;147;73.5;84;42;USD;null;null;63;31.5;0.5
0;KZ75125USD2069100102;2015-09-12;100;100;50;null;null;USD;47;23.5;147;73.5;0.5
0;KZ75125USD2069100102;2015-09-13;196;196;98;96;48;USD;null;null;100;50;0.5
0;KZ75125USD2069100102;2015-09-14;180;180;90;null;null;USD;16;8;196;98;0.5
0;KZ75125USD2069100102;2015-09-15;185;185;92.5;5;2.5;USD;null;null;180;90;0.5
0;KZ75125USD2069100102;2015-09-16;211;211;105.5;26;13;USD;null;null;185;92.5;0.5
0;KZ75125USD2069100102;2015-09-17;259;259;129.5;48;24;USD;null;null;211;105.5;0.5
0;KZ75125USD2069100102;2015-09-18;261;261;130.5;2;1;USD;null;null;259;129.5;0.5
0;KZ75125USD2069100102;2015-09-19;318;318;159;57;28.5;USD;null;null;261;130.5;0.5
0;KZ75125USD2069100102;2015-09-20;229;229;114.5;null;null;USD;89;44.5;318;159;0.5
0;KZ75125USD2069100102;2015-09-21;158;158;79;null;null;USD;71;35.5;229;114.5;0.5
0;KZ75125USD2069100102;2015-09-22;98;98;49;null;null;USD;60;30;158;79;0.5
0;KZ75125USD2069100102;2015-09-23;87;87;43.5;null;null;USD;11;5.5;98;49;0.5
0;KZ75125USD2069100102;2015-09-24;122;122;61;35;17.5;USD;null;null;87;43.5;0.5
0;KZ75125USD2069100102;2015-09-25;30;30;15;null;null;USD;92;46;122;61;0.5
0;KZ75125USD2069100102;2015-09-26;79;79;39.5;49;24.5;USD;null;null;30;15;0.5
0;KZ75125USD2069100102;2015-09-27;45;45;22.5;null;null;USD;34;17;79;39.5;0.5
0;KZ75125USD2069100102;2015-09-28;115;115;57.5;70;35;USD;null;null;45;22.5;0.5
0;KZ75125USD2069100102;2015-09-29;207;207;103.5;92;46;USD;null;null;115;57.5;0.5
0;KZ75125USD2069100102;2015-09-30;116;116;58;null;null;USD;91;45.5;207;103.5;0.5
0;KZ75125USD2069100102;2015-10-01;205;205;102.5;89;44.5;USD;null;null;116;58;0.5
0;KZ75125USD2069100102;2015-10-02;160;160;80;null;null;USD;45;22.5;205;102.5;0.5
0;KZ75125USD2069100102;2015-10-03;212;212;106;52;26;USD;null;null;160;80;0.5
0;KZ75125USD2069100102;2015-10-04;195;195;97.5;null;null;USD;17;8.5;212;106;0.5
0;KZ75125USD2069100102;2015-10-05;159;159;79.5;null;null;USD;36;18;195;97.5;0.5
0;KZ75125USD2069100102;2015-10-06;90;90;45;null;null;USD;69;34.5;159;79.5;0.5
0;KZ75125USD2069100102;2015-10-07;10;10;5;null;null;USD;80;40;90;45;0.5
0;KZ75125USD2069100102;2015-10-08;66;66;33;56;28;USD;null;null;10;5;0.5
0;KZ75125USD2069100102;2015-10-09;92;92;46;26;13;USD;null;null;66;33;0.5
0;KZ75125USD2069100102;2015-10-10;124;124;62;32;16;USD;null;null;92;46;0.5
0;KZ75125USD2069100102;2015-10-11;144;144;72;20;10;USD;null;null;124;62;0.5
0;KZ75125USD2069100102;2015-10-12;77;77;38.5;null;null;USD;67;33.5;144;72;0.5
0;KZ75125USD2069100102;2015-10-13;100;100;50;23;11.5;USD;null;null;77;38.5;0.5
0;KZ75125USD2069100102;2015-10-14;77;77;38.5;null;null;USD;23;11.5;100;50;0.5
0;KZ75125USD2069100102;2015-10-15;26;26;13;null;null;USD;51;25.5;77;38.5;0.5
0;KZ75125USD2069100102;2015-10-16;21;21;10.5;null;null;USD;5;2.5;26;13;0.5
0;KZ75125USD2069100102;2015-10-17;-55;-55;-27.5;null;null;USD;76;38;21;10.5;0.5
0;KZ75125USD2069100102;2015-10-18;-48;-48;-24;7;3.5;USD;null;null;-55;-27.5;0.5
0;KZ75125USD2069100102;2015-10-19;-86;-86;-43;null;null;USD;38;19;-48;-24;0.5
0;KZ75125USD2069100102;2015-10-20;-118;-118;-59;null;null;USD;32;16;-86;-43;0.5
0;KZ75125USD2069100102;2015-10-21;-47;-47;-23.5;71;35.5;USD;null;null;-118;-59;0.5
0;KZ75125USD2069100102;2015-10-22;-131;-131;-65.5;null;null;USD;84;42;-47;-23.5;0.5
0;KZ75125USD2069100102;2015-10-23;-84;-84;-42;47;23.5;USD;null;null;-131;-65.5;0.5
0;KZ75125USD2069100102;2015-10-24;-82;-82;-41;2;1;USD;null;null;-84;-42;0.5
0;KZ75125USD2069100102;2015-10-25;-76;-76;-38;6;3;USD;null;null;-82;-41;0.5
0;KZ75125USD2069100102;2015-10-26;-58;-58;-29;18;9;USD;null;null;-76;-38;0.5
0;KZ75125USD2069100102;2015-10-27;-6;-6;-3;52;26;USD;null;null;-58;-29;0.5
0;KZ75125USD2069100102;2015-10-28;52;52;26;58;29;USD;null;null;-6;-3;0.5
0;KZ75125USD2069100102;2015-10-29;-37;-37;-18.5;null;null;USD;89;44.5;52;26;0.5
0;KZ75125USD2069100102;2015-10-30;-124;-124;-62;null;null;USD;87;43.5;-37;-18.5;0.5
0;KZ75125USD2069100102;2015-10-31;-199;-199;-99.5;null;null;USD;75;37.5;-124;-62;0.5
0;KZ75125USD2069100102;2015-11-01;-259;-259;-129.5;null;null;USD;60;30;-199;-99.5;0.5
0;KZ75125USD2069100102;2015-11-02;-333;-333;-166.5;null;null;USD;74;37;-259;-129.5;0.5
0;KZ75125USD2069100102;2015-11-03;-378;-378;-189;null;null;USD;45;22.5;-333;-166.5;0.5
0;KZ75125USD2069100102;2015-11-04;-477;-477;-238.5;null;null;USD;99;49.5;-378;-189;0.5
0;KZ75125USD2069100102;2015-11-05;-507;-507;-253.5;null;null;USD;30;15;-477;-238.5;0.5
0;KZ75125USD2069100102;2015-11-06;-497;-497;-248.5;10;5;USD;null;null;-507;-253.5;0.5
0;KZ75125USD2069100102;2015-11-07;-506;-506;-253;null;null;USD;9;4.5;-497;-248.5;0.5
0;KZ75125USD2069100102;2015-11-08;-536;-536;-268;null;null;USD;30;15;-506;-253;0.5
0;KZ75125USD2069100102;2015-11-09;-554;-554;-277;null;null;USD;18;9;-536;-268;0.5
0;KZ75125USD2069100102;2015-11-10;-623;-623;-311.5;null;null;USD;69;34.5;-554;-277;0.5
0;KZ75125USD2069100102;2015-11-11;-653;-653;-326.5;null;null;USD;30;15;-623;-311.5;0.5
0;KZ75125USD2069100102;2015-11-12;-692;-692;-346;null;null;USD;39;19.5;-653;-326.5;0.5
0;KZ75125USD2069100102;2015-11-13;-748;-748;-374;null;null;USD;56;28;-692;-346;0.5
0;KZ75125USD2069100102;2015-11-14;-685;-685;-342.5;63;31.5;USD;null;null;-748;-374;0.5
0;KZ75125USD2069100102;2015-11-15;-655;-655;-327.5;30;15;USD;null;null;-685;-342.5;0.5
0;KZ75125USD2069100102;2015-11-16;-658;-658;-329;null;null;USD;3;1.5;-655;-327.5;0.5
0;KZ75125USD2069100102;2015-11-17;-685;-685;-342.5;null;null;USD;27;13.5;-658;-329;0.5
0;KZ75125USD2069100102;2015-11-18;-780;-780;-390;null;null;USD;95;47.5;-685;-342.5;0.5
0;KZ75125USD2069100102;2015-11-19;-700;-700;-350;80;40;USD;null;null;-780;-390;0.5
0;KZ75125USD2069100102;2015-11-20;-788;-788;-394;null;null;USD;88;44;-700;-350;0.5
0;KZ75125USD2069100102;2015-11-21;-709;-709;-354.5;79;39.5;USD;null;null;-788;-394;0.5
0;KZ75125USD2069100102;2015-11-22;-629;-629;-314.5;80;40;USD;null;null;-709;-354.5;0.5
0;KZ75125USD2069100102;2015-11-23;-596;-596;-298;33;16.5;USD;null;null;-629;-314.5;0.5
0;KZ75125USD2069100102;2015-11-24;-674;-674;-337;null;null;USD;78;39;-596;-298;0.5
0;KZ75125USD2069100102;2015-11-25;-650;-650;-325;24;12;USD;null;null;-674;-337;0.5
0;KZ75125USD2069100102;2015-11-26;-674;-674;-337;null;null;USD;24;12;-650;-325;0.5
0;KZ75125USD2069100102;2015-11-27;-603;-603;-301.5;71;35.5;USD;null;null;-674;-337;0.5
0;KZ75125USD2069100102;2015-11-28;-696;-696;-348;null;null;USD;93;46.5;-603;-301.5;0.5
0;KZ75125USD2069100102;2015-11-29;-723;-723;-361.5;null;null;USD;27;13.5;-696;-348;0.5
0;KZ75125USD2069100102;2015-11-30;-679;-679;-339.5;44;22;USD;null;null;-723;-361.5;0.5
0;KZ75125USD2069100102;2015-12-01;-707;-707;-353.5;null;null;USD;28;14;-679;-339.5;0.5
0;KZ75125USD2069100102;2015-12-02;-657;-657;-328.5;50;25;USD;null;null;-707;-353.5;0.5
0;KZ75125USD2069100102;2015-12-03;-605;-605;-302.5;52;26;USD;null;null;-657;-328.5;0.5
0;KZ75125USD2069100102;2015-12-04;-575;-575;-287.5;30;15;USD;null;null;-605;-302.5;0.5
0;KZ75125USD2069100102;2015-12-05;-637;-637;-318.5;null;null;USD;62;31;-575;-287.5;0.5
0;KZ75125USD2069100102;2015-12-06;-712;-712;-356;null;null;USD;75;37.5;-637;-318.5;0.5
0;KZ75125USD2069100102;2015-12-07;-692;-692;-346;20;10;USD;null;null;-712;-356;0.5
0;KZ75125USD2069100102;2015-12-08;-707;-707;-353.5;null;null;USD;15;7.5;-692;-346;0.5
0;KZ75125USD2069100102;2015-12-09;-712;-712;-356;null;null;USD;5;2.5;-707;-353.5;0.5
0;KZ75125USD2069100102;2015-12-10;-806;-806;-403;null;null;USD;94;47;-712;-356;0.5
0;KZ75125USD2069100102;2015-12-11;-839;-839;-419.5;null;null;USD;33;16.5;-806;-403;0.5
0;KZ75125USD2069100102;2015-12-12;-910;-910;-455;null;null;USD;71;35.5;-839;-419.5;0.5
0;KZ75125USD2069100102;2015-12-13;-943;-943;-471.5;null;null;USD;33;16.5;-910;-455;0.5
0;KZ75125USD2069100102;2015-12-14;-869;-869;-434.5;74;37;USD;null;null;-943;-471.5;0.5
0;KZ75125USD2069100102;2015-12-15;-803;-803;-401.5;66;33;USD;null;null;-869;-434.5;0.5
0;KZ75125USD2069100102;2015-12-16;-809;-809;-404.5;null;null;USD;6;3;-803;-401.5;0.5
0;KZ75125USD2069100102;2015-12-17;-777;-777;-388.5;32;16;USD;null;null;-809;-404.5;0.5
0;KZ75125USD2069100102;2015-12-18;-800;-800;-400;null;null;USD;23;11.5;-777;-388.5;0.5
0;KZ75125USD2069100102;2015-12-19;-867;-867;-433.5;null;null;USD;67;33.5;-800;-400;0.5
0;KZ75125USD2069100102;2015-12-20;-808;-808;-404;59;29.5;USD;null;null;-867;-433.5;0.5
0;KZ75125USD2069100102;2015-12-21;-793;-793;-396.5;15;7.5;USD;null;null;-808;-404;0.5
0;KZ75125USD2069100102;2015-12-22;-846;-846;-423;null;null;USD;53;26.5;-793;-396.5;0.5
0;KZ75125USD2069100102;2015-12-23;-775;-775;-387.5;71;35.5;USD;null;null;-846;-423;0.5
0;KZ75125USD2069100102;2015-12-24;-827;-827;-413.5;null;null;USD;52;26;-775;-387.5;0.5
0;KZ75125USD2069100102;2015-12-25;-786;-786;-393;41;20.5;USD;null;null;-827;-413.5;0.5
0;KZ75125USD2069100102;2015-12-26;-772;-772;-386;14;7;USD;null;null;-786;-393;0.5
0;KZ75125USD2069100102;2015-12-27;-859;-859;-429.5;null;null;USD;87;43.5;-772;-386;0.5
0;KZ75125USD2069100102;2015-12-28;-931;-931;-465.5;null;null;USD;72;36;-859;-429.5;0.5
0;KZ75125USD2069100102;2015-12-29;-961;-961;-480.5;null;null;USD;30;15;-931;-465.5;0.5
0;KZ75125USD2069100102;2015-12-30;-991;-991;-495.5;null;null;USD;30;15;-961;-480.5;0.5
0;KZ75125USD2069100102;2015-12-31;-997;-997;-498.5;null;null;USD;6;3;-991;-495.5;0.5
0;KZ75125USD2069100102;2016-01-01;-1056;-1056;-528;null;null;USD;59;29.5;-997;-498.5;0.5
0;KZ75125USD2069100102;2016-01-02;-1024;-1024;-512;32;16;USD;null;null;-1056;-528;0.5
0;KZ75125USD2069100102;2016-01-03;-1067;-1067;-533.5;null;null;USD;43;21.5;-1024;-512;0.5
0;KZ75125USD2069100102;2016-01-04;-1092;-1092;-546;null;null;USD;25;12.5;-1067;-533.5;0.5
0;KZ75125USD2069100102;2016-01-05;-1173;-1173;-586.5;null;null;USD;81;40.5;-1092;-546;0.5
0;KZ75125USD2069100102;2016-01-06;-1141;-1141;-570.5;32;16;USD;null;null;-1173;-586.5;0.5
0;KZ75125USD2069100102;2016-01-07;-1155;-1155;-577.5;null;null;USD;14;7;-1141;-570.5;0.5
0;KZ75125USD2069100102;2016-01-08;-1083;-1083;-541.5;72;36;USD;null;null;-1155;-577.5;0.5
0;KZ75125USD2069100102;2016-01-09;-1159;-1159;-579.5;null;null;USD;76;38;-1083;-541.5;0.5
0;KZ75125USD2069100102;2016-01-10;-1102;-1102;-551;57;28.5;USD;null;null;-1159;-579.5;0.5
0;KZ75125USD2069100102;2016-01-11;-1095;-1095;-547.5;7;3.5;USD;null;null;-1102;-551;0.5
0;KZ75125USD2069100102;2016-01-12;-1172;-1172;-586;null;null;USD;77;38.5;-1095;-547.5;0.5
0;KZ75125USD2069100102;2016-01-13;-1152;-1152;-576;20;10;USD;null;null;-1172;-586;0.5
0;KZ75125USD2069100102;2016-01-14;-1198;-1198;-599;null;null;USD;46;23;-1152;-576;0.5
0;KZ75125USD2069100102;2016-01-15;-1119;-1119;-559.5;79;39.5;USD;null;null;-1198;-599;0.5
0;KZ75125USD2069100102;2016-01-16;-1128;-1128;-564;null;null;USD;9;4.5;-1119;-559.5;0.5
0;KZ75125USD2069100102;2016-01-17;-1099;-1099;-549.5;29;14.5;USD;null;null;-1128;-564;0.5
0;KZ75125USD2069100102;2016-01-18;-1139;-1139;-569.5;null;null;USD;40;20;-1099;-549.5;0.5
0;KZ75125USD2069100102;2016-01-19;-1087;-1087;-543.5;52;26;USD;null;null;-1139;-569.5;0.5
0;KZ75125USD2069100102;2016-01-20;-1077;-1077;-538.5;10;5;USD;null;null;-1087;-543.5;0.5
0;KZ75125USD2069100102;2016-01-21;-1118;-1118;-559;null;null;USD;41;20.5;-1077;-538.5;0.5
0;KZ75125USD2069100102;2016-01-22;-1185;-1185;-592.5;null;null;USD;67;33.5;-1118;-559;0.5
0;KZ75125USD2069100102;2016-01-23;-1199;-1199;-599.5;null;null;USD;14;7;-1185;-592.5;0.5
0;KZ75125USD2069100102;2016-01-24;-1192;-1192;-596;7;3.5;USD;null;null;-1199;-599.5;0.5
0;KZ75125USD2069100102;2016-01-25;-1206;-1206;-603;null;null;USD;14;7;-1192;-596;0.5
0;KZ75125USD2069100102;2016-01-26;-1229;-1229;-614.5;null;null;USD;23;11.5;-1206;-603;0.5
0;KZ75125USD2069100102;2016-01-27;-1194;-1194;-597;35;17.5;USD;null;null;-1229;-614.5;0.5
0;KZ75125USD2069100102;2016-01-28;-1203;-1203;-601.5;null;null;USD;9;4.5;-1194;-597;0.5
0;KZ75125USD2069100102;2016-01-29;-1178;-1178;-589;25;12.5;USD;null;null;-1203;-601.5;0.5
0;KZ75125USD2069100102;2016-01-30;-1180;-1180;-590;null;null;USD;2;1;-1178;-589;0.5
0;KZ75125USD2069100102;2016-01-31;-1170;-1170;-585;10;5;USD;null;null;-1180;-590;0.5
0;KZ75125USD2069100102;2016-02-01;-1135;-1135;-567.5;35;17.5;USD;null;null;-1170;-585;0.5
0;KZ75125USD2069100102;2016-02-02;-1138;-1138;-569;null;null;USD;3;1.5;-1135;-567.5;0.5
0;KZ75125USD2069100102;2016-02-03;-1223;-1223;-611.5;null;null;USD;85;42.5;-1138;-569;0.5
0;KZ75125USD2069100102;2016-02-04;-1235;-1235;-617.5;null;null;USD;12;6;-1223;-611.5;0.5
0;KZ75125USD2069100102;2016-02-05;-1263;-1263;-631.5;null;null;USD;28;14;-1235;-617.5;0.5
0;KZ75125USD2069100102;2016-02-06;-1310;-1310;-655;null;null;USD;47;23.5;-1263;-631.5;0.5
0;KZ75125USD2069100102;2016-02-07;-1398;-1398;-699;null;null;USD;88;44;-1310;-655;0.5
0;KZ75125USD2069100102;2016-02-08;-1310;-1310;-655;88;44;USD;null;null;-1398;-699;0.5
0;KZ75125USD2069100102;2016-02-09;-1239;-1239;-619.5;71;35.5;USD;null;null;-1310;-655;0.5
0;KZ75125USD2069100102;2016-02-10;-1239;-1239;-619.5;null;null;USD;0;0;-1239;-619.5;0.5
0;KZ75125USD2069100102;2016-02-11;-1181;-1181;-590.5;58;29;USD;null;null;-1239;-619.5;0.5
0;KZ75125USD2069100102;2016-02-12;-1171;-1171;-585.5;10;5;USD;null;null;-1181;-590.5;0.5
0;KZ75125USD2069100102;2016-02-13;-1142;-1142;-571;29;14.5;USD;null;null;-1171;-585.5;0.5
0;KZ75125USD2069100102;2016-02-14;-1134;-1134;-567;8;4;USD;null;null;-1142;-571;0.5
0;KZ75125USD2069100102;2016-02-15;-1036;-1036;-518;98;49;USD;null;null;-1134;-567;0.5
0;KZ75125USD2069100102;2016-02-16;-1030;-1030;-515;6;3;USD;null;null;-1036;-518;0.5
0;KZ75125USD2069100102;2016-02-17;-1001;-1001;-500.5;29;14.5;USD;null;null;-1030;-515;0.5
0;KZ75125USD2069100102;2016-02-18;-1029;-1029;-514.5;null;null;USD;28;14;-1001;-500.5;0.5
0;KZ75125USD2069100102;2016-02-19;-978;-978;-489;51;25.5;USD;null;null;-1029;-514.5;0.5
0;KZ75125USD2069100102;2016-02-20;-946;-946;-473;32;16;USD;null;null;-978;-489;0.5
0;KZ75125USD2069100102;2016-02-21;-990;-990;-495;null;null;USD;44;22;-946;-473;0.5
0;KZ75125USD2069100102;2016-02-22;-1017;-1017;-508.5;null;null;USD;27;13.5;-990;-495;0.5
0;KZ75125USD2069100102;2016-02-23;-1071;-1071;-535.5;null;null;USD;54;27;-1017;-508.5;0.5
0;KZ75125USD2069100102;2016-02-24;-1146;-1146;-573;null;null;USD;75;37.5;-1071;-535.5;0.5
0;KZ75125USD2069100102;2016-02-25;-1239;-1239;-619.5;null;null;USD;93;46.5;-1146;-573;0.5
0;KZ75125USD2069100102;2016-02-26;-1154;-1154;-577;85;42.5;USD;null;null;-1239;-619.5;0.5
0;KZ75125USD2069100102;2016-02-27;-1145;-1145;-572.5;9;4.5;USD;null;null;-1154;-577;0.5
0;KZ75125USD2069100102;2016-02-28;-1220;-1220;-610;null;null;USD;75;37.5;-1145;-572.5;0.5
0;KZ75125USD2069100102;2016-02-29;-1256;-1256;-628;null;null;USD;36;18;-1220;-610;0.5
0;KZ75125USD2069100102;2016-03-01;-1189;-1189;-594.5;67;33.5;USD;null;null;-1256;-628;0.5
0;KZ75125USD2069100102;2016-03-02;-1131;-1131;-565.5;58;29;USD;null;null;-1189;-594.5;0.5
0;KZ75125USD2069100102;2016-03-03;-1205;-1205;-602.5;null;null;USD;74;37;-1131;-565.5;0.5
0;KZ75125USD2069100102;2016-03-04;-1187;-1187;-593.5;18;9;USD;null;null;-1205;-602.5;0.5
0;KZ75125USD2069100102;2016-03-05;-1270;-1270;-635;null;null;USD;83;41.5;-1187;-593.5;0.5
0;KZ75125USD2069100102;2016-03-06;-1272;-1272;-636;null;null;USD;2;1;-1270;-635;0.5
0;KZ75125USD2069100102;2016-03-07;-1186;-1186;-593;86;43;USD;null;null;-1272;-636;0.5
0;KZ75125USD2069100102;2016-03-08;-1122;-1122;-561;64;32;USD;null;null;-1186;-593;0.5
0;KZ75125USD2069100102;2016-03-09;-1115;-1115;-557.5;7;3.5;USD;null;null;-1122;-561;0.5
0;KZ75125USD2069100102;2016-03-10;-1165;-1165;-582.5;null;null;USD;50;25;-1115;-557.5;0.5
0;KZ75125USD2069100102;2016-03-11;-1153;-1153;-576.5;12;6;USD;null;null;-1165;-582.5;0.5
0;KZ75125USD2069100102;2016-03-12;-1221;-1221;-610.5;null;null;USD;68;34;-1153;-576.5;0.5
0;KZ75125USD2069100102;2016-03-13;-1258;-1258;-629;null;null;USD;37;18.5;-1221;-610.5;0.5
0;KZ75125USD2069100102;2016-03-14;-1219;-1219;-609.5;39;19.5;USD;null;null;-1258;-629;0.5
0;KZ75125USD2069100102;2016-03-15;-1202;-1202;-601;17;8.5;USD;null;null;-1219;-609.5;0.5
0;KZ75125USD2069100102;2016-03-16;-1182;-1182;-591;20;10;USD;null;null;-1202;-601;0.5
0;KZ75125USD2069100102;2016-03-17;-1255;-1255;-627.5;null;null;USD;73;36.5;-1182;-591;0.5
0;KZ75125USD2069100102;2016-03-18;-1228;-1228;-614;27;13.5;USD;null;null;-1255;-627.5;0.5
0;KZ75125USD2069100102;2016-03-19;-1229;-1229;-614.5;null;null;USD;1;0.5;-1228;-614;0.5
0;KZ75125USD2069100102;2016-03-20;-1286;-1286;-643;null;null;USD;57;28.5;-1229;-614.5;0.5
0;KZ75125USD2069100102;2016-03-21;-1279;-1279;-639.5;7;3.5;USD;null;null;-1286;-643;0.5
0;KZ75125USD2069100102;2016-03-22;-1203;-1203;-601.5;76;38;USD;null;null;-1279;-639.5;0.5
0;KZ75125USD2069100102;2016-03-23;-1153;-1153;-576.5;50;25;USD;null;null;-1203;-601.5;0.5
0;KZ75125USD2069100102;2016-03-24;-1072;-1072;-536;81;40.5;USD;null;null;-1153;-576.5;0.5
0;KZ75125USD2069100102;2016-03-25;-1014;-1014;-507;58;29;USD;null;null;-1072;-536;0.5
0;KZ75125USD2069100102;2016-03-26;-969;-969;-484.5;45;22.5;USD;null;null;-1014;-507;0.5
0;KZ75125USD2069100102;2016-03-27;-974;-974;-487;null;null;USD;5;2.5;-969;-484.5;0.5
0;KZ75125USD2069100102;2016-03-28;-945;-945;-472.5;29;14.5;USD;null;null;-974;-487;0.5
0;KZ75125USD2069100102;2016-03-29;-864;-864;-432;81;40.5;USD;null;null;-945;-472.5;0.5
0;KZ75125USD2069100102;2016-03-30;-899;-899;-449.5;null;null;USD;35;17.5;-864;-432;0.5
0;KZ75125USD2069100102;2016-03-31;-812;-812;-406;87;43.5;USD;null;null;-899;-449.5;0.5
0;KZ75125USD2069100102;2016-04-01;-884;-884;-442;null;null;USD;72;36;-812;-406;0.5
0;KZ75125USD2069100102;2016-04-02;-845;-845;-422.5;39;19.5;USD;null;null;-884;-442;0.5
0;KZ75125USD2069100102;2016-04-03;-824;-824;-412;21;10.5;USD;null;null;-845;-422.5;0.5
0;KZ75125USD2069100102;2016-04-04;-766;-766;-383;58;29;USD;null;null;-824;-412;0.5
0;KZ75125USD2069100102;2016-04-05;-756;-756;-378;10;5;USD;null;null;-766;-383;0.5
0;KZ75125USD2069100102;2016-04-06;-716;-716;-358;40;20;USD;null;null;-756;-378;0.5
0;KZ75125USD2069100102;2016-04-07;-703;-703;-351.5;13;6.5;USD;null;null;-716;-358;0.5
0;KZ75125USD2069100102;2016-04-08;-700;-700;-350;3;1.5;USD;null;null;-703;-351.5;0.5
0;KZ75125USD2069100102;2016-04-09;-789;-789;-394.5;null;null;USD;89;44.5;-700;-350;0.5
0;KZ75125USD2069100102;2016-04-10;-806;-806;-403;null;null;USD;17;8.5;-789;-394.5;0.5
0;KZ75125USD2069100102;2016-04-11;-762;-762;-381;44;22;USD;null;null;-806;-403;0.5
0;KZ75125USD2069100102;2016-04-12;-773;-773;-386.5;null;null;USD;11;5.5;-762;-381;0.5
0;KZ75125USD2069100102;2016-04-13;-832;-832;-416;null;null;USD;59;29.5;-773;-386.5;0.5
0;KZ75125USD2069100102;2016-04-14;-796;-796;-398;36;18;USD;null;null;-832;-416;0.5
0;KZ75125USD2069100102;2016-04-15;-746;-746;-373;50;25;USD;null;null;-796;-398;0.5
0;KZ75125USD2069100102;2016-04-16;-690;-690;-345;56;28;USD;null;null;-746;-373;0.5
0;KZ75125USD2069100102;2016-04-17;-770;-770;-385;null;null;USD;80;40;-690;-345;0.5
0;KZ75125USD2069100102;2016-04-18;-859;-859;-429.5;null;null;USD;89;44.5;-770;-385;0.5
0;KZ75125USD2069100102;2016-04-19;-955;-955;-477.5;null;null;USD;96;48;-859;-429.5;0.5
0;KZ75125USD2069100102;2016-04-20;-1012;-1012;-506;null;null;USD;57;28.5;-955;-477.5;0.5
0;KZ75125USD2069100102;2016-04-21;-1008;-1008;-504;4;2;USD;null;null;-1012;-506;0.5
0;KZ75125USD2069100102;2016-04-22;-1029;-1029;-514.5;null;null;USD;21;10.5;-1008;-504;0.5
0;KZ75125USD2069100102;2016-04-23;-993;-993;-496.5;36;18;USD;null;null;-1029;-514.5;0.5
0;KZ75125USD2069100102;2016-04-24;-915;-915;-457.5;78;39;USD;null;null;-993;-496.5;0.5
0;KZ75125USD2069100102;2016-04-25;-847;-847;-423.5;68;34;USD;null;null;-915;-457.5;0.5
0;KZ75125USD2069100102;2016-04-26;-847;-847;-423.5;null;null;USD;0;0;-847;-423.5;0.5
0;KZ75125USD2069100102;2016-04-27;-797;-797;-398.5;50;25;USD;null;null;-847;-423.5;0.5
0;KZ75125USD2069100102;2016-04-28;-836;-836;-418;null;null;USD;39;19.5;-797;-398.5;0.5
0;KZ75125USD2069100102;2016-04-29;-831;-831;-415.5;5;2.5;USD;null;null;-836;-418;0.5
0;KZ75125USD2069100102;2016-04-30;-859;-859;-429.5;null;null;USD;28;14;-831;-415.5;0.5
0;KZ75125USD2069100102;2016-05-01;-767;-767;-383.5;92;46;USD;null;null;-859;-429.5;0.5
0;KZ75125USD2069100102;2016-05-02;-690;-690;-345;77;38.5;USD;null;null;-767;-383.5;0.5
0;KZ75125USD2069100102;2016-05-03;-657;-657;-328.5;33;16.5;USD;null;null;-690;-345;0.5
0;KZ75125USD2069100102;2016-05-04;-743;-743;-371.5;null;null;USD;86;43;-657;-328.5;0.5
0;KZ75125USD2069100102;2016-05-05;-815;-815;-407.5;null;null;USD;72;36;-743;-371.5;0.5
0;KZ75125USD2069100102;2016-05-06;-849;-849;-424.5;null;null;USD;34;17;-815;-407.5;0.5
0;KZ75125USD2069100102;2016-05-07;-831;-831;-415.5;18;9;USD;null;null;-849;-424.5;0.5
0;KZ75125USD2069100102;2016-05-08;-899;-899;-449.5;null;null;USD;68;34;-831;-415.5;0.5
0;KZ75125USD2069100102;2016-05-09;-827;-827;-413.5;72;36;USD;null;null;-899;-449.5;0.5
0;KZ75125USD2069100102;2016-05-10;-895;-895;-447.5;null;null;USD;68;34;-827;-413.5;0.5
0;KZ75125USD2069100102;2016-05-11;-969;-969;-484.5;null;null;USD;74;37;-895;-447.5;0.5
0;KZ75125USD2069100102;2016-05-12;-1001;-1001;-500.5;null;null;USD;32;16;-969;-484.5;0.5
0;KZ75125USD2069100102;2016-05-13;-924;-924;-462;77;38.5;USD;null;null;-1001;-500.5;0.5
0;KZ75125USD2069100102;2016-05-14;-896;-896;-448;28;14;USD;null;null;-924;-462;0.5
0;KZ75125USD2069100102;2016-05-15;-882;-882;-441;14;7;USD;null;null;-896;-448;0.5
0;KZ75125USD2069100102;2016-05-16;-821;-821;-410.5;61;30.5;USD;null;null;-882;-441;0.5
0;KZ75125USD2069100102;2016-05-17;-775;-775;-387.5;46;23;USD;null;null;-821;-410.5;0.5
0;KZ75125USD2069100102;2016-05-18;-681;-681;-340.5;94;47;USD;null;null;-775;-387.5;0.5
0;KZ75125USD2069100102;2016-05-19;-652;-652;-326;29;14.5;USD;null;null;-681;-340.5;0.5
0;KZ75125USD2069100102;2016-05-20;-720;-720;-360;null;null;USD;68;34;-652;-326;0.5
0;KZ75125USD2069100102;2016-05-21;-763;-763;-381.5;null;null;USD;43;21.5;-720;-360;0.5
0;KZ75125USD2069100102;2016-05-22;-794;-794;-397;null;null;USD;31;15.5;-763;-381.5;0.5
0;KZ75125USD2069100102;2016-05-23;-874;-874;-437;null;null;USD;80;40;-794;-397;0.5
0;KZ75125USD2069100102;2016-05-24;-798;-798;-399;76;38;USD;null;null;-874;-437;0.5
0;KZ75125USD2069100102;2016-05-25;-872;-872;-436;null;null;USD;74;37;-798;-399;0.5
0;KZ75125USD2069100102;2016-05-26;-963;-963;-481.5;null;null;USD;91;45.5;-872;-436;0.5
0;KZ75125USD2069100102;2016-05-27;-954;-954;-477;9;4.5;USD;null;null;-963;-481.5;0.5
0;KZ75125USD2069100102;2016-05-28;-857;-857;-428.5;97;48.5;USD;null;null;-954;-477;0.5
0;KZ75125USD2069100102;2016-05-29;-871;-871;-435.5;null;null;USD;14;7;-857;-428.5;0.5
0;KZ75125USD2069100102;2016-05-30;-893;-893;-446.5;null;null;USD;22;11;-871;-435.5;0.5
0;KZ75125USD2069100102;2016-05-31;-880;-880;-440;13;6.5;USD;null;null;-893;-446.5;0.5
0;KZ75125USD2069100102;2016-06-01;-893;-893;-446.5;null;null;USD;13;6.5;-880;-440;0.5
0;KZ75125USD2069100102;2016-06-02;-804;-804;-402;89;44.5;USD;null;null;-893;-446.5;0.5
0;KZ75125USD2069100102;2016-06-03;-864;-864;-432;null;null;USD;60;30;-804;-402;0.5
0;KZ75125USD2069100102;2016-06-04;-867;-867;-433.5;null;null;USD;3;1.5;-864;-432;0.5
0;KZ75125USD2069100102;2016-06-05;-966;-966;-483;null;null;USD;99;49.5;-867;-433.5;0.5
0;KZ75125USD2069100102;2016-06-06;-927;-927;-463.5;39;19.5;USD;null;null;-966;-483;0.5
0;KZ75125USD2069100102;2016-06-07;-893;-893;-446.5;34;17;USD;null;null;-927;-463.5;0.5
0;KZ75125USD2069100102;2016-06-08;-856;-856;-428;37;18.5;USD;null;null;-893;-446.5;0.5
0;KZ75125USD2069100102;2016-06-09;-852;-852;-426;4;2;USD;null;null;-856;-428;0.5
0;KZ75125USD2069100102;2016-06-10;-897;-897;-448.5;null;null;USD;45;22.5;-852;-426;0.5
0;KZ75125USD2069100102;2016-06-11;-884;-884;-442;13;6.5;USD;null;null;-897;-448.5;0.5
0;KZ75125USD2069100102;2016-06-12;-829;-829;-414.5;55;27.5;USD;null;null;-884;-442;0.5
0;KZ75125USD2069100102;2016-06-13;-776;-776;-388;53;26.5;USD;null;null;-829;-414.5;0.5
0;KZ75125USD2069100102;2016-06-14;-747;-747;-373.5;29;14.5;USD;null;null;-776;-388;0.5
0;KZ75125USD2069100102;2016-06-15;-840;-840;-420;null;null;USD;93;46.5;-747;-373.5;0.5
0;KZ75125USD2069100102;2016-06-16;-835;-835;-417.5;5;2.5;USD;null;null;-840;-420;0.5
0;KZ75125USD2069100102;2016-06-17;-746;-746;-373;89;44.5;USD;null;null;-835;-417.5;0.5
0;KZ75125USD2069100102;2016-06-18;-713;-713;-356.5;33;16.5;USD;null;null;-746;-373;0.5
0;KZ75125USD2069100102;2016-06-19;-619;-619;-309.5;94;47;USD;null;null;-713;-356.5;0.5
0;KZ75125USD2069100102;2016-06-20;-648;-648;-324;null;null;USD;29;14.5;-619;-309.5;0.5
0;KZ75125USD2069100102;2016-06-21;-682;-682;-341;null;null;USD;34;17;-648;-324;0.5
0;KZ75125USD2069100102;2016-06-22;-623;-623;-311.5;59;29.5;USD;null;null;-682;-341;0.5
0;KZ75125USD2069100102;2016-06-23;-635;-635;-317.5;null;null;USD;12;6;-623;-311.5;0.5
0;KZ75125USD2069100102;2016-06-24;-641;-641;-320.5;null;null;USD;6;3;-635;-317.5;0.5
0;KZ75125USD2069100102;2016-06-25;-632;-632;-316;9;4.5;USD;null;null;-641;-320.5;0.5
0;KZ75125USD2069100102;2016-06-26;-693;-693;-346.5;null;null;USD;61;30.5;-632;-316;0.5
0;KZ75125USD2069100102;2016-06-27;-722;-722;-361;null;null;USD;29;14.5;-693;-346.5;0.5
0;KZ75125USD2069100102;2016-06-28;-808;-808;-404;null;null;USD;86;43;-722;-361;0.5
0;KZ75125USD2069100102;2016-06-29;-710;-710;-355;98;49;USD;null;null;-808;-404;0.5
0;KZ75125USD2069100102;2016-06-30;-781;-781;-390.5;null;null;USD;71;35.5;-710;-355;0.5
0;KZ75125USD2069100102;2016-07-01;-688;-688;-344;93;46.5;USD;null;null;-781;-390.5;0.5
0;KZ75125USD2069100102;2016-07-02;-673;-673;-336.5;15;7.5;USD;null;null;-688;-344;0.5
0;KZ75125USD2069100102;2016-07-03;-759;-759;-379.5;null;null;USD;86;43;-673;-336.5;0.5
0;KZ75125USD2069100102;2016-07-04;-789;-789;-394.5;null;null;USD;30;15;-759;-379.5;0.5
0;KZ75125USD2069100102;2016-07-05;-803;-803;-401.5;null;null;USD;14;7;-789;-394.5;0.5
0;KZ75125USD2069100102;2016-07-06;-745;-745;-372.5;58;29;USD;null;null;-803;-401.5;0.5
0;KZ75125USD2069100102;2016-07-07;-796;-796;-398;null;null;USD;51;25.5;-745;-372.5;0.5
0;KZ75125USD2069100102;2016-07-08;-848;-848;-424;null;null;USD;52;26;-796;-398;0.5
0;KZ75125USD2069100102;2016-07-09;-897;-897;-448.5;null;null;USD;49;24.5;-848;-424;0.5
0;KZ75125USD2069100102;2016-07-10;-957;-957;-478.5;null;null;USD;60;30;-897;-448.5;0.5
0;KZ75125USD2069100102;2016-07-11;-949;-949;-474.5;8;4;USD;null;null;-957;-478.5;0.5
0;KZ75125USD2069100102;2016-07-12;-914;-914;-457;35;17.5;USD;null;null;-949;-474.5;0.5
0;KZ75125USD2069100102;2016-07-13;-828;-828;-414;86;43;USD;null;null;-914;-457;0.5
0;KZ75125USD2069100102;2016-07-14;-822;-822;-411;6;3;USD;null;null;-828;-414;0.5
0;KZ75125USD2069100102;2016-07-15;-823;-823;-411.5;null;null;USD;1;0.5;-822;-411;0.5
0;KZ75125USD2069100102;2016-07-16;-875;-875;-437.5;null;null;USD;52;26;-823;-411.5;0.5
0;KZ75125USD2069100102;2016-07-17;-889;-889;-444.5;null;null;USD;14;7;-875;-437.5;0.5
0;KZ75125USD2069100102;2016-07-18;-836;-836;-418;53;26.5;USD;null;null;-889;-444.5;0.5
0;KZ75125USD2069100102;2016-07-19;-805;-805;-402.5;31;15.5;USD;null;null;-836;-418;0.5
0;KZ75125USD2069100102;2016-07-20;-742;-742;-371;63;31.5;USD;null;null;-805;-402.5;0.5
0;KZ75125USD2069100102;2016-07-21;-811;-811;-405.5;null;null;USD;69;34.5;-742;-371;0.5
0;KZ75125USD2069100102;2016-07-22;-849;-849;-424.5;null;null;USD;38;19;-811;-405.5;0.5
0;KZ75125USD2069100102;2016-07-23;-827;-827;-413.5;22;11;USD;null;null;-849;-424.5;0.5
0;KZ75125USD2069100102;2016-07-24;-870;-870;-435;null;null;USD;43;21.5;-827;-413.5;0.5
0;KZ75125USD2069100102;2016-07-25;-784;-784;-392;86;43;USD;null;null;-870;-435;0.5
0;KZ75125USD2069100102;2016-07-26;-834;-834;-417;null;null;USD;50;25;-784;-392;0.5
0;KZ75125USD2069100102;2016-07-27;-832;-832;-416;2;1;USD;null;null;-834;-417;0.5
0;KZ75125USD2069100102;2016-07-28;-900;-900;-450;null;null;USD;68;34;-832;-416;0.5
0;KZ75125USD2069100102;2016-07-29;-893;-893;-446.5;7;3.5;USD;null;null;-900;-450;0.5
0;KZ75125USD2069100102;2016-07-30;-844;-844;-422;49;24.5;USD;null;null;-893;-446.5;0.5
0;KZ75125USD2069100102;2016-07-31;-847;-847;-423.5;null;null;USD;3;1.5;-844;-422;0.5
0;KZ75125USD2069100102;2016-08-01;-748;-748;-374;99;49.5;USD;null;null;-847;-423.5;0.5
0;KZ75125USD2069100102;2016-08-02;-741;-741;-370.5;7;3.5;USD;null;null;-748;-374;0.5
0;KZ75125USD2069100102;2016-08-03;-708;-708;-354;33;16.5;USD;null;null;-741;-370.5;0.5
0;KZ75125USD2069100102;2016-08-04;-650;-650;-325;58;29;USD;null;null;-708;-354;0.5
0;KZ75125USD2069100102;2016-08-05;-664;-664;-332;null;null;USD;14;7;-650;-325;0.5
0;KZ75125USD2069100102;2016-08-06;-628;-628;-314;36;18;USD;null;null;-664;-332;0.5
0;KZ75125USD2069100102;2016-08-07;-625;-625;-312.5;3;1.5;USD;null;null;-628;-314;0.5
0;KZ75125USD2069100102;2016-08-08;-527;-527;-263.5;98;49;USD;null;null;-625;-312.5;0.5
0;KZ75125USD2069100102;2016-08-09;-610;-610;-305;null;null;USD;83;41.5;-527;-263.5;0.5
0;KZ75125USD2069100102;2016-08-10;-602;-602;-301;8;4;USD;null;null;-610;-305;0.5
0;KZ75125USD2069100102;2016-08-11;-586;-586;-293;16;8;USD;null;null;-602;-301;0.5
0;KZ75125USD2069100102;2016-08-12;-624;-624;-312;null;null;USD;38;19;-586;-293;0.5
0;KZ75125USD2069100102;2016-08-13;-546;-546;-273;78;39;USD;null;null;-624;-312;0.5
0;KZ75125USD2069100102;2016-08-14;-467;-467;-233.5;79;39.5;USD;null;null;-546;-273;0.5
0;KZ75125USD2069100102;2016-08-15;-553;-553;-276.5;null;null;USD;86;43;-467;-233.5;0.5
0;KZ75125USD2069100102;2016-08-16;-613;-613;-306.5;null;null;USD;60;30;-553;-276.5;0.5
0;KZ75125USD2069100102;2016-08-17;-653;-653;-326.5;null;null;USD;40;20;-613;-306.5;0.5
0;KZ75125USD2069100102;2016-08-18;-554;-554;-277;99;49.5;USD;null;null;-653;-326.5;0.5
0;KZ75125USD2069100102;2016-08-19;-558;-558;-279;null;null;USD;4;2;-554;-277;0.5
0;KZ75125USD2069100102;2016-08-20;-609;-609;-304.5;null;null;USD;51;25.5;-558;-279;0.5
0;KZ75125USD2069100102;2016-08-21;-525;-525;-262.5;84;42;USD;null;null;-609;-304.5;0.5
0;KZ75125USD2069100102;2016-08-22;-584;-584;-292;null;null;USD;59;29.5;-525;-262.5;0.5
0;KZ75125USD2069100102;2016-08-23;-620;-620;-310;null;null;USD;36;18;-584;-292;0.5
0;KZ75125USD2069100102;2016-08-24;-599;-599;-299.5;21;10.5;USD;null;null;-620;-310;0.5
0;KZ75125USD2069100102;2016-08-25;-660;-660;-330;null;null;USD;61;30.5;-599;-299.5;0.5
0;KZ75125USD2069100102;2016-08-26;-695;-695;-347.5;null;null;USD;35;17.5;-660;-330;0.5
0;KZ75125USD2069100102;2016-08-27;-697;-697;-348.5;null;null;USD;2;1;-695;-347.5;0.5
0;KZ75125USD2069100102;2016-08-28;-639;-639;-319.5;58;29;USD;null;null;-697;-348.5;0.5
0;KZ75125USD2069100102;2016-08-29;-708;-708;-354;null;null;USD;69;34.5;-639;-319.5;0.5
0;KZ75125USD2069100102;2016-08-30;-711;-711;-355.5;null;null;USD;3;1.5;-708;-354;0.5
0;KZ75125USD2069100102;2016-08-31;-760;-760;-380;null;null;USD;49;24.5;-711;-355.5;0.5
0;KZ75125USD2069100102;2016-09-01;-696;-696;-348;64;32;USD;null;null;-760;-380;0.5
0;KZ75125USD2069100102;2016-09-02;-696;-696;-348;null;null;USD;0;0;-696;-348;0.5
0;KZ75125USD2069100102;2016-09-03;-627;-627;-313.5;69;34.5;USD;null;null;-696;-348;0.5
0;KZ75125USD2069100102;2016-09-04;-545;-545;-272.5;82;41;USD;null;null;-627;-313.5;0.5
0;KZ75125USD2069100102;2016-09-05;-470;-470;-235;75;37.5;USD;null;null;-545;-272.5;0.5
0;KZ75125USD2069100102;2016-09-06;-468;-468;-234;2;1;USD;null;null;-470;-235;0.5
0;KZ75125USD2069100102;2016-09-07;-563;-563;-281.5;null;null;USD;95;47.5;-468;-234;0.5
0;KZ75125USD2069100102;2016-09-08;-549;-549;-274.5;14;7;USD;null;null;-563;-281.5;0.5
0;KZ75125USD2069100102;2016-09-09;-469;-469;-234.5;80;40;USD;null;null;-549;-274.5;0.5
0;KZ75125USD2069100102;2016-09-10;-373;-373;-186.5;96;48;USD;null;null;-469;-234.5;0.5
0;KZ75125USD2069100102;2016-09-11;-285;-285;-142.5;88;44;USD;null;null;-373;-186.5;0.5
0;KZ75125USD2069100102;2016-09-12;-310;-310;-155;null;null;USD;25;12.5;-285;-142.5;0.5
0;KZ75125USD2069100102;2016-09-13;-381;-381;-190.5;null;null;USD;71;35.5;-310;-155;0.5
0;KZ75125USD2069100102;2016-09-14;-320;-320;-160;61;30.5;USD;null;null;-381;-190.5;0.5
0;KZ75125USD2069100102;2016-09-15;-260;-260;-130;60;30;USD;null;null;-320;-160;0.5
0;KZ75125USD2069100102;2016-09-16;-192;-192;-96;68;34;USD;null;null;-260;-130;0.5
0;KZ75125USD2069100102;2016-09-17;-237;-237;-118.5;null;null;USD;45;22.5;-192;-96;0.5
0;KZ75125USD2069100102;2016-09-18;-299;-299;-149.5;null;null;USD;62;31;-237;-118.5;0.5
0;KZ75125USD2069100102;2016-09-19;-222;-222;-111;77;38.5;USD;null;null;-299;-149.5;0.5
0;KZ75125USD2069100102;2016-09-20;-203;-203;-101.5;19;9.5;USD;null;null;-222;-111;0.5
0;KZ75125USD2069100102;2016-09-21;-203;-203;-101.5;null;null;USD;0;0;-203;-101.5;0.5
0;KZ75125USD2069100102;2016-09-22;-171;-171;-85.5;32;16;USD;null;null;-203;-101.5;0.5
0;KZ75125USD2069100102;2016-09-23;-225;-225;-112.5;null;null;USD;54;27;-171;-85.5;0.5
0;KZ75125USD2069100102;2016-09-24;-164;-164;-82;61;30.5;USD;null;null;-225;-112.5;0.5
0;KZ75125USD2069100102;2016-09-25;-245;-245;-122.5;null;null;USD;81;40.5;-164;-82;0.5
0;KZ75125USD2069100102;2016-09-26;-271;-271;-135.5;null;null;USD;26;13;-245;-122.5;0.5
0;KZ75125USD2069100102;2016-09-27;-241;-241;-120.5;30;15;USD;null;null;-271;-135.5;0.5
0;KZ75125USD2069100102;2016-09-28;-289;-289;-144.5;null;null;USD;48;24;-241;-120.5;0.5
0;KZ75125USD2069100102;2016-09-29;-224;-224;-112;65;32.5;USD;null;null;-289;-144.5;0.5
0;KZ75125USD2069100102;2016-09-30;-137;-137;-68.5;87;43.5;USD;null;null;-224;-112;0.5
0;KZ75125USD2069100102;2016-10-01;-213;-213;-106.5;null;null;USD;76;38;-137;-68.5;0.5
0;KZ75125USD2069100102;2016-10-02;-152;-152;-76;61;30.5;USD;null;null;-213;-106.5;0.5
0;KZ75125USD2069100102;2016-10-03;-209;-209;-104.5;null;null;USD;57;28.5;-152;-76;0.5
0;KZ75125USD2069100102;2016-10-04;-208;-208;-104;1;0.5;USD;null;null;-209;-104.5;0.5
0;KZ75125USD2069100102;2016-10-05;-273;-273;-136.5;null;null;USD;65;32.5;-208;-104;0.5
0;KZ75125USD2069100102;2016-10-06;-321;-321;-160.5;null;null;USD;48;24;-273;-136.5;0.5
0;KZ75125USD2069100102;2016-10-07;-296;-296;-148;25;12.5;USD;null;null;-321;-160.5;0.5
0;KZ75125USD2069100102;2016-10-08;-381;-381;-190.5;null;null;USD;85;42.5;-296;-148;0.5
0;KZ75125USD2069100102;2016-10-09;-450;-450;-225;null;null;USD;69;34.5;-381;-190.5;0.5
0;KZ75125USD2069100102;2016-10-10;-461;-461;-230.5;null;null;USD;11;5.5;-450;-225;0.5
0;KZ75125USD2069100102;2016-10-11;-494;-494;-247;null;null;USD;33;16.5;-461;-230.5;0.5
0;KZ75125USD2069100102;2016-10-12;-525;-525;-262.5;null;null;USD;31;15.5;-494;-247;0.5
0;KZ75125USD2069100102;2016-10-13;-464;-464;-232;61;30.5;USD;null;null;-525;-262.5;0.5
0;KZ75125USD2069100102;2016-10-14;-486;-486;-243;null;null;USD;22;11;-464;-232;0.5
0;KZ75125USD2069100102;2016-10-15;-429;-429;-214.5;57;28.5;USD;null;null;-486;-243;0.5
0;KZ75125USD2069100102;2016-10-16;-364;-364;-182;65;32.5;USD;null;null;-429;-214.5;0.5
0;KZ75125USD2069100102;2016-10-17;-425;-425;-212.5;null;null;USD;61;30.5;-364;-182;0.5
0;KZ75125USD2069100102;2016-10-18;-332;-332;-166;93;46.5;USD;null;null;-425;-212.5;0.5
0;KZ75125USD2069100102;2016-10-19;-250;-250;-125;82;41;USD;null;null;-332;-166;0.5
0;KZ75125USD2069100102;2016-10-20;-236;-236;-118;14;7;USD;null;null;-250;-125;0.5
0;KZ75125USD2069100102;2016-10-21;-308;-308;-154;null;null;USD;72;36;-236;-118;0.5
0;KZ75125USD2069100102;2016-10-22;-335;-335;-167.5;null;null;USD;27;13.5;-308;-154;0.5
0;KZ75125USD2069100102;2016-10-23;-301;-301;-150.5;34;17;USD;null;null;-335;-167.5;0.5
0;KZ75125USD2069100102;2016-10-24;-322;-322;-161;null;null;USD;21;10.5;-301;-150.5;0.5
0;KZ75125USD2069100102;2016-10-25;-418;-418;-209;null;null;USD;96;48;-322;-161;0.5
0;KZ75125USD2069100102;2016-10-26;-513;-513;-256.5;null;null;USD;95;47.5;-418;-209;0.5
0;KZ75125USD2069100102;2016-10-27;-436;-436;-218;77;38.5;USD;null;null;-513;-256.5;0.5
0;KZ75125USD2069100102;2016-10-28;-356;-356;-178;80;40;USD;null;null;-436;-218;0.5
0;KZ75125USD2069100102;2016-10-29;-415;-415;-207.5;null;null;USD;59;29.5;-356;-178;0.5
0;KZ75125USD2069100102;2016-10-30;-416;-416;-208;null;null;USD;1;0.5;-415;-207.5;0.5
0;KZ75125USD2069100102;2016-10-31;-464;-464;-232;null;null;USD;48;24;-416;-208;0.5
0;KZ75125USD2069100102;2016-11-01;-371;-371;-185.5;93;46.5;USD;null;null;-464;-232;0.5
0;KZ75125USD2069100102;2016-11-02;-368;-368;-184;3;1.5;USD;null;null;-371;-185.5;0.5
0;KZ75125USD2069100102;2016-11-03;-331;-331;-165.5;37;18.5;USD;null;null;-368;-184;0.5
0;KZ75125USD2069100102;2016-11-04;-352;-352;-176;null;null;USD;21;10.5;-331;-165.5;0.5
0;KZ75125USD2069100102;2016-11-05;-361;-361;-180.5;null;null;USD;9;4.5;-352;-176;0.5
0;KZ75125USD2069100102;2016-11-06;-293;-293;-146.5;68;34;USD;null;null;-361;-180.5;0.5
0;KZ75125USD2069100102;2016-11-07;-263;-263;-131.5;30;15;USD;null;null;-293;-146.5;0.5
0;KZ75125USD2069100102;2016-11-08;-355;-355;-177.5;null;null;USD;92;46;-263;-131.5;0.5
0;KZ75125USD2069100102;2016-11-09;-433;-433;-216.5;null;null;USD;78;39;-355;-177.5;0.5
0;KZ75125USD2069100102;2016-11-10;-464;-464;-232;null;null;USD;31;15.5;-433;-216.5;0.5
0;KZ75125USD2069100102;2016-11-11;-367;-367;-183.5;97;48.5;USD;null;null;-464;-232;0.5
0;KZ75125USD2069100102;2016-11-12;-294;-294;-147;73;36.5;USD;null;null;-367;-183.5;0.5
0;KZ75125USD2069100102;2016-11-13;-247;-247;-123.5;47;23.5;USD;null;null;-294;-147;0.5
0;KZ75125USD2069100102;2016-11-14;-182;-182;-91;65;32.5;USD;null;null;-247;-123.5;0.5
0;KZ75125USD2069100102;2016-11-15;-241;-241;-120.5;null;null;USD;59;29.5;-182;-91;0.5
0;KZ75125USD2069100102;2016-11-16;-181;-181;-90.5;60;30;USD;null;null;-241;-120.5;0.5
0;KZ75125USD2069100102;2016-11-17;-178;-178;-89;3;1.5;USD;null;null;-181;-90.5;0.5
0;KZ75125USD2069100102;2016-11-18;-174;-174;-87;4;2;USD;null;null;-178;-89;0.5
0;KZ75125USD2069100102;2016-11-19;-209;-209;-104.5;null;null;USD;35;17.5;-174;-87;0.5
0;KZ75125USD2069100102;2016-11-20;-232;-232;-116;null;null;USD;23;11.5;-209;-104.5;0.5
0;KZ75125USD2069100102;2016-11-21;-281;-281;-140.5;null;null;USD;49;24.5;-232;-116;0.5
0;KZ75125USD2069100102;2016-11-22;-217;-217;-108.5;64;32;USD;null;null;-281;-140.5;0.5
0;KZ75125USD2069100102;2016-11-23;-306;-306;-153;null;null;USD;89;44.5;-217;-108.5;0.5
0;KZ75125USD2069100102;2016-11-24;-269;-269;-134.5;37;18.5;USD;null;null;-306;-153;0.5
0;KZ75125USD2069100102;2016-11-25;-339;-339;-169.5;null;null;USD;70;35;-269;-134.5;0.5
0;KZ75125USD2069100102;2016-11-26;-319;-319;-159.5;20;10;USD;null;null;-339;-169.5;0.5
0;KZ75125USD2069100102;2016-11-27;-328;-328;-164;null;null;USD;9;4.5;-319;-159.5;0.5
0;KZ75125USD2069100102;2016-11-28;-424;-424;-212;null;null;USD;96;48;-328;-164;0.5
0;KZ75125USD2069100102;2016-11-29;-463;-463;-231.5;null;null;USD;39;19.5;-424;-212;0.5
0;KZ75125USD2069100102;2016-11-30;-472;-472;-236;null;null;USD;9;4.5;-463;-231.5;0.5
0;KZ75125USD2069100102;2016-12-01;-555;-555;-277.5;null;null;USD;83;41.5;-472;-236;0.5
0;KZ75125USD2069100102;2016-12-02;-460;-460;-230;95;47.5;USD;null;null;-555;-277.5;0.5
0;KZ75125USD2069100102;2016-12-03;-426;-426;-213;34;17;USD;null;null;-460;-230;0.5
0;KZ75125USD2069100102;2016-12-04;-470;-470;-235;null;null;USD;44;22;-426;-213;0.5
0;KZ75125USD2069100102;2016-12-05;-376;-376;-188;94;47;USD;null;null;-470;-235;0.5
0;KZ75125USD2069100102;2016-12-06;-362;-362;-181;14;7;USD;null;null;-376;-188;0.5
0;KZ75125USD2069100102;2016-12-07;-310;-310;-155;52;26;USD;null;null;-362;-181;0.5
0;KZ75125USD2069100102;2016-12-08;-404;-404;-202;null;null;USD;94;47;-310;-155;0.5
0;KZ75125USD2069100102;2016-12-09;-406;-406;-203;null;null;USD;2;1;-404;-202;0.5
0;KZ75125USD2069100102;2016-12-10;-388;-388;-194;18;9;USD;null;null;-406;-203;0.5
0;KZ75125USD2069100102;2016-12-11;-343;-343;-171.5;45;22.5;USD;null;null;-388;-194;0.5
0;KZ75125USD2069100102;2016-12-12;-324;-324;-162;19;9.5;USD;null;null;-343;-171.5;0.5
0;KZ75125USD2069100102;2016-12-13;-324;-324;-162;null;null;USD;0;0;-324;-162;0.5
0;KZ75125USD2069100102;2016-12-14;-413;-413;-206.5;null;null;USD;89;44.5;-324;-162;0.5
0;KZ75125USD2069100102;2016-12-15;-374;-374;-187;39;19.5;USD;null;null;-413;-206.5;0.5
0;KZ75125USD2069100102;2016-12-16;-357;-357;-178.5;17;8.5;USD;null;null;-374;-187;0.5
0;KZ75125USD2069100102;2016-12-17;-287;-287;-143.5;70;35;USD;null;null;-357;-178.5;0.5
0;KZ75125USD2069100102;2016-12-18;-341;-341;-170.5;null;null;USD;54;27;-287;-143.5;0.5
0;KZ75125USD2069100102;2016-12-19;-332;-332;-166;9;4.5;USD;null;null;-341;-170.5;0.5
0;KZ75125USD2069100102;2016-12-20;-395;-395;-197.5;null;null;USD;63;31.5;-332;-166;0.5
0;KZ75125USD2069100102;2016-12-21;-306;-306;-153;89;44.5;USD;null;null;-395;-197.5;0.5
0;KZ75125USD2069100102;2016-12-22;-279;-279;-139.5;27;13.5;USD;null;null;-306;-153;0.5
0;KZ75125USD2069100102;2016-12-23;-336;-336;-168;null;null;USD;57;28.5;-279;-139.5;0.5
0;KZ75125USD2069100102;2016-12-24;-349;-349;-174.5;null;null;USD;13;6.5;-336;-168;0.5
0;KZ75125USD2069100102;2016-12-25;-436;-436;-218;null;null;USD;87;43.5;-349;-174.5;0.5
0;KZ75125USD2069100102;2016-12-26;-411;-411;-205.5;25;12.5;USD;null;null;-436;-218;0.5
0;KZ75125USD2069100102;2016-12-27;-343;-343;-171.5;68;34;USD;null;null;-411;-205.5;0.5
0;KZ75125USD2069100102;2016-12-28;-427;-427;-213.5;null;null;USD;84;42;-343;-171.5;0.5
0;KZ75125USD2069100102;2016-12-29;-422;-422;-211;5;2.5;USD;null;null;-427;-213.5;0.5
0;KZ75125USD2069100102;2016-12-30;-510;-510;-255;null;null;USD;88;44;-422;-211;0.5
0;KZ75125USD2069100102;2016-12-31;-435;-435;-217.5;75;37.5;USD;null;null;-510;-255;0.5
0;KZ75125USD2069100102;2017-01-01;-475;-475;-237.5;null;null;USD;40;20;-435;-217.5;0.5
0;KZ75125USD2069100102;2017-01-02;-532;-532;-266;null;null;USD;57;28.5;-475;-237.5;0.5
0;KZ75125USD2069100102;2017-01-03;-551;-551;-275.5;null;null;USD;19;9.5;-532;-266;0.5
0;KZ75125USD2069100102;2017-01-04;-453;-453;-226.5;98;49;USD;null;null;-551;-275.5;0.5
0;KZ75125USD2069100102;2017-01-05;-526;-526;-263;null;null;USD;73;36.5;-453;-226.5;0.5
0;KZ75125USD2069100102;2017-01-06;-516;-516;-258;10;5;USD;null;null;-526;-263;0.5
0;KZ75125USD2069100102;2017-01-07;-490;-490;-245;26;13;USD;null;null;-516;-258;0.5
0;KZ75125USD2069100102;2017-01-08;-475;-475;-237.5;15;7.5;USD;null;null;-490;-245;0.5
0;KZ75125USD2069100102;2017-01-09;-433;-433;-216.5;42;21;USD;null;null;-475;-237.5;0.5
0;KZ75125USD2069100102;2017-01-10;-490;-490;-245;null;null;USD;57;28.5;-433;-216.5;0.5
0;KZ75125USD2069100102;2017-01-11;-511;-511;-255.5;null;null;USD;21;10.5;-490;-245;0.5
0;KZ75125USD2069100102;2017-01-12;-606;-606;-303;null;null;USD;95;47.5;-511;-255.5;0.5
0;KZ75125USD2069100102;2017-01-13;-687;-687;-343.5;null;null;USD;81;40.5;-606;-303;0.5
0;KZ75125USD2069100102;2017-01-14;-780;-780;-390;null;null;USD;93;46.5;-687;-343.5;0.5
0;KZ75125USD2069100102;2017-01-15;-797;-797;-398.5;null;null;USD;17;8.5;-780;-390;0.5
0;KZ75125USD2069100102;2017-01-16;-757;-757;-378.5;40;20;USD;null;null;-797;-398.5;0.5
0;KZ75125USD2069100102;2017-01-17;-778;-778;-389;null;null;USD;21;10.5;-757;-378.5;0.5
0;KZ75125USD2069100102;2017-01-18;-715;-715;-357.5;63;31.5;USD;null;null;-778;-389;0.5
0;KZ75125USD2069100102;2017-01-19;-716;-716;-358;null;null;USD;1;0.5;-715;-357.5;0.5
0;KZ75125USD2069100102;2017-01-20;-646;-646;-323;70;35;USD;null;null;-716;-358;0.5
0;KZ75125USD2069100102;2017-01-21;-604;-604;-302;42;21;USD;null;null;-646;-323;0.5
0;KZ75125USD2069100102;2017-01-22;-579;-579;-289.5;25;12.5;USD;null;null;-604;-302;0.5
0;KZ75125USD2069100102;2017-01-23;-657;-657;-328.5;null;null;USD;78;39;-579;-289.5;0.5
0;KZ75125USD2069100102;2017-01-24;-561;-561;-280.5;96;48;USD;null;null;-657;-328.5;0.5
0;KZ75125USD2069100102;2017-01-25;-552;-552;-276;9;4.5;USD;null;null;-561;-280.5;0.5
0;KZ75125USD2069100102;2017-01-26;-623;-623;-311.5;null;null;USD;71;35.5;-552;-276;0.5
0;KZ75125USD2069100102;2017-01-27;-633;-633;-316.5;null;null;USD;10;5;-623;-311.5;0.5
0;KZ75125USD2069100102;2017-01-28;-580;-580;-290;53;26.5;USD;null;null;-633;-316.5;0.5
0;KZ75125USD2069100102;2017-01-29;-556;-556;-278;24;12;USD;null;null;-580;-290;0.5
0;KZ75125USD2069100102;2017-01-30;-549;-549;-274.5;7;3.5;USD;null;null;-556;-278;0.5
0;KZ75125USD2069100102;2017-01-31;-491;-491;-245.5;58;29;USD;null;null;-549;-274.5;0.5
0;KZ75125USD2069100102;2017-02-01;-522;-522;-261;null;null;USD;31;15.5;-491;-245.5;0.5
0;KZ75125USD2069100102;2017-02-02;-524;-524;-262;null;null;USD;2;1;-522;-261;0.5
0;KZ75125USD2069100102;2017-02-03;-436;-436;-218;88;44;USD;null;null;-524;-262;0.5
0;KZ75125USD2069100102;2017-02-04;-533;-533;-266.5;null;null;USD;97;48.5;-436;-218;0.5
0;KZ75125USD2069100102;2017-02-05;-593;-593;-296.5;null;null;USD;60;30;-533;-266.5;0.5
0;KZ75125USD2069100102;2017-02-06;-531;-531;-265.5;62;31;USD;null;null;-593;-296.5;0.5
0;KZ75125USD2069100102;2017-02-07;-561;-561;-280.5;null;null;USD;30;15;-531;-265.5;0.5
0;KZ75125USD2069100102;2017-02-08;-547;-547;-273.5;14;7;USD;null;null;-561;-280.5;0.5
0;KZ75125USD2069100102;2017-02-09;-509;-509;-254.5;38;19;USD;null;null;-547;-273.5;0.5
0;KZ75125USD2069100102;2017-02-10;-604;-604;-302;null;null;USD;95;47.5;-509;-254.5;0.5
0;KZ75125USD2069100102;2017-02-11;-651;-651;-325.5;null;null;USD;47;23.5;-604;-302;0.5
0;KZ75125USD2069100102;2017-02-12;-652;-652;-326;null;null;USD;1;0.5;-651;-325.5;0.5
0;KZ75125USD2069100102;2017-02-13;-717;-717;-358.5;null;null;USD;65;32.5;-652;-326;0.5
0;KZ75125USD2069100102;2017-02-14;-646;-646;-323;71;35.5;USD;null;null;-717;-358.5;0.5
0;KZ75125USD2069100102;2017-02-15;-562;-562;-281;84;42;USD;null;null;-646;-323;0.5
0;KZ75125USD2069100102;2017-02-16;-523;-523;-261.5;39;19.5;USD;null;null;-562;-281;0.5
0;KZ75125USD2069100102;2017-02-17;-532;-532;-266;null;null;USD;9;4.5;-523;-261.5;0.5
0;KZ75125USD2069100102;2017-02-18;-556;-556;-278;null;null;USD;24;12;-532;-266;0.5
0;KZ75125USD2069100102;2017-02-19;-612;-612;-306;null;null;USD;56;28;-556;-278;0.5
0;KZ75125USD2069100102;2017-02-20;-596;-596;-298;16;8;USD;null;null;-612;-306;0.5
0;KZ75125USD2069100102;2017-02-21;-689;-689;-344.5;null;null;USD;93;46.5;-596;-298;0.5
0;KZ75125USD2069100102;2017-02-22;-729;-729;-364.5;null;null;USD;40;20;-689;-344.5;0.5
0;KZ75125USD2069100102;2017-02-23;-668;-668;-334;61;30.5;USD;null;null;-729;-364.5;0.5
0;KZ75125USD2069100102;2017-02-24;-615;-615;-307.5;53;26.5;USD;null;null;-668;-334;0.5
0;KZ75125USD2069100102;2017-02-25;-678;-678;-339;null;null;USD;63;31.5;-615;-307.5;0.5
0;KZ75125USD2069100102;2017-02-26;-639;-639;-319.5;39;19.5;USD;null;null;-678;-339;0.5
0;KZ75125USD2069100102;2017-02-27;-551;-551;-275.5;88;44;USD;null;null;-639;-319.5;0.5
0;KZ75125USD2069100102;2017-02-28;-460;-460;-230;91;45.5;USD;null;null;-551;-275.5;0.5
0;KZ75125USD2069100102;2017-03-01;-496;-496;-248;null;null;USD;36;18;-460;-230;0.5
0;KZ75125USD2069100102;2017-03-02;-431;-431;-215.5;65;32.5;USD;null;null;-496;-248;0.5
0;KZ75125USD2069100102;2017-03-03;-364;-364;-182;67;33.5;USD;null;null;-431;-215.5;0.5
0;KZ75125USD2069100102;2017-03-04;-450;-450;-225;null;null;USD;86;43;-364;-182;0.5
0;KZ75125USD2069100102;2017-03-05;-401;-401;-200.5;49;24.5;USD;null;null;-450;-225;0.5
0;KZ75125USD2069100102;2017-03-06;-429;-429;-214.5;null;null;USD;28;14;-401;-200.5;0.5
0;KZ75125USD2069100102;2017-03-07;-514;-514;-257;null;null;USD;85;42.5;-429;-214.5;0.5
0;KZ75125USD2069100102;2017-03-08;-584;-584;-292;null;null;USD;70;35;-514;-257;0.5
0;KZ75125USD2069100102;2017-03-09;-502;-502;-251;82;41;USD;null;null;-584;-292;0.5
0;KZ75125USD2069100102;2017-03-10;-573;-573;-286.5;null;null;USD;71;35.5;-502;-251;0.5
0;KZ75125USD2069100102;2017-03-11;-505;-505;-252.5;68;34;USD;null;null;-573;-286.5;0.5
0;KZ75125USD2069100102;2017-03-12;-566;-566;-283;null;null;USD;61;30.5;-505;-252.5;0.5
0;KZ75125USD2069100102;2017-03-13;-512;-512;-256;54;27;USD;null;null;-566;-283;0.5
0;KZ75125USD2069100102;2017-03-14;-472;-472;-236;40;20;USD;null;null;-512;-256;0.5
0;KZ75125USD2069100102;2017-03-15;-530;-530;-265;null;null;USD;58;29;-472;-236;0.5
0;KZ75125USD2069100102;2017-03-16;-527;-527;-263.5;3;1.5;USD;null;null;-530;-265;0.5
0;KZ75125USD2069100102;2017-03-17;-468;-468;-234;59;29.5;USD;null;null;-527;-263.5;0.5
0;KZ75125USD2069100102;2017-03-18;-433;-433;-216.5;35;17.5;USD;null;null;-468;-234;0.5
0;KZ75125USD2069100102;2017-03-19;-409;-409;-204.5;24;12;USD;null;null;-433;-216.5;0.5
0;KZ75125USD2069100102;2017-03-20;-428;-428;-214;null;null;USD;19;9.5;-409;-204.5;0.5
0;KZ75125USD2069100102;2017-03-21;-454;-454;-227;null;null;USD;26;13;-428;-214;0.5
0;KZ75125USD2069100102;2017-03-22;-391;-391;-195.5;63;31.5;USD;null;null;-454;-227;0.5
0;KZ75125USD2069100102;2017-03-23;-433;-433;-216.5;null;null;USD;42;21;-391;-195.5;0.5
0;KZ75125USD2069100102;2017-03-24;-445;-445;-222.5;null;null;USD;12;6;-433;-216.5;0.5
0;KZ75125USD2069100102;2017-03-25;-533;-533;-266.5;null;null;USD;88;44;-445;-222.5;0.5
0;KZ75125USD2069100102;2017-03-26;-529;-529;-264.5;4;2;USD;null;null;-533;-266.5;0.5
0;KZ75125USD2069100102;2017-03-27;-494;-494;-247;35;17.5;USD;null;null;-529;-264.5;0.5
0;KZ75125USD2069100102;2017-03-28;-499;-499;-249.5;null;null;USD;5;2.5;-494;-247;0.5
0;KZ75125USD2069100102;2017-03-29;-525;-525;-262.5;null;null;USD;26;13;-499;-249.5;0.5
0;KZ75125USD2069100102;2017-03-30;-519;-519;-259.5;6;3;USD;null;null;-525;-262.5;0.5
0;KZ75125USD2069100102;2017-03-31;-460;-460;-230;59;29.5;USD;null;null;-519;-259.5;0.5
0;KZ75125USD2069100102;2017-04-01;-551;-551;-275.5;null;null;USD;91;45.5;-460;-230;0.5
0;KZ75125USD2069100102;2017-04-02;-453;-453;-226.5;98;49;USD;null;null;-551;-275.5;0.5
0;KZ75125USD2069100102;2017-04-03;-505;-505;-252.5;null;null;USD;52;26;-453;-226.5;0.5
0;KZ75125USD2069100102;2017-04-04;-553;-553;-276.5;null;null;USD;48;24;-505;-252.5;0.5
0;KZ75125USD2069100102;2017-04-05;-463;-463;-231.5;90;45;USD;null;null;-553;-276.5;0.5
0;KZ75125USD2069100102;2017-04-06;-446;-446;-223;17;8.5;USD;null;null;-463;-231.5;0.5
0;KZ75125USD2069100102;2017-04-07;-391;-391;-195.5;55;27.5;USD;null;null;-446;-223;0.5
0;KZ75125USD2069100102;2017-04-08;-448;-448;-224;null;null;USD;57;28.5;-391;-195.5;0.5
0;KZ75125USD2069100102;2017-04-09;-542;-542;-271;null;null;USD;94;47;-448;-224;0.5
0;KZ75125USD2069100102;2017-04-10;-559;-559;-279.5;null;null;USD;17;8.5;-542;-271;0.5
0;KZ75125USD2069100102;2017-04-11;-570;-570;-285;null;null;USD;11;5.5;-559;-279.5;0.5
0;KZ75125USD2069100102;2017-04-12;-512;-512;-256;58;29;USD;null;null;-570;-285;0.5
0;KZ75125USD2069100102;2017-04-13;-606;-606;-303;null;null;USD;94;47;-512;-256;0.5
0;KZ75125USD2069100102;2017-04-14;-551;-551;-275.5;55;27.5;USD;null;null;-606;-303;0.5
0;KZ75125USD2069100102;2017-04-15;-471;-471;-235.5;80;40;USD;null;null;-551;-275.5;0.5
0;KZ75125USD2069100102;2017-04-16;-541;-541;-270.5;null;null;USD;70;35;-471;-235.5;0.5
0;KZ75125USD2069100102;2017-04-17;-545;-545;-272.5;null;null;USD;4;2;-541;-270.5;0.5
0;KZ75125USD2069100102;2017-04-18;-534;-534;-267;11;5.5;USD;null;null;-545;-272.5;0.5
0;KZ75125USD2069100102;2017-04-19;-573;-573;-286.5;null;null;USD;39;19.5;-534;-267;0.5
0;KZ75125USD2069100102;2017-04-20;-518;-518;-259;55;27.5;USD;null;null;-573;-286.5;0.5
0;KZ75125USD2069100102;2017-04-21;-519;-519;-259.5;null;null;USD;1;0.5;-518;-259;0.5
0;KZ75125USD2069100102;2017-04-22;-546;-546;-273;null;null;USD;27;13.5;-519;-259.5;0.5
0;KZ75125USD2069100102;2017-04-23;-502;-502;-251;44;22;USD;null;null;-546;-273;0.5
0;KZ75125USD2069100102;2017-04-24;-581;-581;-290.5;null;null;USD;79;39.5;-502;-251;0.5
0;KZ75125USD2069100102;2017-04-25;-554;-554;-277;27;13.5;USD;null;null;-581;-290.5;0.5
0;KZ75125USD2069100102;2017-04-26;-622;-622;-311;null;null;USD;68;34;-554;-277;0.5
0;KZ75125USD2069100102;2017-04-27;-656;-656;-328;null;null;USD;34;17;-622;-311;0.5
0;KZ75125USD2069100102;2017-04-28;-642;-642;-321;14;7;USD;null;null;-656;-328;0.5
0;KZ75125USD2069100102;2017-04-29;-641;-641;-320.5;1;0.5;USD;null;null;-642;-321;0.5
0;KZ75125USD2069100102;2017-04-30;-721;-721;-360.5;null;null;USD;80;40;-641;-320.5;0.5
0;KZ75125USD2069100102;2017-05-01;-776;-776;-388;null;null;USD;55;27.5;-721;-360.5;0.5
0;KZ75125USD2069100102;2017-05-02;-727;-727;-363.5;49;24.5;USD;null;null;-776;-388;0.5
0;KZ75125USD2069100102;2017-05-03;-801;-801;-400.5;null;null;USD;74;37;-727;-363.5;0.5
0;KZ75125USD2069100102;2017-05-04;-784;-784;-392;17;8.5;USD;null;null;-801;-400.5;0.5
0;KZ75125USD2069100102;2017-05-05;-853;-853;-426.5;null;null;USD;69;34.5;-784;-392;0.5
0;KZ75125USD2069100102;2017-05-06;-793;-793;-396.5;60;30;USD;null;null;-853;-426.5;0.5
0;KZ75125USD2069100102;2017-05-07;-875;-875;-437.5;null;null;USD;82;41;-793;-396.5;0.5
0;KZ75125USD2069100102;2017-05-08;-934;-934;-467;null;null;USD;59;29.5;-875;-437.5;0.5
0;KZ75125USD2069100102;2017-05-09;-964;-964;-482;null;null;USD;30;15;-934;-467;0.5
0;KZ75125USD2069100102;2017-05-10;-1037;-1037;-518.5;null;null;USD;73;36.5;-964;-482;0.5
0;KZ75125USD2069100102;2017-05-11;-1126;-1126;-563;null;null;USD;89;44.5;-1037;-518.5;0.5
0;KZ75125USD2069100102;2017-05-12;-1191;-1191;-595.5;null;null;USD;65;32.5;-1126;-563;0.5
0;KZ75125USD2069100102;2017-05-13;-1269;-1269;-634.5;null;null;USD;78;39;-1191;-595.5;0.5
0;KZ75125USD2069100102;2017-05-14;-1318;-1318;-659;null;null;USD;49;24.5;-1269;-634.5;0.5
0;KZ75125USD2069100102;2017-05-15;-1306;-1306;-653;12;6;USD;null;null;-1318;-659;0.5
0;KZ75125USD2069100102;2017-05-16;-1268;-1268;-634;38;19;USD;null;null;-1306;-653;0.5
0;KZ75125USD2069100102;2017-05-17;-1326;-1326;-663;null;null;USD;58;29;-1268;-634;0.5
0;KZ75125USD2069100102;2017-05-18;-1350;-1350;-675;null;null;USD;24;12;-1326;-663;0.5
0;KZ75125USD2069100102;2017-05-19;-1271;-1271;-635.5;79;39.5;USD;null;null;-1350;-675;0.5
0;KZ75125USD2069100102;2017-05-20;-1366;-1366;-683;null;null;USD;95;47.5;-1271;-635.5;0.5
0;KZ75125USD2069100102;2017-05-21;-1298;-1298;-649;68;34;USD;null;null;-1366;-683;0.5
0;KZ75125USD2069100102;2017-05-22;-1299;-1299;-649.5;null;null;USD;1;0.5;-1298;-649;0.5
0;KZ75125USD2069100102;2017-05-23;-1309;-1309;-654.5;null;null;USD;10;5;-1299;-649.5;0.5
0;KZ75125USD2069100102;2017-05-24;-1236;-1236;-618;73;36.5;USD;null;null;-1309;-654.5;0.5
0;KZ75125USD2069100102;2017-05-25;-1206;-1206;-603;30;15;USD;null;null;-1236;-618;0.5
0;KZ75125USD2069100102;2017-05-26;-1200;-1200;-600;6;3;USD;null;null;-1206;-603;0.5
0;KZ75125USD2069100102;2017-05-27;-1243;-1243;-621.5;null;null;USD;43;21.5;-1200;-600;0.5
0;KZ75125USD2069100102;2017-05-28;-1145;-1145;-572.5;98;49;USD;null;null;-1243;-621.5;0.5
0;KZ75125USD2069100102;2017-05-29;-1187;-1187;-593.5;null;null;USD;42;21;-1145;-572.5;0.5
0;KZ75125USD2069100102;2017-05-30;-1171;-1171;-585.5;16;8;USD;null;null;-1187;-593.5;0.5
0;KZ75125USD2069100102;2017-05-31;-1189;-1189;-594.5;null;null;USD;18;9;-1171;-585.5;0.5
0;KZ75125USD2069100102;2017-06-01;-1237;-1237;-618.5;null;null;USD;48;24;-1189;-594.5;0.5
0;KZ75125USD2069100102;2017-06-02;-1320;-1320;-660;null;null;USD;83;41.5;-1237;-618.5;0.5
0;KZ75125USD2069100102;2017-06-03;-1260;-1260;-630;60;30;USD;null;null;-1320;-660;0.5
0;KZ75125USD2069100102;2017-06-04;-1176;-1176;-588;84;42;USD;null;null;-1260;-630;0.5
0;KZ75125USD2069100102;2017-06-05;-1134;-1134;-567;42;21;USD;null;null;-1176;-588;0.5
0;KZ75125USD2069100102;2017-06-06;-1099;-1099;-549.5;35;17.5;USD;null;null;-1134;-567;0.5
0;KZ75125USD2069100102;2017-06-07;-1081;-1081;-540.5;18;9;USD;null;null;-1099;-549.5;0.5
0;KZ75125USD2069100102;2017-06-08;-1114;-1114;-557;null;null;USD;33;16.5;-1081;-540.5;0.5
0;KZ75125USD2069100102;2017-06-09;-1130;-1130;-565;null;null;USD;16;8;-1114;-557;0.5
0;KZ75125USD2069100102;2017-06-10;-1056;-1056;-528;74;37;USD;null;null;-1130;-565;0.5
0;KZ75125USD2069100102;2017-06-11;-1084;-1084;-542;null;null;USD;28;14;-1056;-528;0.5
0;KZ75125USD2069100102;2017-06-12;-1118;-1118;-559;null;null;USD;34;17;-1084;-542;0.5
0;KZ75125EUR2069100103;2015-05-11;132;132;66;32;16;EUR;null;null;100;50;0.5
0;KZ75125EUR2069100103;2015-05-12;132;132;66;null;null;EUR;0;0;132;66;0.5
0;KZ75125EUR2069100103;2015-05-13;195;195;97.5;63;31.5;EUR;null;null;132;66;0.5
0;KZ75125EUR2069100103;2015-05-14;228;228;114;33;16.5;EUR;null;null;195;97.5;0.5
0;KZ75125EUR2069100103;2015-05-15;218;218;109;null;null;EUR;10;5;228;114;0.5
0;KZ75125EUR2069100103;2015-05-16;296;296;148;78;39;EUR;null;null;218;109;0.5
0;KZ75125EUR2069100103;2015-05-17;251;251;125.5;null;null;EUR;45;22.5;296;148;0.5
0;KZ75125EUR2069100103;2015-05-18;182;182;91;null;null;EUR;69;34.5;251;125.5;0.5
0;KZ75125EUR2069100103;2015-05-19;235;235;117.5;53;26.5;EUR;null;null;182;91;0.5
0;KZ75125EUR2069100103;2015-05-20;230;230;115;null;null;EUR;5;2.5;235;117.5;0.5
0;KZ75125EUR2069100103;2015-05-21;316;316;158;86;43;EUR;null;null;230;115;0.5
0;KZ75125EUR2069100103;2015-05-22;314;314;157;null;null;EUR;2;1;316;158;0.5
0;KZ75125EUR2069100103;2015-05-23;229;229;114.5;null;null;EUR;85;42.5;314;157;0.5
0;KZ75125EUR2069100103;2015-05-24;294;294;147;65;32.5;EUR;null;null;229;114.5;0.5
0;KZ75125EUR2069100103;2015-05-25;284;284;142;null;null;EUR;10;5;294;147;0.5
0;KZ75125EUR2069100103;2015-05-26;221;221;110.5;null;null;EUR;63;31.5;284;142;0.5
0;KZ75125EUR2069100103;2015-05-27;141;141;70.5;null;null;EUR;80;40;221;110.5;0.5
0;KZ75125EUR2069100103;2015-05-28;54;54;27;null;null;EUR;87;43.5;141;70.5;0.5
0;KZ75125EUR2069100103;2015-05-29;39;39;19.5;null;null;EUR;15;7.5;54;27;0.5
0;KZ75125EUR2069100103;2015-05-30;-53;-53;-26.5;null;null;EUR;92;46;39;19.5;0.5
0;KZ75125EUR2069100103;2015-05-31;-28;-28;-14;25;12.5;EUR;null;null;-53;-26.5;0.5
0;KZ75125EUR2069100103;2015-06-01;-34;-34;-17;null;null;EUR;6;3;-28;-14;0.5
0;KZ75125EUR2069100103;2015-06-02;-34;-34;-17;null;null;EUR;0;0;-34;-17;0.5
0;KZ75125EUR2069100103;2015-06-03;-60;-60;-30;null;null;EUR;26;13;-34;-17;0.5
0;KZ75125EUR2069100103;2015-06-04;-58;-58;-29;2;1;EUR;null;null;-60;-30;0.5
0;KZ75125EUR2069100103;2015-06-05;-152;-152;-76;null;null;EUR;94;47;-58;-29;0.5
0;KZ75125EUR2069100103;2015-06-06;-246;-246;-123;null;null;EUR;94;47;-152;-76;0.5
0;KZ75125EUR2069100103;2015-06-07;-217;-217;-108.5;29;14.5;EUR;null;null;-246;-123;0.5
0;KZ75125EUR2069100103;2015-06-08;-233;-233;-116.5;null;null;EUR;16;8;-217;-108.5;0.5
0;KZ75125EUR2069100103;2015-06-09;-319;-319;-159.5;null;null;EUR;86;43;-233;-116.5;0.5
0;KZ75125EUR2069100103;2015-06-10;-222;-222;-111;97;48.5;EUR;null;null;-319;-159.5;0.5
0;KZ75125EUR2069100103;2015-06-11;-229;-229;-114.5;null;null;EUR;7;3.5;-222;-111;0.5
0;KZ75125EUR2069100103;2015-06-12;-253;-253;-126.5;null;null;EUR;24;12;-229;-114.5;0.5
0;KZ75125EUR2069100103;2015-06-13;-347;-347;-173.5;null;null;EUR;94;47;-253;-126.5;0.5
0;KZ75125EUR2069100103;2015-06-14;-425;-425;-212.5;null;null;EUR;78;39;-347;-173.5;0.5
0;KZ75125EUR2069100103;2015-06-15;-471;-471;-235.5;null;null;EUR;46;23;-425;-212.5;0.5
0;KZ75125EUR2069100103;2015-06-16;-541;-541;-270.5;null;null;EUR;70;35;-471;-235.5;0.5
0;KZ75125EUR2069100103;2015-06-17;-552;-552;-276;null;null;EUR;11;5.5;-541;-270.5;0.5
0;KZ75125EUR2069100103;2015-06-18;-558;-558;-279;null;null;EUR;6;3;-552;-276;0.5
0;KZ75125EUR2069100103;2015-06-19;-643;-643;-321.5;null;null;EUR;85;42.5;-558;-279;0.5
0;KZ75125EUR2069100103;2015-06-20;-595;-595;-297.5;48;24;EUR;null;null;-643;-321.5;0.5
0;KZ75125EUR2069100103;2015-06-21;-626;-626;-313;null;null;EUR;31;15.5;-595;-297.5;0.5
0;KZ75125EUR2069100103;2015-06-22;-704;-704;-352;null;null;EUR;78;39;-626;-313;0.5
0;KZ75125EUR2069100103;2015-06-23;-786;-786;-393;null;null;EUR;82;41;-704;-352;0.5
0;KZ75125EUR2069100103;2015-06-24;-797;-797;-398.5;null;null;EUR;11;5.5;-786;-393;0.5
0;KZ75125EUR2069100103;2015-06-25;-807;-807;-403.5;null;null;EUR;10;5;-797;-398.5;0.5
0;KZ75125EUR2069100103;2015-06-26;-862;-862;-431;null;null;EUR;55;27.5;-807;-403.5;0.5
0;KZ75125EUR2069100103;2015-06-27;-912;-912;-456;null;null;EUR;50;25;-862;-431;0.5
0;KZ75125EUR2069100103;2015-06-28;-909;-909;-454.5;3;1.5;EUR;null;null;-912;-456;0.5
0;KZ75125EUR2069100103;2015-06-29;-974;-974;-487;null;null;EUR;65;32.5;-909;-454.5;0.5
0;KZ75125EUR2069100103;2015-06-30;-963;-963;-481.5;11;5.5;EUR;null;null;-974;-487;0.5
0;KZ75125EUR2069100103;2015-07-01;-884;-884;-442;79;39.5;EUR;null;null;-963;-481.5;0.5
0;KZ75125EUR2069100103;2015-07-02;-837;-837;-418.5;47;23.5;EUR;null;null;-884;-442;0.5
0;KZ75125EUR2069100103;2015-07-03;-748;-748;-374;89;44.5;EUR;null;null;-837;-418.5;0.5
0;KZ75125EUR2069100103;2015-07-04;-715;-715;-357.5;33;16.5;EUR;null;null;-748;-374;0.5
0;KZ75125EUR2069100103;2015-07-05;-639;-639;-319.5;76;38;EUR;null;null;-715;-357.5;0.5
0;KZ75125EUR2069100103;2015-07-06;-614;-614;-307;25;12.5;EUR;null;null;-639;-319.5;0.5
0;KZ75125EUR2069100103;2015-07-07;-697;-697;-348.5;null;null;EUR;83;41.5;-614;-307;0.5
0;KZ75125EUR2069100103;2015-07-08;-748;-748;-374;null;null;EUR;51;25.5;-697;-348.5;0.5
0;KZ75125EUR2069100103;2015-07-09;-805;-805;-402.5;null;null;EUR;57;28.5;-748;-374;0.5
0;KZ75125EUR2069100103;2015-07-10;-725;-725;-362.5;80;40;EUR;null;null;-805;-402.5;0.5
0;KZ75125EUR2069100103;2015-07-11;-724;-724;-362;1;0.5;EUR;null;null;-725;-362.5;0.5
0;KZ75125EUR2069100103;2015-07-12;-661;-661;-330.5;63;31.5;EUR;null;null;-724;-362;0.5
0;KZ75125EUR2069100103;2015-07-13;-644;-644;-322;17;8.5;EUR;null;null;-661;-330.5;0.5
0;KZ75125EUR2069100103;2015-07-14;-712;-712;-356;null;null;EUR;68;34;-644;-322;0.5
0;KZ75125EUR2069100103;2015-07-15;-702;-702;-351;10;5;EUR;null;null;-712;-356;0.5
0;KZ75125EUR2069100103;2015-07-16;-699;-699;-349.5;3;1.5;EUR;null;null;-702;-351;0.5
0;KZ75125EUR2069100103;2015-07-17;-734;-734;-367;null;null;EUR;35;17.5;-699;-349.5;0.5
0;KZ75125EUR2069100103;2015-07-18;-736;-736;-368;null;null;EUR;2;1;-734;-367;0.5
0;KZ75125EUR2069100103;2015-07-19;-766;-766;-383;null;null;EUR;30;15;-736;-368;0.5
0;KZ75125EUR2069100103;2015-07-20;-819;-819;-409.5;null;null;EUR;53;26.5;-766;-383;0.5
0;KZ75125EUR2069100103;2015-07-21;-763;-763;-381.5;56;28;EUR;null;null;-819;-409.5;0.5
0;KZ75125EUR2069100103;2015-07-22;-691;-691;-345.5;72;36;EUR;null;null;-763;-381.5;0.5
0;KZ75125EUR2069100103;2015-07-23;-640;-640;-320;51;25.5;EUR;null;null;-691;-345.5;0.5
0;KZ75125EUR2069100103;2015-07-24;-553;-553;-276.5;87;43.5;EUR;null;null;-640;-320;0.5
0;KZ75125EUR2069100103;2015-07-25;-508;-508;-254;45;22.5;EUR;null;null;-553;-276.5;0.5
0;KZ75125EUR2069100103;2015-07-26;-508;-508;-254;null;null;EUR;0;0;-508;-254;0.5
0;KZ75125EUR2069100103;2015-07-27;-554;-554;-277;null;null;EUR;46;23;-508;-254;0.5
0;KZ75125EUR2069100103;2015-07-28;-574;-574;-287;null;null;EUR;20;10;-554;-277;0.5
0;KZ75125EUR2069100103;2015-07-29;-641;-641;-320.5;null;null;EUR;67;33.5;-574;-287;0.5
0;KZ75125EUR2069100103;2015-07-30;-591;-591;-295.5;50;25;EUR;null;null;-641;-320.5;0.5
0;KZ75125EUR2069100103;2015-07-31;-498;-498;-249;93;46.5;EUR;null;null;-591;-295.5;0.5
0;KZ75125EUR2069100103;2015-08-01;-484;-484;-242;14;7;EUR;null;null;-498;-249;0.5
0;KZ75125EUR2069100103;2015-08-02;-448;-448;-224;36;18;EUR;null;null;-484;-242;0.5
0;KZ75125EUR2069100103;2015-08-03;-369;-369;-184.5;79;39.5;EUR;null;null;-448;-224;0.5
0;KZ75125EUR2069100103;2015-08-04;-336;-336;-168;33;16.5;EUR;null;null;-369;-184.5;0.5
0;KZ75125EUR2069100103;2015-08-05;-346;-346;-173;null;null;EUR;10;5;-336;-168;0.5
0;KZ75125EUR2069100103;2015-08-06;-281;-281;-140.5;65;32.5;EUR;null;null;-346;-173;0.5
0;KZ75125EUR2069100103;2015-08-07;-287;-287;-143.5;null;null;EUR;6;3;-281;-140.5;0.5
0;KZ75125EUR2069100103;2015-08-08;-351;-351;-175.5;null;null;EUR;64;32;-287;-143.5;0.5
0;KZ75125EUR2069100103;2015-08-09;-296;-296;-148;55;27.5;EUR;null;null;-351;-175.5;0.5
0;KZ75125EUR2069100103;2015-08-10;-233;-233;-116.5;63;31.5;EUR;null;null;-296;-148;0.5
0;KZ75125EUR2069100103;2015-08-11;-243;-243;-121.5;null;null;EUR;10;5;-233;-116.5;0.5
0;KZ75125EUR2069100103;2015-08-12;-175;-175;-87.5;68;34;EUR;null;null;-243;-121.5;0.5
0;KZ75125EUR2069100103;2015-08-13;-144;-144;-72;31;15.5;EUR;null;null;-175;-87.5;0.5
0;KZ75125EUR2069100103;2015-08-14;-113;-113;-56.5;31;15.5;EUR;null;null;-144;-72;0.5
0;KZ75125EUR2069100103;2015-08-15;-74;-74;-37;39;19.5;EUR;null;null;-113;-56.5;0.5
0;KZ75125EUR2069100103;2015-08-16;20;20;10;94;47;EUR;null;null;-74;-37;0.5
0;KZ75125EUR2069100103;2015-08-17;-32;-32;-16;null;null;EUR;52;26;20;10;0.5
0;KZ75125EUR2069100103;2015-08-18;66;66;33;98;49;EUR;null;null;-32;-16;0.5
0;KZ75125EUR2069100103;2015-08-19;66;66;33;null;null;EUR;0;0;66;33;0.5
0;KZ75125EUR2069100103;2015-08-20;-17;-17;-8.5;null;null;EUR;83;41.5;66;33;0.5
0;KZ75125EUR2069100103;2015-08-21;-86;-86;-43;null;null;EUR;69;34.5;-17;-8.5;0.5
0;KZ75125EUR2069100103;2015-08-22;-27;-27;-13.5;59;29.5;EUR;null;null;-86;-43;0.5
0;KZ75125EUR2069100103;2015-08-23;48;48;24;75;37.5;EUR;null;null;-27;-13.5;0.5
0;KZ75125EUR2069100103;2015-08-24;68;68;34;20;10;EUR;null;null;48;24;0.5
0;KZ75125EUR2069100103;2015-08-25;81;81;40.5;13;6.5;EUR;null;null;68;34;0.5
0;KZ75125EUR2069100103;2015-08-26;162;162;81;81;40.5;EUR;null;null;81;40.5;0.5
0;KZ75125EUR2069100103;2015-08-27;222;222;111;60;30;EUR;null;null;162;81;0.5
0;KZ75125EUR2069100103;2015-08-28;211;211;105.5;null;null;EUR;11;5.5;222;111;0.5
0;KZ75125EUR2069100103;2015-08-29;249;249;124.5;38;19;EUR;null;null;211;105.5;0.5
0;KZ75125EUR2069100103;2015-08-30;207;207;103.5;null;null;EUR;42;21;249;124.5;0.5
0;KZ75125EUR2069100103;2015-08-31;288;288;144;81;40.5;EUR;null;null;207;103.5;0.5
0;KZ75125EUR2069100103;2015-09-01;358;358;179;70;35;EUR;null;null;288;144;0.5
0;KZ75125EUR2069100103;2015-09-02;418;418;209;60;30;EUR;null;null;358;179;0.5
0;KZ75125EUR2069100103;2015-09-03;343;343;171.5;null;null;EUR;75;37.5;418;209;0.5
0;KZ75125EUR2069100103;2015-09-04;356;356;178;13;6.5;EUR;null;null;343;171.5;0.5
0;KZ75125EUR2069100103;2015-09-05;262;262;131;null;null;EUR;94;47;356;178;0.5
0;KZ75125EUR2069100103;2015-09-06;276;276;138;14;7;EUR;null;null;262;131;0.5
0;KZ75125EUR2069100103;2015-09-07;222;222;111;null;null;EUR;54;27;276;138;0.5
0;KZ75125EUR2069100103;2015-09-08;252;252;126;30;15;EUR;null;null;222;111;0.5
0;KZ75125EUR2069100103;2015-09-09;187;187;93.5;null;null;EUR;65;32.5;252;126;0.5
0;KZ75125EUR2069100103;2015-09-10;190;190;95;3;1.5;EUR;null;null;187;93.5;0.5
0;KZ75125EUR2069100103;2015-09-11;186;186;93;null;null;EUR;4;2;190;95;0.5
0;KZ75125EUR2069100103;2015-09-12;122;122;61;null;null;EUR;64;32;186;93;0.5
0;KZ75125EUR2069100103;2015-09-13;72;72;36;null;null;EUR;50;25;122;61;0.5
0;KZ75125EUR2069100103;2015-09-14;156;156;78;84;42;EUR;null;null;72;36;0.5
0;KZ75125EUR2069100103;2015-09-15;254;254;127;98;49;EUR;null;null;156;78;0.5
0;KZ75125EUR2069100103;2015-09-16;228;228;114;null;null;EUR;26;13;254;127;0.5
0;KZ75125EUR2069100103;2015-09-17;147;147;73.5;null;null;EUR;81;40.5;228;114;0.5
0;KZ75125EUR2069100103;2015-09-18;140;140;70;null;null;EUR;7;3.5;147;73.5;0.5
0;KZ75125EUR2069100103;2015-09-19;57;57;28.5;null;null;EUR;83;41.5;140;70;0.5
0;KZ75125EUR2069100103;2015-09-20;47;47;23.5;null;null;EUR;10;5;57;28.5;0.5
0;KZ75125EUR2069100103;2015-09-21;32;32;16;null;null;EUR;15;7.5;47;23.5;0.5
0;KZ75125EUR2069100103;2015-09-22;-67;-67;-33.5;null;null;EUR;99;49.5;32;16;0.5
0;KZ75125EUR2069100103;2015-09-23;-87;-87;-43.5;null;null;EUR;20;10;-67;-33.5;0.5
0;KZ75125EUR2069100103;2015-09-24;-93;-93;-46.5;null;null;EUR;6;3;-87;-43.5;0.5
0;KZ75125EUR2069100103;2015-09-25;-187;-187;-93.5;null;null;EUR;94;47;-93;-46.5;0.5
0;KZ75125EUR2069100103;2015-09-26;-103;-103;-51.5;84;42;EUR;null;null;-187;-93.5;0.5
0;KZ75125EUR2069100103;2015-09-27;-123;-123;-61.5;null;null;EUR;20;10;-103;-51.5;0.5
0;KZ75125EUR2069100103;2015-09-28;-173;-173;-86.5;null;null;EUR;50;25;-123;-61.5;0.5
0;KZ75125EUR2069100103;2015-09-29;-153;-153;-76.5;20;10;EUR;null;null;-173;-86.5;0.5
0;KZ75125EUR2069100103;2015-09-30;-213;-213;-106.5;null;null;EUR;60;30;-153;-76.5;0.5
0;KZ75125EUR2069100103;2015-10-01;-148;-148;-74;65;32.5;EUR;null;null;-213;-106.5;0.5
0;KZ75125EUR2069100103;2015-10-02;-221;-221;-110.5;null;null;EUR;73;36.5;-148;-74;0.5
0;KZ75125EUR2069100103;2015-10-03;-158;-158;-79;63;31.5;EUR;null;null;-221;-110.5;0.5
0;KZ75125EUR2069100103;2015-10-04;-219;-219;-109.5;null;null;EUR;61;30.5;-158;-79;0.5
0;KZ75125EUR2069100103;2015-10-05;-310;-310;-155;null;null;EUR;91;45.5;-219;-109.5;0.5
0;KZ75125EUR2069100103;2015-10-06;-231;-231;-115.5;79;39.5;EUR;null;null;-310;-155;0.5
0;KZ75125EUR2069100103;2015-10-07;-224;-224;-112;7;3.5;EUR;null;null;-231;-115.5;0.5
0;KZ75125EUR2069100103;2015-10-08;-143;-143;-71.5;81;40.5;EUR;null;null;-224;-112;0.5
0;KZ75125EUR2069100103;2015-10-09;-95;-95;-47.5;48;24;EUR;null;null;-143;-71.5;0.5
0;KZ75125EUR2069100103;2015-10-10;-44;-44;-22;51;25.5;EUR;null;null;-95;-47.5;0.5
0;KZ75125EUR2069100103;2015-10-11;1;1;0.5;45;22.5;EUR;null;null;-44;-22;0.5
0;KZ75125EUR2069100103;2015-10-12;76;76;38;75;37.5;EUR;null;null;1;0.5;0.5
0;KZ75125EUR2069100103;2015-10-13;44;44;22;null;null;EUR;32;16;76;38;0.5
0;KZ75125EUR2069100103;2015-10-14;70;70;35;26;13;EUR;null;null;44;22;0.5
0;KZ75125EUR2069100103;2015-10-15;-1;-1;-0.5;null;null;EUR;71;35.5;70;35;0.5
0;KZ75125EUR2069100103;2015-10-16;-1;-1;-0.5;null;null;EUR;0;0;-1;-0.5;0.5
0;KZ75125EUR2069100103;2015-10-17;-94;-94;-47;null;null;EUR;93;46.5;-1;-0.5;0.5
0;KZ75125EUR2069100103;2015-10-18;-141;-141;-70.5;null;null;EUR;47;23.5;-94;-47;0.5
0;KZ75125EUR2069100103;2015-10-19;-91;-91;-45.5;50;25;EUR;null;null;-141;-70.5;0.5
0;KZ75125EUR2069100103;2015-10-20;-8;-8;-4;83;41.5;EUR;null;null;-91;-45.5;0.5
0;KZ75125EUR2069100103;2015-10-21;41;41;20.5;49;24.5;EUR;null;null;-8;-4;0.5
0;KZ75125EUR2069100103;2015-10-22;-44;-44;-22;null;null;EUR;85;42.5;41;20.5;0.5
0;KZ75125EUR2069100103;2015-10-23;41;41;20.5;85;42.5;EUR;null;null;-44;-22;0.5
0;KZ75125EUR2069100103;2015-10-24;126;126;63;85;42.5;EUR;null;null;41;20.5;0.5
0;KZ75125EUR2069100103;2015-10-25;64;64;32;null;null;EUR;62;31;126;63;0.5
0;KZ75125EUR2069100103;2015-10-26;85;85;42.5;21;10.5;EUR;null;null;64;32;0.5
0;KZ75125EUR2069100103;2015-10-27;58;58;29;null;null;EUR;27;13.5;85;42.5;0.5
0;KZ75125EUR2069100103;2015-10-28;60;60;30;2;1;EUR;null;null;58;29;0.5
0;KZ75125EUR2069100103;2015-10-29;106;106;53;46;23;EUR;null;null;60;30;0.5
0;KZ75125EUR2069100103;2015-10-30;116;116;58;10;5;EUR;null;null;106;53;0.5
0;KZ75125EUR2069100103;2015-10-31;56;56;28;null;null;EUR;60;30;116;58;0.5
0;KZ75125EUR2069100103;2015-11-01;125;125;62.5;69;34.5;EUR;null;null;56;28;0.5
0;KZ75125EUR2069100103;2015-11-02;74;74;37;null;null;EUR;51;25.5;125;62.5;0.5
0;KZ75125EUR2069100103;2015-11-03;28;28;14;null;null;EUR;46;23;74;37;0.5
0;KZ75125EUR2069100103;2015-11-04;-44;-44;-22;null;null;EUR;72;36;28;14;0.5
0;KZ75125EUR2069100103;2015-11-05;-58;-58;-29;null;null;EUR;14;7;-44;-22;0.5
0;KZ75125EUR2069100103;2015-11-06;-27;-27;-13.5;31;15.5;EUR;null;null;-58;-29;0.5
0;KZ75125EUR2069100103;2015-11-07;-14;-14;-7;13;6.5;EUR;null;null;-27;-13.5;0.5
0;KZ75125EUR2069100103;2015-11-08;-113;-113;-56.5;null;null;EUR;99;49.5;-14;-7;0.5
0;KZ75125EUR2069100103;2015-11-09;-166;-166;-83;null;null;EUR;53;26.5;-113;-56.5;0.5
0;KZ75125EUR2069100103;2015-11-10;-85;-85;-42.5;81;40.5;EUR;null;null;-166;-83;0.5
0;KZ75125EUR2069100103;2015-11-11;-121;-121;-60.5;null;null;EUR;36;18;-85;-42.5;0.5
0;KZ75125EUR2069100103;2015-11-12;-43;-43;-21.5;78;39;EUR;null;null;-121;-60.5;0.5
0;KZ75125EUR2069100103;2015-11-13;-94;-94;-47;null;null;EUR;51;25.5;-43;-21.5;0.5
0;KZ75125EUR2069100103;2015-11-14;-40;-40;-20;54;27;EUR;null;null;-94;-47;0.5
0;KZ75125EUR2069100103;2015-11-15;38;38;19;78;39;EUR;null;null;-40;-20;0.5
0;KZ75125EUR2069100103;2015-11-16;-33;-33;-16.5;null;null;EUR;71;35.5;38;19;0.5
0;KZ75125EUR2069100103;2015-11-17;26;26;13;59;29.5;EUR;null;null;-33;-16.5;0.5
0;KZ75125EUR2069100103;2015-11-18;10;10;5;null;null;EUR;16;8;26;13;0.5
0;KZ75125EUR2069100103;2015-11-19;2;2;1;null;null;EUR;8;4;10;5;0.5
0;KZ75125EUR2069100103;2015-11-20;-64;-64;-32;null;null;EUR;66;33;2;1;0.5
0;KZ75125EUR2069100103;2015-11-21;-46;-46;-23;18;9;EUR;null;null;-64;-32;0.5
0;KZ75125EUR2069100103;2015-11-22;-60;-60;-30;null;null;EUR;14;7;-46;-23;0.5
0;KZ75125EUR2069100103;2015-11-23;-153;-153;-76.5;null;null;EUR;93;46.5;-60;-30;0.5
0;KZ75125EUR2069100103;2015-11-24;-108;-108;-54;45;22.5;EUR;null;null;-153;-76.5;0.5
0;KZ75125EUR2069100103;2015-11-25;-42;-42;-21;66;33;EUR;null;null;-108;-54;0.5
0;KZ75125EUR2069100103;2015-11-26;55;55;27.5;97;48.5;EUR;null;null;-42;-21;0.5
0;KZ75125EUR2069100103;2015-11-27;-8;-8;-4;null;null;EUR;63;31.5;55;27.5;0.5
0;KZ75125EUR2069100103;2015-11-28;-48;-48;-24;null;null;EUR;40;20;-8;-4;0.5
0;KZ75125EUR2069100103;2015-11-29;-46;-46;-23;2;1;EUR;null;null;-48;-24;0.5
0;KZ75125EUR2069100103;2015-11-30;50;50;25;96;48;EUR;null;null;-46;-23;0.5
0;KZ75125EUR2069100103;2015-12-01;-44;-44;-22;null;null;EUR;94;47;50;25;0.5
0;KZ75125EUR2069100103;2015-12-02;-132;-132;-66;null;null;EUR;88;44;-44;-22;0.5
0;KZ75125EUR2069100103;2015-12-03;-205;-205;-102.5;null;null;EUR;73;36.5;-132;-66;0.5
0;KZ75125EUR2069100103;2015-12-04;-125;-125;-62.5;80;40;EUR;null;null;-205;-102.5;0.5
0;KZ75125EUR2069100103;2015-12-05;-70;-70;-35;55;27.5;EUR;null;null;-125;-62.5;0.5
0;KZ75125EUR2069100103;2015-12-06;-92;-92;-46;null;null;EUR;22;11;-70;-35;0.5
0;KZ75125EUR2069100103;2015-12-07;-130;-130;-65;null;null;EUR;38;19;-92;-46;0.5
0;KZ75125EUR2069100103;2015-12-08;-196;-196;-98;null;null;EUR;66;33;-130;-65;0.5
0;KZ75125EUR2069100103;2015-12-09;-121;-121;-60.5;75;37.5;EUR;null;null;-196;-98;0.5
0;KZ75125EUR2069100103;2015-12-10;-43;-43;-21.5;78;39;EUR;null;null;-121;-60.5;0.5
0;KZ75125EUR2069100103;2015-12-11;-95;-95;-47.5;null;null;EUR;52;26;-43;-21.5;0.5
0;KZ75125EUR2069100103;2015-12-12;-79;-79;-39.5;16;8;EUR;null;null;-95;-47.5;0.5
0;KZ75125EUR2069100103;2015-12-13;-176;-176;-88;null;null;EUR;97;48.5;-79;-39.5;0.5
0;KZ75125EUR2069100103;2015-12-14;-102;-102;-51;74;37;EUR;null;null;-176;-88;0.5
0;KZ75125EUR2069100103;2015-12-15;-76;-76;-38;26;13;EUR;null;null;-102;-51;0.5
0;KZ75125EUR2069100103;2015-12-16;-17;-17;-8.5;59;29.5;EUR;null;null;-76;-38;0.5
0;KZ75125EUR2069100103;2015-12-17;-115;-115;-57.5;null;null;EUR;98;49;-17;-8.5;0.5
0;KZ75125EUR2069100103;2015-12-18;-160;-160;-80;null;null;EUR;45;22.5;-115;-57.5;0.5
0;KZ75125EUR2069100103;2015-12-19;-233;-233;-116.5;null;null;EUR;73;36.5;-160;-80;0.5
0;KZ75125EUR2069100103;2015-12-20;-287;-287;-143.5;null;null;EUR;54;27;-233;-116.5;0.5
0;KZ75125EUR2069100103;2015-12-21;-269;-269;-134.5;18;9;EUR;null;null;-287;-143.5;0.5
0;KZ75125EUR2069100103;2015-12-22;-255;-255;-127.5;14;7;EUR;null;null;-269;-134.5;0.5
0;KZ75125EUR2069100103;2015-12-23;-206;-206;-103;49;24.5;EUR;null;null;-255;-127.5;0.5
0;KZ75125EUR2069100103;2015-12-24;-298;-298;-149;null;null;EUR;92;46;-206;-103;0.5
0;KZ75125EUR2069100103;2015-12-25;-283;-283;-141.5;15;7.5;EUR;null;null;-298;-149;0.5
0;KZ75125EUR2069100103;2015-12-26;-275;-275;-137.5;8;4;EUR;null;null;-283;-141.5;0.5
0;KZ75125EUR2069100103;2015-12-27;-368;-368;-184;null;null;EUR;93;46.5;-275;-137.5;0.5
0;KZ75125EUR2069100103;2015-12-28;-289;-289;-144.5;79;39.5;EUR;null;null;-368;-184;0.5
0;KZ75125EUR2069100103;2015-12-29;-228;-228;-114;61;30.5;EUR;null;null;-289;-144.5;0.5
0;KZ75125EUR2069100103;2015-12-30;-262;-262;-131;null;null;EUR;34;17;-228;-114;0.5
0;KZ75125EUR2069100103;2015-12-31;-353;-353;-176.5;null;null;EUR;91;45.5;-262;-131;0.5
0;KZ75125EUR2069100103;2016-01-01;-303;-303;-151.5;50;25;EUR;null;null;-353;-176.5;0.5
0;KZ75125EUR2069100103;2016-01-02;-285;-285;-142.5;18;9;EUR;null;null;-303;-151.5;0.5
0;KZ75125EUR2069100103;2016-01-03;-333;-333;-166.5;null;null;EUR;48;24;-285;-142.5;0.5
0;KZ75125EUR2069100103;2016-01-04;-420;-420;-210;null;null;EUR;87;43.5;-333;-166.5;0.5
0;KZ75125EUR2069100103;2016-01-05;-519;-519;-259.5;null;null;EUR;99;49.5;-420;-210;0.5
0;KZ75125EUR2069100103;2016-01-06;-435;-435;-217.5;84;42;EUR;null;null;-519;-259.5;0.5
0;KZ75125EUR2069100103;2016-01-07;-404;-404;-202;31;15.5;EUR;null;null;-435;-217.5;0.5
0;KZ75125EUR2069100103;2016-01-08;-432;-432;-216;null;null;EUR;28;14;-404;-202;0.5
0;KZ75125EUR2069100103;2016-01-09;-418;-418;-209;14;7;EUR;null;null;-432;-216;0.5
0;KZ75125EUR2069100103;2016-01-10;-510;-510;-255;null;null;EUR;92;46;-418;-209;0.5
0;KZ75125EUR2069100103;2016-01-11;-411;-411;-205.5;99;49.5;EUR;null;null;-510;-255;0.5
0;KZ75125EUR2069100103;2016-01-12;-344;-344;-172;67;33.5;EUR;null;null;-411;-205.5;0.5
0;KZ75125EUR2069100103;2016-01-13;-306;-306;-153;38;19;EUR;null;null;-344;-172;0.5
0;KZ75125EUR2069100103;2016-01-14;-368;-368;-184;null;null;EUR;62;31;-306;-153;0.5
0;KZ75125EUR2069100103;2016-01-15;-448;-448;-224;null;null;EUR;80;40;-368;-184;0.5
0;KZ75125EUR2069100103;2016-01-16;-415;-415;-207.5;33;16.5;EUR;null;null;-448;-224;0.5
0;KZ75125EUR2069100103;2016-01-17;-382;-382;-191;33;16.5;EUR;null;null;-415;-207.5;0.5
0;KZ75125EUR2069100103;2016-01-18;-365;-365;-182.5;17;8.5;EUR;null;null;-382;-191;0.5
0;KZ75125EUR2069100103;2016-01-19;-383;-383;-191.5;null;null;EUR;18;9;-365;-182.5;0.5
0;KZ75125EUR2069100103;2016-01-20;-429;-429;-214.5;null;null;EUR;46;23;-383;-191.5;0.5
0;KZ75125EUR2069100103;2016-01-21;-417;-417;-208.5;12;6;EUR;null;null;-429;-214.5;0.5
0;KZ75125EUR2069100103;2016-01-22;-388;-388;-194;29;14.5;EUR;null;null;-417;-208.5;0.5
0;KZ75125EUR2069100103;2016-01-23;-476;-476;-238;null;null;EUR;88;44;-388;-194;0.5
0;KZ75125EUR2069100103;2016-01-24;-546;-546;-273;null;null;EUR;70;35;-476;-238;0.5
0;KZ75125EUR2069100103;2016-01-25;-564;-564;-282;null;null;EUR;18;9;-546;-273;0.5
0;KZ75125EUR2069100103;2016-01-26;-557;-557;-278.5;7;3.5;EUR;null;null;-564;-282;0.5
0;KZ75125EUR2069100103;2016-01-27;-465;-465;-232.5;92;46;EUR;null;null;-557;-278.5;0.5
0;KZ75125EUR2069100103;2016-01-28;-531;-531;-265.5;null;null;EUR;66;33;-465;-232.5;0.5
0;KZ75125EUR2069100103;2016-01-29;-501;-501;-250.5;30;15;EUR;null;null;-531;-265.5;0.5
0;KZ75125EUR2069100103;2016-01-30;-404;-404;-202;97;48.5;EUR;null;null;-501;-250.5;0.5
0;KZ75125EUR2069100103;2016-01-31;-424;-424;-212;null;null;EUR;20;10;-404;-202;0.5
0;KZ75125EUR2069100103;2016-02-01;-375;-375;-187.5;49;24.5;EUR;null;null;-424;-212;0.5
0;KZ75125EUR2069100103;2016-02-02;-389;-389;-194.5;null;null;EUR;14;7;-375;-187.5;0.5
0;KZ75125EUR2069100103;2016-02-03;-482;-482;-241;null;null;EUR;93;46.5;-389;-194.5;0.5
0;KZ75125EUR2069100103;2016-02-04;-548;-548;-274;null;null;EUR;66;33;-482;-241;0.5
0;KZ75125EUR2069100103;2016-02-05;-568;-568;-284;null;null;EUR;20;10;-548;-274;0.5
0;KZ75125EUR2069100103;2016-02-06;-523;-523;-261.5;45;22.5;EUR;null;null;-568;-284;0.5
0;KZ75125EUR2069100103;2016-02-07;-590;-590;-295;null;null;EUR;67;33.5;-523;-261.5;0.5
0;KZ75125EUR2069100103;2016-02-08;-676;-676;-338;null;null;EUR;86;43;-590;-295;0.5
0;KZ75125EUR2069100103;2016-02-09;-634;-634;-317;42;21;EUR;null;null;-676;-338;0.5
0;KZ75125EUR2069100103;2016-02-10;-591;-591;-295.5;43;21.5;EUR;null;null;-634;-317;0.5
0;KZ75125EUR2069100103;2016-02-11;-536;-536;-268;55;27.5;EUR;null;null;-591;-295.5;0.5
0;KZ75125EUR2069100103;2016-02-12;-572;-572;-286;null;null;EUR;36;18;-536;-268;0.5
0;KZ75125EUR2069100103;2016-02-13;-536;-536;-268;36;18;EUR;null;null;-572;-286;0.5
0;KZ75125EUR2069100103;2016-02-14;-595;-595;-297.5;null;null;EUR;59;29.5;-536;-268;0.5
0;KZ75125EUR2069100103;2016-02-15;-579;-579;-289.5;16;8;EUR;null;null;-595;-297.5;0.5
0;KZ75125EUR2069100103;2016-02-16;-576;-576;-288;3;1.5;EUR;null;null;-579;-289.5;0.5
0;KZ75125EUR2069100103;2016-02-17;-532;-532;-266;44;22;EUR;null;null;-576;-288;0.5
0;KZ75125EUR2069100103;2016-02-18;-476;-476;-238;56;28;EUR;null;null;-532;-266;0.5
0;KZ75125EUR2069100103;2016-02-19;-432;-432;-216;44;22;EUR;null;null;-476;-238;0.5
0;KZ75125EUR2069100103;2016-02-20;-529;-529;-264.5;null;null;EUR;97;48.5;-432;-216;0.5
0;KZ75125EUR2069100103;2016-02-21;-566;-566;-283;null;null;EUR;37;18.5;-529;-264.5;0.5
0;KZ75125EUR2069100103;2016-02-22;-606;-606;-303;null;null;EUR;40;20;-566;-283;0.5
0;KZ75125EUR2069100103;2016-02-23;-509;-509;-254.5;97;48.5;EUR;null;null;-606;-303;0.5
0;KZ75125EUR2069100103;2016-02-24;-471;-471;-235.5;38;19;EUR;null;null;-509;-254.5;0.5
0;KZ75125EUR2069100103;2016-02-25;-457;-457;-228.5;14;7;EUR;null;null;-471;-235.5;0.5
0;KZ75125EUR2069100103;2016-02-26;-358;-358;-179;99;49.5;EUR;null;null;-457;-228.5;0.5
0;KZ75125EUR2069100103;2016-02-27;-359;-359;-179.5;null;null;EUR;1;0.5;-358;-179;0.5
0;KZ75125EUR2069100103;2016-02-28;-270;-270;-135;89;44.5;EUR;null;null;-359;-179.5;0.5
0;KZ75125EUR2069100103;2016-02-29;-300;-300;-150;null;null;EUR;30;15;-270;-135;0.5
0;KZ75125EUR2069100103;2016-03-01;-351;-351;-175.5;null;null;EUR;51;25.5;-300;-150;0.5
0;KZ75125EUR2069100103;2016-03-02;-366;-366;-183;null;null;EUR;15;7.5;-351;-175.5;0.5
0;KZ75125EUR2069100103;2016-03-03;-297;-297;-148.5;69;34.5;EUR;null;null;-366;-183;0.5
0;KZ75125EUR2069100103;2016-03-04;-278;-278;-139;19;9.5;EUR;null;null;-297;-148.5;0.5
0;KZ75125EUR2069100103;2016-03-05;-239;-239;-119.5;39;19.5;EUR;null;null;-278;-139;0.5
0;KZ75125EUR2069100103;2016-03-06;-234;-234;-117;5;2.5;EUR;null;null;-239;-119.5;0.5
0;KZ75125EUR2069100103;2016-03-07;-172;-172;-86;62;31;EUR;null;null;-234;-117;0.5
0;KZ75125EUR2069100103;2016-03-08;-252;-252;-126;null;null;EUR;80;40;-172;-86;0.5
0;KZ75125EUR2069100103;2016-03-09;-221;-221;-110.5;31;15.5;EUR;null;null;-252;-126;0.5
0;KZ75125EUR2069100103;2016-03-10;-153;-153;-76.5;68;34;EUR;null;null;-221;-110.5;0.5
0;KZ75125EUR2069100103;2016-03-11;-154;-154;-77;null;null;EUR;1;0.5;-153;-76.5;0.5
0;KZ75125EUR2069100103;2016-03-12;-207;-207;-103.5;null;null;EUR;53;26.5;-154;-77;0.5
0;KZ75125EUR2069100103;2016-03-13;-180;-180;-90;27;13.5;EUR;null;null;-207;-103.5;0.5
0;KZ75125EUR2069100103;2016-03-14;-250;-250;-125;null;null;EUR;70;35;-180;-90;0.5
0;KZ75125EUR2069100103;2016-03-15;-304;-304;-152;null;null;EUR;54;27;-250;-125;0.5
0;KZ75125EUR2069100103;2016-03-16;-215;-215;-107.5;89;44.5;EUR;null;null;-304;-152;0.5
0;KZ75125EUR2069100103;2016-03-17;-249;-249;-124.5;null;null;EUR;34;17;-215;-107.5;0.5
0;KZ75125EUR2069100103;2016-03-18;-293;-293;-146.5;null;null;EUR;44;22;-249;-124.5;0.5
0;KZ75125EUR2069100103;2016-03-19;-360;-360;-180;null;null;EUR;67;33.5;-293;-146.5;0.5
0;KZ75125EUR2069100103;2016-03-20;-384;-384;-192;null;null;EUR;24;12;-360;-180;0.5
0;KZ75125EUR2069100103;2016-03-21;-325;-325;-162.5;59;29.5;EUR;null;null;-384;-192;0.5
0;KZ75125EUR2069100103;2016-03-22;-404;-404;-202;null;null;EUR;79;39.5;-325;-162.5;0.5
0;KZ75125EUR2069100103;2016-03-23;-491;-491;-245.5;null;null;EUR;87;43.5;-404;-202;0.5
0;KZ75125EUR2069100103;2016-03-24;-439;-439;-219.5;52;26;EUR;null;null;-491;-245.5;0.5
0;KZ75125EUR2069100103;2016-03-25;-513;-513;-256.5;null;null;EUR;74;37;-439;-219.5;0.5
0;KZ75125EUR2069100103;2016-03-26;-481;-481;-240.5;32;16;EUR;null;null;-513;-256.5;0.5
0;KZ75125EUR2069100103;2016-03-27;-401;-401;-200.5;80;40;EUR;null;null;-481;-240.5;0.5
0;KZ75125EUR2069100103;2016-03-28;-390;-390;-195;11;5.5;EUR;null;null;-401;-200.5;0.5
0;KZ75125EUR2069100103;2016-03-29;-331;-331;-165.5;59;29.5;EUR;null;null;-390;-195;0.5
0;KZ75125EUR2069100103;2016-03-30;-384;-384;-192;null;null;EUR;53;26.5;-331;-165.5;0.5
0;KZ75125EUR2069100103;2016-03-31;-362;-362;-181;22;11;EUR;null;null;-384;-192;0.5
0;KZ75125EUR2069100103;2016-04-01;-352;-352;-176;10;5;EUR;null;null;-362;-181;0.5
0;KZ75125EUR2069100103;2016-04-02;-304;-304;-152;48;24;EUR;null;null;-352;-176;0.5
0;KZ75125EUR2069100103;2016-04-03;-274;-274;-137;30;15;EUR;null;null;-304;-152;0.5
0;KZ75125EUR2069100103;2016-04-04;-254;-254;-127;20;10;EUR;null;null;-274;-137;0.5
0;KZ75125EUR2069100103;2016-04-05;-162;-162;-81;92;46;EUR;null;null;-254;-127;0.5
0;KZ75125EUR2069100103;2016-04-06;-203;-203;-101.5;null;null;EUR;41;20.5;-162;-81;0.5
0;KZ75125EUR2069100103;2016-04-07;-227;-227;-113.5;null;null;EUR;24;12;-203;-101.5;0.5
0;KZ75125EUR2069100103;2016-04-08;-239;-239;-119.5;null;null;EUR;12;6;-227;-113.5;0.5
0;KZ75125EUR2069100103;2016-04-09;-330;-330;-165;null;null;EUR;91;45.5;-239;-119.5;0.5
0;KZ75125EUR2069100103;2016-04-10;-344;-344;-172;null;null;EUR;14;7;-330;-165;0.5
0;KZ75125EUR2069100103;2016-04-11;-425;-425;-212.5;null;null;EUR;81;40.5;-344;-172;0.5
0;KZ75125EUR2069100103;2016-04-12;-415;-415;-207.5;10;5;EUR;null;null;-425;-212.5;0.5
0;KZ75125EUR2069100103;2016-04-13;-341;-341;-170.5;74;37;EUR;null;null;-415;-207.5;0.5
0;KZ75125EUR2069100103;2016-04-14;-421;-421;-210.5;null;null;EUR;80;40;-341;-170.5;0.5
0;KZ75125EUR2069100103;2016-04-15;-399;-399;-199.5;22;11;EUR;null;null;-421;-210.5;0.5
0;KZ75125EUR2069100103;2016-04-16;-332;-332;-166;67;33.5;EUR;null;null;-399;-199.5;0.5
0;KZ75125EUR2069100103;2016-04-17;-365;-365;-182.5;null;null;EUR;33;16.5;-332;-166;0.5
0;KZ75125EUR2069100103;2016-04-18;-460;-460;-230;null;null;EUR;95;47.5;-365;-182.5;0.5
0;KZ75125EUR2069100103;2016-04-19;-367;-367;-183.5;93;46.5;EUR;null;null;-460;-230;0.5
0;KZ75125EUR2069100103;2016-04-20;-279;-279;-139.5;88;44;EUR;null;null;-367;-183.5;0.5
0;KZ75125EUR2069100103;2016-04-21;-357;-357;-178.5;null;null;EUR;78;39;-279;-139.5;0.5
0;KZ75125EUR2069100103;2016-04-22;-452;-452;-226;null;null;EUR;95;47.5;-357;-178.5;0.5
0;KZ75125EUR2069100103;2016-04-23;-468;-468;-234;null;null;EUR;16;8;-452;-226;0.5
0;KZ75125EUR2069100103;2016-04-24;-513;-513;-256.5;null;null;EUR;45;22.5;-468;-234;0.5
0;KZ75125EUR2069100103;2016-04-25;-439;-439;-219.5;74;37;EUR;null;null;-513;-256.5;0.5
0;KZ75125EUR2069100103;2016-04-26;-368;-368;-184;71;35.5;EUR;null;null;-439;-219.5;0.5
0;KZ75125EUR2069100103;2016-04-27;-281;-281;-140.5;87;43.5;EUR;null;null;-368;-184;0.5
0;KZ75125EUR2069100103;2016-04-28;-367;-367;-183.5;null;null;EUR;86;43;-281;-140.5;0.5
0;KZ75125EUR2069100103;2016-04-29;-389;-389;-194.5;null;null;EUR;22;11;-367;-183.5;0.5
0;KZ75125EUR2069100103;2016-04-30;-376;-376;-188;13;6.5;EUR;null;null;-389;-194.5;0.5
0;KZ75125EUR2069100103;2016-05-01;-381;-381;-190.5;null;null;EUR;5;2.5;-376;-188;0.5
0;KZ75125EUR2069100103;2016-05-02;-432;-432;-216;null;null;EUR;51;25.5;-381;-190.5;0.5
0;KZ75125EUR2069100103;2016-05-03;-472;-472;-236;null;null;EUR;40;20;-432;-216;0.5
0;KZ75125EUR2069100103;2016-05-04;-491;-491;-245.5;null;null;EUR;19;9.5;-472;-236;0.5
0;KZ75125EUR2069100103;2016-05-05;-413;-413;-206.5;78;39;EUR;null;null;-491;-245.5;0.5
0;KZ75125EUR2069100103;2016-05-06;-401;-401;-200.5;12;6;EUR;null;null;-413;-206.5;0.5
0;KZ75125EUR2069100103;2016-05-07;-323;-323;-161.5;78;39;EUR;null;null;-401;-200.5;0.5
0;KZ75125EUR2069100103;2016-05-08;-224;-224;-112;99;49.5;EUR;null;null;-323;-161.5;0.5
0;KZ75125EUR2069100103;2016-05-09;-310;-310;-155;null;null;EUR;86;43;-224;-112;0.5
0;KZ75125EUR2069100103;2016-05-10;-339;-339;-169.5;null;null;EUR;29;14.5;-310;-155;0.5
0;KZ75125EUR2069100103;2016-05-11;-240;-240;-120;99;49.5;EUR;null;null;-339;-169.5;0.5
0;KZ75125EUR2069100103;2016-05-12;-211;-211;-105.5;29;14.5;EUR;null;null;-240;-120;0.5
0;KZ75125EUR2069100103;2016-05-13;-305;-305;-152.5;null;null;EUR;94;47;-211;-105.5;0.5
0;KZ75125EUR2069100103;2016-05-14;-234;-234;-117;71;35.5;EUR;null;null;-305;-152.5;0.5
0;KZ75125EUR2069100103;2016-05-15;-270;-270;-135;null;null;EUR;36;18;-234;-117;0.5
0;KZ75125EUR2069100103;2016-05-16;-281;-281;-140.5;null;null;EUR;11;5.5;-270;-135;0.5
0;KZ75125EUR2069100103;2016-05-17;-309;-309;-154.5;null;null;EUR;28;14;-281;-140.5;0.5
0;KZ75125EUR2069100103;2016-05-18;-275;-275;-137.5;34;17;EUR;null;null;-309;-154.5;0.5
0;KZ75125EUR2069100103;2016-05-19;-297;-297;-148.5;null;null;EUR;22;11;-275;-137.5;0.5
0;KZ75125EUR2069100103;2016-05-20;-261;-261;-130.5;36;18;EUR;null;null;-297;-148.5;0.5
0;KZ75125EUR2069100103;2016-05-21;-277;-277;-138.5;null;null;EUR;16;8;-261;-130.5;0.5
0;KZ75125EUR2069100103;2016-05-22;-241;-241;-120.5;36;18;EUR;null;null;-277;-138.5;0.5
0;KZ75125EUR2069100103;2016-05-23;-301;-301;-150.5;null;null;EUR;60;30;-241;-120.5;0.5
0;KZ75125EUR2069100103;2016-05-24;-394;-394;-197;null;null;EUR;93;46.5;-301;-150.5;0.5
0;KZ75125EUR2069100103;2016-05-25;-297;-297;-148.5;97;48.5;EUR;null;null;-394;-197;0.5
0;KZ75125EUR2069100103;2016-05-26;-284;-284;-142;13;6.5;EUR;null;null;-297;-148.5;0.5
0;KZ75125EUR2069100103;2016-05-27;-338;-338;-169;null;null;EUR;54;27;-284;-142;0.5
0;KZ75125EUR2069100103;2016-05-28;-249;-249;-124.5;89;44.5;EUR;null;null;-338;-169;0.5
0;KZ75125EUR2069100103;2016-05-29;-327;-327;-163.5;null;null;EUR;78;39;-249;-124.5;0.5
0;KZ75125EUR2069100103;2016-05-30;-348;-348;-174;null;null;EUR;21;10.5;-327;-163.5;0.5
0;KZ75125EUR2069100103;2016-05-31;-377;-377;-188.5;null;null;EUR;29;14.5;-348;-174;0.5
0;KZ75125EUR2069100103;2016-06-01;-429;-429;-214.5;null;null;EUR;52;26;-377;-188.5;0.5
0;KZ75125EUR2069100103;2016-06-02;-374;-374;-187;55;27.5;EUR;null;null;-429;-214.5;0.5
0;KZ75125EUR2069100103;2016-06-03;-362;-362;-181;12;6;EUR;null;null;-374;-187;0.5
0;KZ75125EUR2069100103;2016-06-04;-358;-358;-179;4;2;EUR;null;null;-362;-181;0.5
0;KZ75125EUR2069100103;2016-06-05;-454;-454;-227;null;null;EUR;96;48;-358;-179;0.5
0;KZ75125EUR2069100103;2016-06-06;-526;-526;-263;null;null;EUR;72;36;-454;-227;0.5
0;KZ75125EUR2069100103;2016-06-07;-563;-563;-281.5;null;null;EUR;37;18.5;-526;-263;0.5
0;KZ75125EUR2069100103;2016-06-08;-522;-522;-261;41;20.5;EUR;null;null;-563;-281.5;0.5
0;KZ75125EUR2069100103;2016-06-09;-442;-442;-221;80;40;EUR;null;null;-522;-261;0.5
0;KZ75125EUR2069100103;2016-06-10;-445;-445;-222.5;null;null;EUR;3;1.5;-442;-221;0.5
0;KZ75125EUR2069100103;2016-06-11;-346;-346;-173;99;49.5;EUR;null;null;-445;-222.5;0.5
0;KZ75125EUR2069100103;2016-06-12;-280;-280;-140;66;33;EUR;null;null;-346;-173;0.5
0;KZ75125EUR2069100103;2016-06-13;-369;-369;-184.5;null;null;EUR;89;44.5;-280;-140;0.5
0;KZ75125EUR2069100103;2016-06-14;-443;-443;-221.5;null;null;EUR;74;37;-369;-184.5;0.5
0;KZ75125EUR2069100103;2016-06-15;-445;-445;-222.5;null;null;EUR;2;1;-443;-221.5;0.5
0;KZ75125EUR2069100103;2016-06-16;-379;-379;-189.5;66;33;EUR;null;null;-445;-222.5;0.5
0;KZ75125EUR2069100103;2016-06-17;-353;-353;-176.5;26;13;EUR;null;null;-379;-189.5;0.5
0;KZ75125EUR2069100103;2016-06-18;-276;-276;-138;77;38.5;EUR;null;null;-353;-176.5;0.5
0;KZ75125EUR2069100103;2016-06-19;-267;-267;-133.5;9;4.5;EUR;null;null;-276;-138;0.5
0;KZ75125EUR2069100103;2016-06-20;-169;-169;-84.5;98;49;EUR;null;null;-267;-133.5;0.5
0;KZ75125EUR2069100103;2016-06-21;-239;-239;-119.5;null;null;EUR;70;35;-169;-84.5;0.5
0;KZ75125EUR2069100103;2016-06-22;-296;-296;-148;null;null;EUR;57;28.5;-239;-119.5;0.5
0;KZ75125EUR2069100103;2016-06-23;-304;-304;-152;null;null;EUR;8;4;-296;-148;0.5
0;KZ75125EUR2069100103;2016-06-24;-216;-216;-108;88;44;EUR;null;null;-304;-152;0.5
0;KZ75125EUR2069100103;2016-06-25;-204;-204;-102;12;6;EUR;null;null;-216;-108;0.5
0;KZ75125EUR2069100103;2016-06-26;-173;-173;-86.5;31;15.5;EUR;null;null;-204;-102;0.5
0;KZ75125EUR2069100103;2016-06-27;-121;-121;-60.5;52;26;EUR;null;null;-173;-86.5;0.5
0;KZ75125EUR2069100103;2016-06-28;-102;-102;-51;19;9.5;EUR;null;null;-121;-60.5;0.5
0;KZ75125EUR2069100103;2016-06-29;-148;-148;-74;null;null;EUR;46;23;-102;-51;0.5
0;KZ75125EUR2069100103;2016-06-30;-144;-144;-72;4;2;EUR;null;null;-148;-74;0.5
0;KZ75125EUR2069100103;2016-07-01;-239;-239;-119.5;null;null;EUR;95;47.5;-144;-72;0.5
0;KZ75125EUR2069100103;2016-07-02;-291;-291;-145.5;null;null;EUR;52;26;-239;-119.5;0.5
0;KZ75125EUR2069100103;2016-07-03;-264;-264;-132;27;13.5;EUR;null;null;-291;-145.5;0.5
0;KZ75125EUR2069100103;2016-07-04;-209;-209;-104.5;55;27.5;EUR;null;null;-264;-132;0.5
0;KZ75125EUR2069100103;2016-07-05;-255;-255;-127.5;null;null;EUR;46;23;-209;-104.5;0.5
0;KZ75125EUR2069100103;2016-07-06;-203;-203;-101.5;52;26;EUR;null;null;-255;-127.5;0.5
0;KZ75125EUR2069100103;2016-07-07;-199;-199;-99.5;4;2;EUR;null;null;-203;-101.5;0.5
0;KZ75125EUR2069100103;2016-07-08;-190;-190;-95;9;4.5;EUR;null;null;-199;-99.5;0.5
0;KZ75125EUR2069100103;2016-07-09;-281;-281;-140.5;null;null;EUR;91;45.5;-190;-95;0.5
0;KZ75125EUR2069100103;2016-07-10;-222;-222;-111;59;29.5;EUR;null;null;-281;-140.5;0.5
0;KZ75125EUR2069100103;2016-07-11;-139;-139;-69.5;83;41.5;EUR;null;null;-222;-111;0.5
0;KZ75125EUR2069100103;2016-07-12;-149;-149;-74.5;null;null;EUR;10;5;-139;-69.5;0.5
0;KZ75125EUR2069100103;2016-07-13;-187;-187;-93.5;null;null;EUR;38;19;-149;-74.5;0.5
0;KZ75125EUR2069100103;2016-07-14;-89;-89;-44.5;98;49;EUR;null;null;-187;-93.5;0.5
0;KZ75125EUR2069100103;2016-07-15;-4;-4;-2;85;42.5;EUR;null;null;-89;-44.5;0.5
0;KZ75125EUR2069100103;2016-07-16;83;83;41.5;87;43.5;EUR;null;null;-4;-2;0.5
0;KZ75125EUR2069100103;2016-07-17;129;129;64.5;46;23;EUR;null;null;83;41.5;0.5
0;KZ75125EUR2069100103;2016-07-18;112;112;56;null;null;EUR;17;8.5;129;64.5;0.5
0;KZ75125EUR2069100103;2016-07-19;128;128;64;16;8;EUR;null;null;112;56;0.5
0;KZ75125EUR2069100103;2016-07-20;192;192;96;64;32;EUR;null;null;128;64;0.5
0;KZ75125EUR2069100103;2016-07-21;236;236;118;44;22;EUR;null;null;192;96;0.5
0;KZ75125EUR2069100103;2016-07-22;171;171;85.5;null;null;EUR;65;32.5;236;118;0.5
0;KZ75125EUR2069100103;2016-07-23;251;251;125.5;80;40;EUR;null;null;171;85.5;0.5
0;KZ75125EUR2069100103;2016-07-24;293;293;146.5;42;21;EUR;null;null;251;125.5;0.5
0;KZ75125EUR2069100103;2016-07-25;215;215;107.5;null;null;EUR;78;39;293;146.5;0.5
0;KZ75125EUR2069100103;2016-07-26;133;133;66.5;null;null;EUR;82;41;215;107.5;0.5
0;KZ75125EUR2069100103;2016-07-27;158;158;79;25;12.5;EUR;null;null;133;66.5;0.5
0;KZ75125EUR2069100103;2016-07-28;243;243;121.5;85;42.5;EUR;null;null;158;79;0.5
0;KZ75125EUR2069100103;2016-07-29;249;249;124.5;6;3;EUR;null;null;243;121.5;0.5
0;KZ75125EUR2069100103;2016-07-30;154;154;77;null;null;EUR;95;47.5;249;124.5;0.5
0;KZ75125EUR2069100103;2016-07-31;87;87;43.5;null;null;EUR;67;33.5;154;77;0.5
0;KZ75125EUR2069100103;2016-08-01;166;166;83;79;39.5;EUR;null;null;87;43.5;0.5
0;KZ75125EUR2069100103;2016-08-02;147;147;73.5;null;null;EUR;19;9.5;166;83;0.5
0;KZ75125EUR2069100103;2016-08-03;63;63;31.5;null;null;EUR;84;42;147;73.5;0.5
0;KZ75125EUR2069100103;2016-08-04;44;44;22;null;null;EUR;19;9.5;63;31.5;0.5
0;KZ75125EUR2069100103;2016-08-05;67;67;33.5;23;11.5;EUR;null;null;44;22;0.5
0;KZ75125EUR2069100103;2016-08-06;122;122;61;55;27.5;EUR;null;null;67;33.5;0.5
0;KZ75125EUR2069100103;2016-08-07;127;127;63.5;5;2.5;EUR;null;null;122;61;0.5
0;KZ75125EUR2069100103;2016-08-08;192;192;96;65;32.5;EUR;null;null;127;63.5;0.5
0;KZ75125EUR2069100103;2016-08-09;95;95;47.5;null;null;EUR;97;48.5;192;96;0.5
0;KZ75125EUR2069100103;2016-08-10;136;136;68;41;20.5;EUR;null;null;95;47.5;0.5
0;KZ75125EUR2069100103;2016-08-11;168;168;84;32;16;EUR;null;null;136;68;0.5
0;KZ75125EUR2069100103;2016-08-12;169;169;84.5;1;0.5;EUR;null;null;168;84;0.5
0;KZ75125EUR2069100103;2016-08-13;167;167;83.5;null;null;EUR;2;1;169;84.5;0.5
0;KZ75125EUR2069100103;2016-08-14;120;120;60;null;null;EUR;47;23.5;167;83.5;0.5
0;KZ75125EUR2069100103;2016-08-15;59;59;29.5;null;null;EUR;61;30.5;120;60;0.5
0;KZ75125EUR2069100103;2016-08-16;110;110;55;51;25.5;EUR;null;null;59;29.5;0.5
0;KZ75125EUR2069100103;2016-08-17;203;203;101.5;93;46.5;EUR;null;null;110;55;0.5
0;KZ75125EUR2069100103;2016-08-18;125;125;62.5;null;null;EUR;78;39;203;101.5;0.5
0;KZ75125EUR2069100103;2016-08-19;49;49;24.5;null;null;EUR;76;38;125;62.5;0.5
0;KZ75125EUR2069100103;2016-08-20;92;92;46;43;21.5;EUR;null;null;49;24.5;0.5
0;KZ75125EUR2069100103;2016-08-21;191;191;95.5;99;49.5;EUR;null;null;92;46;0.5
0;KZ75125EUR2069100103;2016-08-22;149;149;74.5;null;null;EUR;42;21;191;95.5;0.5
0;KZ75125EUR2069100103;2016-08-23;70;70;35;null;null;EUR;79;39.5;149;74.5;0.5
0;KZ75125EUR2069100103;2016-08-24;81;81;40.5;11;5.5;EUR;null;null;70;35;0.5
0;KZ75125EUR2069100103;2016-08-25;44;44;22;null;null;EUR;37;18.5;81;40.5;0.5
0;KZ75125EUR2069100103;2016-08-26;-42;-42;-21;null;null;EUR;86;43;44;22;0.5
0;KZ75125EUR2069100103;2016-08-27;-44;-44;-22;null;null;EUR;2;1;-42;-21;0.5
0;KZ75125EUR2069100103;2016-08-28;38;38;19;82;41;EUR;null;null;-44;-22;0.5
0;KZ75125EUR2069100103;2016-08-29;5;5;2.5;null;null;EUR;33;16.5;38;19;0.5
0;KZ75125EUR2069100103;2016-08-30;29;29;14.5;24;12;EUR;null;null;5;2.5;0.5
0;KZ75125EUR2069100103;2016-08-31;-40;-40;-20;null;null;EUR;69;34.5;29;14.5;0.5
0;KZ75125EUR2069100103;2016-09-01;8;8;4;48;24;EUR;null;null;-40;-20;0.5
0;KZ75125EUR2069100103;2016-09-02;75;75;37.5;67;33.5;EUR;null;null;8;4;0.5
0;KZ75125EUR2069100103;2016-09-03;154;154;77;79;39.5;EUR;null;null;75;37.5;0.5
0;KZ75125EUR2069100103;2016-09-04;81;81;40.5;null;null;EUR;73;36.5;154;77;0.5
0;KZ75125EUR2069100103;2016-09-05;22;22;11;null;null;EUR;59;29.5;81;40.5;0.5
0;KZ75125EUR2069100103;2016-09-06;52;52;26;30;15;EUR;null;null;22;11;0.5
0;KZ75125EUR2069100103;2016-09-07;8;8;4;null;null;EUR;44;22;52;26;0.5
0;KZ75125EUR2069100103;2016-09-08;105;105;52.5;97;48.5;EUR;null;null;8;4;0.5
0;KZ75125EUR2069100103;2016-09-09;189;189;94.5;84;42;EUR;null;null;105;52.5;0.5
0;KZ75125EUR2069100103;2016-09-10;97;97;48.5;null;null;EUR;92;46;189;94.5;0.5
0;KZ75125EUR2069100103;2016-09-11;92;92;46;null;null;EUR;5;2.5;97;48.5;0.5
0;KZ75125EUR2069100103;2016-09-12;44;44;22;null;null;EUR;48;24;92;46;0.5
0;KZ75125EUR2069100103;2016-09-13;89;89;44.5;45;22.5;EUR;null;null;44;22;0.5
0;KZ75125EUR2069100103;2016-09-14;153;153;76.5;64;32;EUR;null;null;89;44.5;0.5
0;KZ75125EUR2069100103;2016-09-15;200;200;100;47;23.5;EUR;null;null;153;76.5;0.5
0;KZ75125EUR2069100103;2016-09-16;184;184;92;null;null;EUR;16;8;200;100;0.5
0;KZ75125EUR2069100103;2016-09-17;112;112;56;null;null;EUR;72;36;184;92;0.5
0;KZ75125EUR2069100103;2016-09-18;187;187;93.5;75;37.5;EUR;null;null;112;56;0.5
0;KZ75125EUR2069100103;2016-09-19;195;195;97.5;8;4;EUR;null;null;187;93.5;0.5
0;KZ75125EUR2069100103;2016-09-20;243;243;121.5;48;24;EUR;null;null;195;97.5;0.5
0;KZ75125EUR2069100103;2016-09-21;302;302;151;59;29.5;EUR;null;null;243;121.5;0.5
0;KZ75125EUR2069100103;2016-09-22;359;359;179.5;57;28.5;EUR;null;null;302;151;0.5
0;KZ75125EUR2069100103;2016-09-23;423;423;211.5;64;32;EUR;null;null;359;179.5;0.5
0;KZ75125EUR2069100103;2016-09-24;403;403;201.5;null;null;EUR;20;10;423;211.5;0.5
0;KZ75125EUR2069100103;2016-09-25;419;419;209.5;16;8;EUR;null;null;403;201.5;0.5
0;KZ75125EUR2069100103;2016-09-26;499;499;249.5;80;40;EUR;null;null;419;209.5;0.5
0;KZ75125EUR2069100103;2016-09-27;479;479;239.5;null;null;EUR;20;10;499;249.5;0.5
0;KZ75125EUR2069100103;2016-09-28;392;392;196;null;null;EUR;87;43.5;479;239.5;0.5
0;KZ75125EUR2069100103;2016-09-29;370;370;185;null;null;EUR;22;11;392;196;0.5
0;KZ75125EUR2069100103;2016-09-30;292;292;146;null;null;EUR;78;39;370;185;0.5
0;KZ75125EUR2069100103;2016-10-01;255;255;127.5;null;null;EUR;37;18.5;292;146;0.5
0;KZ75125EUR2069100103;2016-10-02;322;322;161;67;33.5;EUR;null;null;255;127.5;0.5
0;KZ75125EUR2069100103;2016-10-03;299;299;149.5;null;null;EUR;23;11.5;322;161;0.5
0;KZ75125EUR2069100103;2016-10-04;328;328;164;29;14.5;EUR;null;null;299;149.5;0.5
0;KZ75125EUR2069100103;2016-10-05;358;358;179;30;15;EUR;null;null;328;164;0.5
0;KZ75125EUR2069100103;2016-10-06;294;294;147;null;null;EUR;64;32;358;179;0.5
0;KZ75125EUR2069100103;2016-10-07;226;226;113;null;null;EUR;68;34;294;147;0.5
0;KZ75125EUR2069100103;2016-10-08;207;207;103.5;null;null;EUR;19;9.5;226;113;0.5
0;KZ75125EUR2069100103;2016-10-09;299;299;149.5;92;46;EUR;null;null;207;103.5;0.5
0;KZ75125EUR2069100103;2016-10-10;365;365;182.5;66;33;EUR;null;null;299;149.5;0.5
0;KZ75125EUR2069100103;2016-10-11;312;312;156;null;null;EUR;53;26.5;365;182.5;0.5
0;KZ75125EUR2069100103;2016-10-12;379;379;189.5;67;33.5;EUR;null;null;312;156;0.5
0;KZ75125EUR2069100103;2016-10-13;355;355;177.5;null;null;EUR;24;12;379;189.5;0.5
0;KZ75125EUR2069100103;2016-10-14;359;359;179.5;4;2;EUR;null;null;355;177.5;0.5
0;KZ75125EUR2069100103;2016-10-15;348;348;174;null;null;EUR;11;5.5;359;179.5;0.5
0;KZ75125EUR2069100103;2016-10-16;378;378;189;30;15;EUR;null;null;348;174;0.5
0;KZ75125EUR2069100103;2016-10-17;394;394;197;16;8;EUR;null;null;378;189;0.5
0;KZ75125EUR2069100103;2016-10-18;315;315;157.5;null;null;EUR;79;39.5;394;197;0.5
0;KZ75125EUR2069100103;2016-10-19;402;402;201;87;43.5;EUR;null;null;315;157.5;0.5
0;KZ75125EUR2069100103;2016-10-20;477;477;238.5;75;37.5;EUR;null;null;402;201;0.5
0;KZ75125EUR2069100103;2016-10-21;560;560;280;83;41.5;EUR;null;null;477;238.5;0.5
0;KZ75125EUR2069100103;2016-10-22;588;588;294;28;14;EUR;null;null;560;280;0.5
0;KZ75125EUR2069100103;2016-10-23;682;682;341;94;47;EUR;null;null;588;294;0.5
0;KZ75125EUR2069100103;2016-10-24;712;712;356;30;15;EUR;null;null;682;341;0.5
0;KZ75125EUR2069100103;2016-10-25;669;669;334.5;null;null;EUR;43;21.5;712;356;0.5
0;KZ75125EUR2069100103;2016-10-26;697;697;348.5;28;14;EUR;null;null;669;334.5;0.5
0;KZ75125EUR2069100103;2016-10-27;648;648;324;null;null;EUR;49;24.5;697;348.5;0.5
0;KZ75125EUR2069100103;2016-10-28;671;671;335.5;23;11.5;EUR;null;null;648;324;0.5
0;KZ75125EUR2069100103;2016-10-29;593;593;296.5;null;null;EUR;78;39;671;335.5;0.5
0;KZ75125EUR2069100103;2016-10-30;690;690;345;97;48.5;EUR;null;null;593;296.5;0.5
0;KZ75125EUR2069100103;2016-10-31;630;630;315;null;null;EUR;60;30;690;345;0.5
0;KZ75125EUR2069100103;2016-11-01;540;540;270;null;null;EUR;90;45;630;315;0.5
0;KZ75125EUR2069100103;2016-11-02;462;462;231;null;null;EUR;78;39;540;270;0.5
0;KZ75125EUR2069100103;2016-11-03;557;557;278.5;95;47.5;EUR;null;null;462;231;0.5
0;KZ75125EUR2069100103;2016-11-04;567;567;283.5;10;5;EUR;null;null;557;278.5;0.5
0;KZ75125EUR2069100103;2016-11-05;542;542;271;null;null;EUR;25;12.5;567;283.5;0.5
0;KZ75125EUR2069100103;2016-11-06;584;584;292;42;21;EUR;null;null;542;271;0.5
0;KZ75125EUR2069100103;2016-11-07;673;673;336.5;89;44.5;EUR;null;null;584;292;0.5
0;KZ75125EUR2069100103;2016-11-08;679;679;339.5;6;3;EUR;null;null;673;336.5;0.5
0;KZ75125EUR2069100103;2016-11-09;729;729;364.5;50;25;EUR;null;null;679;339.5;0.5
0;KZ75125EUR2069100103;2016-11-10;745;745;372.5;16;8;EUR;null;null;729;364.5;0.5
0;KZ75125EUR2069100103;2016-11-11;741;741;370.5;null;null;EUR;4;2;745;372.5;0.5
0;KZ75125EUR2069100103;2016-11-12;684;684;342;null;null;EUR;57;28.5;741;370.5;0.5
0;KZ75125EUR2069100103;2016-11-13;724;724;362;40;20;EUR;null;null;684;342;0.5
0;KZ75125EUR2069100103;2016-11-14;680;680;340;null;null;EUR;44;22;724;362;0.5
0;KZ75125EUR2069100103;2016-11-15;622;622;311;null;null;EUR;58;29;680;340;0.5
0;KZ75125EUR2069100103;2016-11-16;695;695;347.5;73;36.5;EUR;null;null;622;311;0.5
0;KZ75125EUR2069100103;2016-11-17;728;728;364;33;16.5;EUR;null;null;695;347.5;0.5
0;KZ75125EUR2069100103;2016-11-18;819;819;409.5;91;45.5;EUR;null;null;728;364;0.5
0;KZ75125EUR2069100103;2016-11-19;842;842;421;23;11.5;EUR;null;null;819;409.5;0.5
0;KZ75125EUR2069100103;2016-11-20;886;886;443;44;22;EUR;null;null;842;421;0.5
0;KZ75125EUR2069100103;2016-11-21;870;870;435;null;null;EUR;16;8;886;443;0.5
0;KZ75125EUR2069100103;2016-11-22;926;926;463;56;28;EUR;null;null;870;435;0.5
0;KZ75125EUR2069100103;2016-11-23;1003;1003;501.5;77;38.5;EUR;null;null;926;463;0.5
0;KZ75125EUR2069100103;2016-11-24;928;928;464;null;null;EUR;75;37.5;1003;501.5;0.5
0;KZ75125EUR2069100103;2016-11-25;830;830;415;null;null;EUR;98;49;928;464;0.5
0;KZ75125EUR2069100103;2016-11-26;761;761;380.5;null;null;EUR;69;34.5;830;415;0.5
0;KZ75125EUR2069100103;2016-11-27;693;693;346.5;null;null;EUR;68;34;761;380.5;0.5
0;KZ75125EUR2069100103;2016-11-28;773;773;386.5;80;40;EUR;null;null;693;346.5;0.5
0;KZ75125EUR2069100103;2016-11-29;832;832;416;59;29.5;EUR;null;null;773;386.5;0.5
0;KZ75125EUR2069100103;2016-11-30;868;868;434;36;18;EUR;null;null;832;416;0.5
0;KZ75125EUR2069100103;2016-12-01;788;788;394;null;null;EUR;80;40;868;434;0.5
0;KZ75125EUR2069100103;2016-12-02;848;848;424;60;30;EUR;null;null;788;394;0.5
0;KZ75125EUR2069100103;2016-12-03;880;880;440;32;16;EUR;null;null;848;424;0.5
0;KZ75125EUR2069100103;2016-12-04;922;922;461;42;21;EUR;null;null;880;440;0.5
0;KZ75125EUR2069100103;2016-12-05;940;940;470;18;9;EUR;null;null;922;461;0.5
0;KZ75125EUR2069100103;2016-12-06;1004;1004;502;64;32;EUR;null;null;940;470;0.5
0;KZ75125EUR2069100103;2016-12-07;922;922;461;null;null;EUR;82;41;1004;502;0.5
0;KZ75125EUR2069100103;2016-12-08;896;896;448;null;null;EUR;26;13;922;461;0.5
0;KZ75125EUR2069100103;2016-12-09;981;981;490.5;85;42.5;EUR;null;null;896;448;0.5
0;KZ75125EUR2069100103;2016-12-10;1021;1021;510.5;40;20;EUR;null;null;981;490.5;0.5
0;KZ75125EUR2069100103;2016-12-11;1000;1000;500;null;null;EUR;21;10.5;1021;510.5;0.5
0;KZ75125EUR2069100103;2016-12-12;940;940;470;null;null;EUR;60;30;1000;500;0.5
0;KZ75125EUR2069100103;2016-12-13;924;924;462;null;null;EUR;16;8;940;470;0.5
0;KZ75125EUR2069100103;2016-12-14;863;863;431.5;null;null;EUR;61;30.5;924;462;0.5
0;KZ75125EUR2069100103;2016-12-15;882;882;441;19;9.5;EUR;null;null;863;431.5;0.5
0;KZ75125EUR2069100103;2016-12-16;785;785;392.5;null;null;EUR;97;48.5;882;441;0.5
0;KZ75125EUR2069100103;2016-12-17;870;870;435;85;42.5;EUR;null;null;785;392.5;0.5
0;KZ75125EUR2069100103;2016-12-18;827;827;413.5;null;null;EUR;43;21.5;870;435;0.5
0;KZ75125EUR2069100103;2016-12-19;884;884;442;57;28.5;EUR;null;null;827;413.5;0.5
0;KZ75125EUR2069100103;2016-12-20;964;964;482;80;40;EUR;null;null;884;442;0.5
0;KZ75125EUR2069100103;2016-12-21;1061;1061;530.5;97;48.5;EUR;null;null;964;482;0.5
0;KZ75125EUR2069100103;2016-12-22;1041;1041;520.5;null;null;EUR;20;10;1061;530.5;0.5
0;KZ75125EUR2069100103;2016-12-23;958;958;479;null;null;EUR;83;41.5;1041;520.5;0.5
0;KZ75125EUR2069100103;2016-12-24;927;927;463.5;null;null;EUR;31;15.5;958;479;0.5
0;KZ75125EUR2069100103;2016-12-25;950;950;475;23;11.5;EUR;null;null;927;463.5;0.5
0;KZ75125EUR2069100103;2016-12-26;930;930;465;null;null;EUR;20;10;950;475;0.5
0;KZ75125EUR2069100103;2016-12-27;881;881;440.5;null;null;EUR;49;24.5;930;465;0.5
0;KZ75125EUR2069100103;2016-12-28;947;947;473.5;66;33;EUR;null;null;881;440.5;0.5
0;KZ75125EUR2069100103;2016-12-29;857;857;428.5;null;null;EUR;90;45;947;473.5;0.5
0;KZ75125EUR2069100103;2016-12-30;835;835;417.5;null;null;EUR;22;11;857;428.5;0.5
0;KZ75125EUR2069100103;2016-12-31;784;784;392;null;null;EUR;51;25.5;835;417.5;0.5
0;KZ75125EUR2069100103;2017-01-01;867;867;433.5;83;41.5;EUR;null;null;784;392;0.5
0;KZ75125EUR2069100103;2017-01-02;888;888;444;21;10.5;EUR;null;null;867;433.5;0.5
0;KZ75125EUR2069100103;2017-01-03;854;854;427;null;null;EUR;34;17;888;444;0.5
0;KZ75125EUR2069100103;2017-01-04;863;863;431.5;9;4.5;EUR;null;null;854;427;0.5
0;KZ75125EUR2069100103;2017-01-05;809;809;404.5;null;null;EUR;54;27;863;431.5;0.5
0;KZ75125EUR2069100103;2017-01-06;749;749;374.5;null;null;EUR;60;30;809;404.5;0.5
0;KZ75125EUR2069100103;2017-01-07;681;681;340.5;null;null;EUR;68;34;749;374.5;0.5
0;KZ75125EUR2069100103;2017-01-08;670;670;335;null;null;EUR;11;5.5;681;340.5;0.5
0;KZ75125EUR2069100103;2017-01-09;730;730;365;60;30;EUR;null;null;670;335;0.5
0;KZ75125EUR2069100103;2017-01-10;695;695;347.5;null;null;EUR;35;17.5;730;365;0.5
0;KZ75125EUR2069100103;2017-01-11;657;657;328.5;null;null;EUR;38;19;695;347.5;0.5
0;KZ75125EUR2069100103;2017-01-12;664;664;332;7;3.5;EUR;null;null;657;328.5;0.5
0;KZ75125EUR2069100103;2017-01-13;606;606;303;null;null;EUR;58;29;664;332;0.5
0;KZ75125EUR2069100103;2017-01-14;689;689;344.5;83;41.5;EUR;null;null;606;303;0.5
0;KZ75125EUR2069100103;2017-01-15;685;685;342.5;null;null;EUR;4;2;689;344.5;0.5
0;KZ75125EUR2069100103;2017-01-16;588;588;294;null;null;EUR;97;48.5;685;342.5;0.5
0;KZ75125EUR2069100103;2017-01-17;651;651;325.5;63;31.5;EUR;null;null;588;294;0.5
0;KZ75125EUR2069100103;2017-01-18;644;644;322;null;null;EUR;7;3.5;651;325.5;0.5
0;KZ75125EUR2069100103;2017-01-19;560;560;280;null;null;EUR;84;42;644;322;0.5
0;KZ75125EUR2069100103;2017-01-20;501;501;250.5;null;null;EUR;59;29.5;560;280;0.5
0;KZ75125EUR2069100103;2017-01-21;441;441;220.5;null;null;EUR;60;30;501;250.5;0.5
0;KZ75125EUR2069100103;2017-01-22;510;510;255;69;34.5;EUR;null;null;441;220.5;0.5
0;KZ75125EUR2069100103;2017-01-23;435;435;217.5;null;null;EUR;75;37.5;510;255;0.5
0;KZ75125EUR2069100103;2017-01-24;491;491;245.5;56;28;EUR;null;null;435;217.5;0.5
0;KZ75125EUR2069100103;2017-01-25;531;531;265.5;40;20;EUR;null;null;491;245.5;0.5
0;KZ75125EUR2069100103;2017-01-26;565;565;282.5;34;17;EUR;null;null;531;265.5;0.5
0;KZ75125EUR2069100103;2017-01-27;478;478;239;null;null;EUR;87;43.5;565;282.5;0.5
0;KZ75125EUR2069100103;2017-01-28;407;407;203.5;null;null;EUR;71;35.5;478;239;0.5
0;KZ75125EUR2069100103;2017-01-29;363;363;181.5;null;null;EUR;44;22;407;203.5;0.5
0;KZ75125EUR2069100103;2017-01-30;353;353;176.5;null;null;EUR;10;5;363;181.5;0.5
0;KZ75125EUR2069100103;2017-01-31;414;414;207;61;30.5;EUR;null;null;353;176.5;0.5
0;KZ75125EUR2069100103;2017-02-01;449;449;224.5;35;17.5;EUR;null;null;414;207;0.5
0;KZ75125EUR2069100103;2017-02-02;534;534;267;85;42.5;EUR;null;null;449;224.5;0.5
0;KZ75125EUR2069100103;2017-02-03;439;439;219.5;null;null;EUR;95;47.5;534;267;0.5
0;KZ75125EUR2069100103;2017-02-04;385;385;192.5;null;null;EUR;54;27;439;219.5;0.5
0;KZ75125EUR2069100103;2017-02-05;295;295;147.5;null;null;EUR;90;45;385;192.5;0.5
0;KZ75125EUR2069100103;2017-02-06;318;318;159;23;11.5;EUR;null;null;295;147.5;0.5
0;KZ75125EUR2069100103;2017-02-07;289;289;144.5;null;null;EUR;29;14.5;318;159;0.5
0;KZ75125EUR2069100103;2017-02-08;282;282;141;null;null;EUR;7;3.5;289;144.5;0.5
0;KZ75125EUR2069100103;2017-02-09;274;274;137;null;null;EUR;8;4;282;141;0.5
0;KZ75125EUR2069100103;2017-02-10;359;359;179.5;85;42.5;EUR;null;null;274;137;0.5
0;KZ75125EUR2069100103;2017-02-11;324;324;162;null;null;EUR;35;17.5;359;179.5;0.5
0;KZ75125EUR2069100103;2017-02-12;372;372;186;48;24;EUR;null;null;324;162;0.5
0;KZ75125EUR2069100103;2017-02-13;442;442;221;70;35;EUR;null;null;372;186;0.5
0;KZ75125EUR2069100103;2017-02-14;465;465;232.5;23;11.5;EUR;null;null;442;221;0.5
0;KZ75125EUR2069100103;2017-02-15;543;543;271.5;78;39;EUR;null;null;465;232.5;0.5
0;KZ75125EUR2069100103;2017-02-16;582;582;291;39;19.5;EUR;null;null;543;271.5;0.5
0;KZ75125EUR2069100103;2017-02-17;500;500;250;null;null;EUR;82;41;582;291;0.5
0;KZ75125EUR2069100103;2017-02-18;407;407;203.5;null;null;EUR;93;46.5;500;250;0.5
0;KZ75125EUR2069100103;2017-02-19;376;376;188;null;null;EUR;31;15.5;407;203.5;0.5
0;KZ75125EUR2069100103;2017-02-20;473;473;236.5;97;48.5;EUR;null;null;376;188;0.5
0;KZ75125EUR2069100103;2017-02-21;496;496;248;23;11.5;EUR;null;null;473;236.5;0.5
0;KZ75125EUR2069100103;2017-02-22;481;481;240.5;null;null;EUR;15;7.5;496;248;0.5
0;KZ75125EUR2069100103;2017-02-23;511;511;255.5;30;15;EUR;null;null;481;240.5;0.5
0;KZ75125EUR2069100103;2017-02-24;510;510;255;null;null;EUR;1;0.5;511;255.5;0.5
0;KZ75125EUR2069100103;2017-02-25;445;445;222.5;null;null;EUR;65;32.5;510;255;0.5
0;KZ75125EUR2069100103;2017-02-26;420;420;210;null;null;EUR;25;12.5;445;222.5;0.5
0;KZ75125EUR2069100103;2017-02-27;413;413;206.5;null;null;EUR;7;3.5;420;210;0.5
0;KZ75125EUR2069100103;2017-02-28;421;421;210.5;8;4;EUR;null;null;413;206.5;0.5
0;KZ75125EUR2069100103;2017-03-01;387;387;193.5;null;null;EUR;34;17;421;210.5;0.5
0;KZ75125EUR2069100103;2017-03-02;470;470;235;83;41.5;EUR;null;null;387;193.5;0.5
0;KZ75125EUR2069100103;2017-03-03;389;389;194.5;null;null;EUR;81;40.5;470;235;0.5
0;KZ75125EUR2069100103;2017-03-04;384;384;192;null;null;EUR;5;2.5;389;194.5;0.5
0;KZ75125EUR2069100103;2017-03-05;380;380;190;null;null;EUR;4;2;384;192;0.5
0;KZ75125EUR2069100103;2017-03-06;379;379;189.5;null;null;EUR;1;0.5;380;190;0.5
0;KZ75125EUR2069100103;2017-03-07;347;347;173.5;null;null;EUR;32;16;379;189.5;0.5
0;KZ75125EUR2069100103;2017-03-08;275;275;137.5;null;null;EUR;72;36;347;173.5;0.5
0;KZ75125EUR2069100103;2017-03-09;199;199;99.5;null;null;EUR;76;38;275;137.5;0.5
0;KZ75125EUR2069100103;2017-03-10;181;181;90.5;null;null;EUR;18;9;199;99.5;0.5
0;KZ75125EUR2069100103;2017-03-11;187;187;93.5;6;3;EUR;null;null;181;90.5;0.5
0;KZ75125EUR2069100103;2017-03-12;159;159;79.5;null;null;EUR;28;14;187;93.5;0.5
0;KZ75125EUR2069100103;2017-03-13;173;173;86.5;14;7;EUR;null;null;159;79.5;0.5
0;KZ75125EUR2069100103;2017-03-14;175;175;87.5;2;1;EUR;null;null;173;86.5;0.5
0;KZ75125EUR2069100103;2017-03-15;192;192;96;17;8.5;EUR;null;null;175;87.5;0.5
0;KZ75125EUR2069100103;2017-03-16;251;251;125.5;59;29.5;EUR;null;null;192;96;0.5
0;KZ75125EUR2069100103;2017-03-17;287;287;143.5;36;18;EUR;null;null;251;125.5;0.5
0;KZ75125EUR2069100103;2017-03-18;297;297;148.5;10;5;EUR;null;null;287;143.5;0.5
0;KZ75125EUR2069100103;2017-03-19;211;211;105.5;null;null;EUR;86;43;297;148.5;0.5
0;KZ75125EUR2069100103;2017-03-20;193;193;96.5;null;null;EUR;18;9;211;105.5;0.5
0;KZ75125EUR2069100103;2017-03-21;283;283;141.5;90;45;EUR;null;null;193;96.5;0.5
0;KZ75125EUR2069100103;2017-03-22;184;184;92;null;null;EUR;99;49.5;283;141.5;0.5
0;KZ75125EUR2069100103;2017-03-23;209;209;104.5;25;12.5;EUR;null;null;184;92;0.5
0;KZ75125EUR2069100103;2017-03-24;227;227;113.5;18;9;EUR;null;null;209;104.5;0.5
0;KZ75125EUR2069100103;2017-03-25;282;282;141;55;27.5;EUR;null;null;227;113.5;0.5
0;KZ75125EUR2069100103;2017-03-26;240;240;120;null;null;EUR;42;21;282;141;0.5
0;KZ75125EUR2069100103;2017-03-27;174;174;87;null;null;EUR;66;33;240;120;0.5
0;KZ75125EUR2069100103;2017-03-28;256;256;128;82;41;EUR;null;null;174;87;0.5
0;KZ75125EUR2069100103;2017-03-29;215;215;107.5;null;null;EUR;41;20.5;256;128;0.5
0;KZ75125EUR2069100103;2017-03-30;307;307;153.5;92;46;EUR;null;null;215;107.5;0.5
0;KZ75125EUR2069100103;2017-03-31;223;223;111.5;null;null;EUR;84;42;307;153.5;0.5
0;KZ75125EUR2069100103;2017-04-01;272;272;136;49;24.5;EUR;null;null;223;111.5;0.5
0;KZ75125EUR2069100103;2017-04-02;209;209;104.5;null;null;EUR;63;31.5;272;136;0.5
0;KZ75125EUR2069100103;2017-04-03;265;265;132.5;56;28;EUR;null;null;209;104.5;0.5
0;KZ75125EUR2069100103;2017-04-04;177;177;88.5;null;null;EUR;88;44;265;132.5;0.5
0;KZ75125EUR2069100103;2017-04-05;105;105;52.5;null;null;EUR;72;36;177;88.5;0.5
0;KZ75125EUR2069100103;2017-04-06;141;141;70.5;36;18;EUR;null;null;105;52.5;0.5
0;KZ75125EUR2069100103;2017-04-07;155;155;77.5;14;7;EUR;null;null;141;70.5;0.5
0;KZ75125EUR2069100103;2017-04-08;145;145;72.5;null;null;EUR;10;5;155;77.5;0.5
0;KZ75125EUR2069100103;2017-04-09;51;51;25.5;null;null;EUR;94;47;145;72.5;0.5
0;KZ75125EUR2069100103;2017-04-10;47;47;23.5;null;null;EUR;4;2;51;25.5;0.5
0;KZ75125EUR2069100103;2017-04-11;77;77;38.5;30;15;EUR;null;null;47;23.5;0.5
0;KZ75125EUR2069100103;2017-04-12;20;20;10;null;null;EUR;57;28.5;77;38.5;0.5
0;KZ75125EUR2069100103;2017-04-13;-35;-35;-17.5;null;null;EUR;55;27.5;20;10;0.5
0;KZ75125EUR2069100103;2017-04-14;51;51;25.5;86;43;EUR;null;null;-35;-17.5;0.5
0;KZ75125EUR2069100103;2017-04-15;57;57;28.5;6;3;EUR;null;null;51;25.5;0.5
0;KZ75125EUR2069100103;2017-04-16;156;156;78;99;49.5;EUR;null;null;57;28.5;0.5
0;KZ75125EUR2069100103;2017-04-17;184;184;92;28;14;EUR;null;null;156;78;0.5
0;KZ75125EUR2069100103;2017-04-18;179;179;89.5;null;null;EUR;5;2.5;184;92;0.5
0;KZ75125EUR2069100103;2017-04-19;88;88;44;null;null;EUR;91;45.5;179;89.5;0.5
0;KZ75125EUR2069100103;2017-04-20;67;67;33.5;null;null;EUR;21;10.5;88;44;0.5
0;KZ75125EUR2069100103;2017-04-21;154;154;77;87;43.5;EUR;null;null;67;33.5;0.5
0;KZ75125EUR2069100103;2017-04-22;122;122;61;null;null;EUR;32;16;154;77;0.5
0;KZ75125EUR2069100103;2017-04-23;75;75;37.5;null;null;EUR;47;23.5;122;61;0.5
0;KZ75125EUR2069100103;2017-04-24;173;173;86.5;98;49;EUR;null;null;75;37.5;0.5
0;KZ75125EUR2069100103;2017-04-25;89;89;44.5;null;null;EUR;84;42;173;86.5;0.5
0;KZ75125EUR2069100103;2017-04-26;35;35;17.5;null;null;EUR;54;27;89;44.5;0.5
0;KZ75125EUR2069100103;2017-04-27;-16;-16;-8;null;null;EUR;51;25.5;35;17.5;0.5
0;KZ75125EUR2069100103;2017-04-28;-84;-84;-42;null;null;EUR;68;34;-16;-8;0.5
0;KZ75125EUR2069100103;2017-04-29;-123;-123;-61.5;null;null;EUR;39;19.5;-84;-42;0.5
0;KZ75125EUR2069100103;2017-04-30;-119;-119;-59.5;4;2;EUR;null;null;-123;-61.5;0.5
0;KZ75125EUR2069100103;2017-05-01;-172;-172;-86;null;null;EUR;53;26.5;-119;-59.5;0.5
0;KZ75125EUR2069100103;2017-05-02;-134;-134;-67;38;19;EUR;null;null;-172;-86;0.5
0;KZ75125EUR2069100103;2017-05-03;-107;-107;-53.5;27;13.5;EUR;null;null;-134;-67;0.5
0;KZ75125EUR2069100103;2017-05-04;-26;-26;-13;81;40.5;EUR;null;null;-107;-53.5;0.5
0;KZ75125EUR2069100103;2017-05-05;53;53;26.5;79;39.5;EUR;null;null;-26;-13;0.5
0;KZ75125EUR2069100103;2017-05-06;116;116;58;63;31.5;EUR;null;null;53;26.5;0.5
0;KZ75125EUR2069100103;2017-05-07;112;112;56;null;null;EUR;4;2;116;58;0.5
0;KZ75125EUR2069100103;2017-05-08;50;50;25;null;null;EUR;62;31;112;56;0.5
0;KZ75125EUR2069100103;2017-05-09;-22;-22;-11;null;null;EUR;72;36;50;25;0.5
0;KZ75125EUR2069100103;2017-05-10;51;51;25.5;73;36.5;EUR;null;null;-22;-11;0.5
0;KZ75125EUR2069100103;2017-05-11;62;62;31;11;5.5;EUR;null;null;51;25.5;0.5
0;KZ75125EUR2069100103;2017-05-12;159;159;79.5;97;48.5;EUR;null;null;62;31;0.5
0;KZ75125EUR2069100103;2017-05-13;87;87;43.5;null;null;EUR;72;36;159;79.5;0.5
0;KZ75125EUR2069100103;2017-05-14;28;28;14;null;null;EUR;59;29.5;87;43.5;0.5
0;KZ75125EUR2069100103;2017-05-15;23;23;11.5;null;null;EUR;5;2.5;28;14;0.5
0;KZ75125EUR2069100103;2017-05-16;108;108;54;85;42.5;EUR;null;null;23;11.5;0.5
0;KZ75125EUR2069100103;2017-05-17;170;170;85;62;31;EUR;null;null;108;54;0.5
0;KZ75125EUR2069100103;2017-05-18;200;200;100;30;15;EUR;null;null;170;85;0.5
0;KZ75125EUR2069100103;2017-05-19;298;298;149;98;49;EUR;null;null;200;100;0.5
0;KZ75125EUR2069100103;2017-05-20;296;296;148;null;null;EUR;2;1;298;149;0.5
0;KZ75125EUR2069100103;2017-05-21;204;204;102;null;null;EUR;92;46;296;148;0.5
0;KZ75125EUR2069100103;2017-05-22;239;239;119.5;35;17.5;EUR;null;null;204;102;0.5
0;KZ75125EUR2069100103;2017-05-23;236;236;118;null;null;EUR;3;1.5;239;119.5;0.5
0;KZ75125EUR2069100103;2017-05-24;223;223;111.5;null;null;EUR;13;6.5;236;118;0.5
0;KZ75125EUR2069100103;2017-05-25;317;317;158.5;94;47;EUR;null;null;223;111.5;0.5
0;KZ75125EUR2069100103;2017-05-26;219;219;109.5;null;null;EUR;98;49;317;158.5;0.5
0;KZ75125EUR2069100103;2017-05-27;170;170;85;null;null;EUR;49;24.5;219;109.5;0.5
0;KZ75125EUR2069100103;2017-05-28;132;132;66;null;null;EUR;38;19;170;85;0.5
0;KZ75125EUR2069100103;2017-05-29;88;88;44;null;null;EUR;44;22;132;66;0.5
0;KZ75125EUR2069100103;2017-05-30;63;63;31.5;null;null;EUR;25;12.5;88;44;0.5
0;KZ75125EUR2069100103;2017-05-31;155;155;77.5;92;46;EUR;null;null;63;31.5;0.5
0;KZ75125EUR2069100103;2017-06-01;199;199;99.5;44;22;EUR;null;null;155;77.5;0.5
0;KZ75125EUR2069100103;2017-06-02;153;153;76.5;null;null;EUR;46;23;199;99.5;0.5
0;KZ75125EUR2069100103;2017-06-03;83;83;41.5;null;null;EUR;70;35;153;76.5;0.5
0;KZ75125EUR2069100103;2017-06-04;-5;-5;-2.5;null;null;EUR;88;44;83;41.5;0.5
0;KZ75125EUR2069100103;2017-06-05;60;60;30;65;32.5;EUR;null;null;-5;-2.5;0.5
0;KZ75125EUR2069100103;2017-06-06;150;150;75;90;45;EUR;null;null;60;30;0.5
0;KZ75125EUR2069100103;2017-06-07;150;150;75;null;null;EUR;0;0;150;75;0.5
0;KZ75125EUR2069100103;2017-06-08;210;210;105;60;30;EUR;null;null;150;75;0.5
0;KZ75125EUR2069100103;2017-06-09;160;160;80;null;null;EUR;50;25;210;105;0.5
0;KZ75125EUR2069100103;2017-06-10;101;101;50.5;null;null;EUR;59;29.5;160;80;0.5
0;KZ75125EUR2069100103;2017-06-11;129;129;64.5;28;14;EUR;null;null;101;50.5;0.5
0;KZ75125EUR2069100103;2017-06-12;176;176;88;47;23.5;EUR;null;null;129;64.5;0.5
0;KZ75125KZT2069100104;2015-05-11;60;60;60;null;null;KZT;40;40;100;100;1
0;KZ75125KZT2069100104;2015-05-12;128;128;128;68;68;KZT;null;null;60;60;1
0;KZ75125KZT2069100104;2015-05-13;75;75;75;null;null;KZT;53;53;128;128;1
0;KZ75125KZT2069100104;2015-05-14;-3;-3;-3;null;null;KZT;78;78;75;75;1
0;KZ75125KZT2069100104;2015-05-15;-101;-101;-101;null;null;KZT;98;98;-3;-3;1
0;KZ75125KZT2069100104;2015-05-16;-31;-31;-31;70;70;KZT;null;null;-101;-101;1
0;KZ75125KZT2069100104;2015-05-17;-107;-107;-107;null;null;KZT;76;76;-31;-31;1
0;KZ75125KZT2069100104;2015-05-18;-93;-93;-93;14;14;KZT;null;null;-107;-107;1
0;KZ75125KZT2069100104;2015-05-19;-42;-42;-42;51;51;KZT;null;null;-93;-93;1
0;KZ75125KZT2069100104;2015-05-20;-9;-9;-9;33;33;KZT;null;null;-42;-42;1
0;KZ75125KZT2069100104;2015-05-21;-8;-8;-8;1;1;KZT;null;null;-9;-9;1
0;KZ75125KZT2069100104;2015-05-22;-16;-16;-16;null;null;KZT;8;8;-8;-8;1
0;KZ75125KZT2069100104;2015-05-23;83;83;83;99;99;KZT;null;null;-16;-16;1
0;KZ75125KZT2069100104;2015-05-24;99;99;99;16;16;KZT;null;null;83;83;1
0;KZ75125KZT2069100104;2015-05-25;146;146;146;47;47;KZT;null;null;99;99;1
0;KZ75125KZT2069100104;2015-05-26;201;201;201;55;55;KZT;null;null;146;146;1
0;KZ75125KZT2069100104;2015-05-27;190;190;190;null;null;KZT;11;11;201;201;1
0;KZ75125KZT2069100104;2015-05-28;97;97;97;null;null;KZT;93;93;190;190;1
0;KZ75125KZT2069100104;2015-05-29;147;147;147;50;50;KZT;null;null;97;97;1
0;KZ75125KZT2069100104;2015-05-30;202;202;202;55;55;KZT;null;null;147;147;1
0;KZ75125KZT2069100104;2015-05-31;237;237;237;35;35;KZT;null;null;202;202;1
0;KZ75125KZT2069100104;2015-06-01;143;143;143;null;null;KZT;94;94;237;237;1
0;KZ75125KZT2069100104;2015-06-02;213;213;213;70;70;KZT;null;null;143;143;1
0;KZ75125KZT2069100104;2015-06-03;268;268;268;55;55;KZT;null;null;213;213;1
0;KZ75125KZT2069100104;2015-06-04;361;361;361;93;93;KZT;null;null;268;268;1
0;KZ75125KZT2069100104;2015-06-05;293;293;293;null;null;KZT;68;68;361;361;1
0;KZ75125KZT2069100104;2015-06-06;281;281;281;null;null;KZT;12;12;293;293;1
0;KZ75125KZT2069100104;2015-06-07;189;189;189;null;null;KZT;92;92;281;281;1
0;KZ75125KZT2069100104;2015-06-08;132;132;132;null;null;KZT;57;57;189;189;1
0;KZ75125KZT2069100104;2015-06-09;58;58;58;null;null;KZT;74;74;132;132;1
0;KZ75125KZT2069100104;2015-06-10;64;64;64;6;6;KZT;null;null;58;58;1
0;KZ75125KZT2069100104;2015-06-11;117;117;117;53;53;KZT;null;null;64;64;1
0;KZ75125KZT2069100104;2015-06-12;163;163;163;46;46;KZT;null;null;117;117;1
0;KZ75125KZT2069100104;2015-06-13;192;192;192;29;29;KZT;null;null;163;163;1
0;KZ75125KZT2069100104;2015-06-14;255;255;255;63;63;KZT;null;null;192;192;1
0;KZ75125KZT2069100104;2015-06-15;251;251;251;null;null;KZT;4;4;255;255;1
0;KZ75125KZT2069100104;2015-06-16;290;290;290;39;39;KZT;null;null;251;251;1
0;KZ75125KZT2069100104;2015-06-17;385;385;385;95;95;KZT;null;null;290;290;1
0;KZ75125KZT2069100104;2015-06-18;469;469;469;84;84;KZT;null;null;385;385;1
0;KZ75125KZT2069100104;2015-06-19;526;526;526;57;57;KZT;null;null;469;469;1
0;KZ75125KZT2069100104;2015-06-20;481;481;481;null;null;KZT;45;45;526;526;1
0;KZ75125KZT2069100104;2015-06-21;536;536;536;55;55;KZT;null;null;481;481;1
0;KZ75125KZT2069100104;2015-06-22;513;513;513;null;null;KZT;23;23;536;536;1
0;KZ75125KZT2069100104;2015-06-23;433;433;433;null;null;KZT;80;80;513;513;1
0;KZ75125KZT2069100104;2015-06-24;474;474;474;41;41;KZT;null;null;433;433;1
0;KZ75125KZT2069100104;2015-06-25;525;525;525;51;51;KZT;null;null;474;474;1
0;KZ75125KZT2069100104;2015-06-26;528;528;528;3;3;KZT;null;null;525;525;1
0;KZ75125KZT2069100104;2015-06-27;567;567;567;39;39;KZT;null;null;528;528;1
0;KZ75125KZT2069100104;2015-06-28;594;594;594;27;27;KZT;null;null;567;567;1
0;KZ75125KZT2069100104;2015-06-29;516;516;516;null;null;KZT;78;78;594;594;1
0;KZ75125KZT2069100104;2015-06-30;594;594;594;78;78;KZT;null;null;516;516;1
0;KZ75125KZT2069100104;2015-07-01;612;612;612;18;18;KZT;null;null;594;594;1
0;KZ75125KZT2069100104;2015-07-02;661;661;661;49;49;KZT;null;null;612;612;1
0;KZ75125KZT2069100104;2015-07-03;570;570;570;null;null;KZT;91;91;661;661;1
0;KZ75125KZT2069100104;2015-07-04;648;648;648;78;78;KZT;null;null;570;570;1
0;KZ75125KZT2069100104;2015-07-05;712;712;712;64;64;KZT;null;null;648;648;1
0;KZ75125KZT2069100104;2015-07-06;793;793;793;81;81;KZT;null;null;712;712;1
0;KZ75125KZT2069100104;2015-07-07;778;778;778;null;null;KZT;15;15;793;793;1
0;KZ75125KZT2069100104;2015-07-08;860;860;860;82;82;KZT;null;null;778;778;1
0;KZ75125KZT2069100104;2015-07-09;947;947;947;87;87;KZT;null;null;860;860;1
0;KZ75125KZT2069100104;2015-07-10;945;945;945;null;null;KZT;2;2;947;947;1
0;KZ75125KZT2069100104;2015-07-11;883;883;883;null;null;KZT;62;62;945;945;1
0;KZ75125KZT2069100104;2015-07-12;877;877;877;null;null;KZT;6;6;883;883;1
0;KZ75125KZT2069100104;2015-07-13;819;819;819;null;null;KZT;58;58;877;877;1
0;KZ75125KZT2069100104;2015-07-14;803;803;803;null;null;KZT;16;16;819;819;1
0;KZ75125KZT2069100104;2015-07-15;759;759;759;null;null;KZT;44;44;803;803;1
0;KZ75125KZT2069100104;2015-07-16;723;723;723;null;null;KZT;36;36;759;759;1
0;KZ75125KZT2069100104;2015-07-17;693;693;693;null;null;KZT;30;30;723;723;1
0;KZ75125KZT2069100104;2015-07-18;776;776;776;83;83;KZT;null;null;693;693;1
0;KZ75125KZT2069100104;2015-07-19;812;812;812;36;36;KZT;null;null;776;776;1
0;KZ75125KZT2069100104;2015-07-20;772;772;772;null;null;KZT;40;40;812;812;1
0;KZ75125KZT2069100104;2015-07-21;807;807;807;35;35;KZT;null;null;772;772;1
0;KZ75125KZT2069100104;2015-07-22;797;797;797;null;null;KZT;10;10;807;807;1
0;KZ75125KZT2069100104;2015-07-23;834;834;834;37;37;KZT;null;null;797;797;1
0;KZ75125KZT2069100104;2015-07-24;764;764;764;null;null;KZT;70;70;834;834;1
0;KZ75125KZT2069100104;2015-07-25;727;727;727;null;null;KZT;37;37;764;764;1
0;KZ75125KZT2069100104;2015-07-26;780;780;780;53;53;KZT;null;null;727;727;1
0;KZ75125KZT2069100104;2015-07-27;794;794;794;14;14;KZT;null;null;780;780;1
0;KZ75125KZT2069100104;2015-07-28;698;698;698;null;null;KZT;96;96;794;794;1
0;KZ75125KZT2069100104;2015-07-29;633;633;633;null;null;KZT;65;65;698;698;1
0;KZ75125KZT2069100104;2015-07-30;584;584;584;null;null;KZT;49;49;633;633;1
0;KZ75125KZT2069100104;2015-07-31;618;618;618;34;34;KZT;null;null;584;584;1
0;KZ75125KZT2069100104;2015-08-01;670;670;670;52;52;KZT;null;null;618;618;1
0;KZ75125KZT2069100104;2015-08-02;749;749;749;79;79;KZT;null;null;670;670;1
0;KZ75125KZT2069100104;2015-08-03;806;806;806;57;57;KZT;null;null;749;749;1
0;KZ75125KZT2069100104;2015-08-04;790;790;790;null;null;KZT;16;16;806;806;1
0;KZ75125KZT2069100104;2015-08-05;770;770;770;null;null;KZT;20;20;790;790;1
0;KZ75125KZT2069100104;2015-08-06;680;680;680;null;null;KZT;90;90;770;770;1
0;KZ75125KZT2069100104;2015-08-07;741;741;741;61;61;KZT;null;null;680;680;1
0;KZ75125KZT2069100104;2015-08-08;788;788;788;47;47;KZT;null;null;741;741;1
0;KZ75125KZT2069100104;2015-08-09;733;733;733;null;null;KZT;55;55;788;788;1
0;KZ75125KZT2069100104;2015-08-10;747;747;747;14;14;KZT;null;null;733;733;1
0;KZ75125KZT2069100104;2015-08-11;804;804;804;57;57;KZT;null;null;747;747;1
0;KZ75125KZT2069100104;2015-08-12;776;776;776;null;null;KZT;28;28;804;804;1
0;KZ75125KZT2069100104;2015-08-13;717;717;717;null;null;KZT;59;59;776;776;1
0;KZ75125KZT2069100104;2015-08-14;685;685;685;null;null;KZT;32;32;717;717;1
0;KZ75125KZT2069100104;2015-08-15;723;723;723;38;38;KZT;null;null;685;685;1
0;KZ75125KZT2069100104;2015-08-16;730;730;730;7;7;KZT;null;null;723;723;1
0;KZ75125KZT2069100104;2015-08-17;692;692;692;null;null;KZT;38;38;730;730;1
0;KZ75125KZT2069100104;2015-08-18;624;624;624;null;null;KZT;68;68;692;692;1
0;KZ75125KZT2069100104;2015-08-19;626;626;626;2;2;KZT;null;null;624;624;1
0;KZ75125KZT2069100104;2015-08-20;576;576;576;null;null;KZT;50;50;626;626;1
0;KZ75125KZT2069100104;2015-08-21;515;515;515;null;null;KZT;61;61;576;576;1
0;KZ75125KZT2069100104;2015-08-22;438;438;438;null;null;KZT;77;77;515;515;1
0;KZ75125KZT2069100104;2015-08-23;498;498;498;60;60;KZT;null;null;438;438;1
0;KZ75125KZT2069100104;2015-08-24;443;443;443;null;null;KZT;55;55;498;498;1
0;KZ75125KZT2069100104;2015-08-25;467;467;467;24;24;KZT;null;null;443;443;1
0;KZ75125KZT2069100104;2015-08-26;518;518;518;51;51;KZT;null;null;467;467;1
0;KZ75125KZT2069100104;2015-08-27;571;571;571;53;53;KZT;null;null;518;518;1
0;KZ75125KZT2069100104;2015-08-28;654;654;654;83;83;KZT;null;null;571;571;1
0;KZ75125KZT2069100104;2015-08-29;667;667;667;13;13;KZT;null;null;654;654;1
0;KZ75125KZT2069100104;2015-08-30;667;667;667;null;null;KZT;0;0;667;667;1
0;KZ75125KZT2069100104;2015-08-31;765;765;765;98;98;KZT;null;null;667;667;1
0;KZ75125KZT2069100104;2015-09-01;720;720;720;null;null;KZT;45;45;765;765;1
0;KZ75125KZT2069100104;2015-09-02;755;755;755;35;35;KZT;null;null;720;720;1
0;KZ75125KZT2069100104;2015-09-03;801;801;801;46;46;KZT;null;null;755;755;1
0;KZ75125KZT2069100104;2015-09-04;767;767;767;null;null;KZT;34;34;801;801;1
0;KZ75125KZT2069100104;2015-09-05;682;682;682;null;null;KZT;85;85;767;767;1
0;KZ75125KZT2069100104;2015-09-06;621;621;621;null;null;KZT;61;61;682;682;1
0;KZ75125KZT2069100104;2015-09-07;710;710;710;89;89;KZT;null;null;621;621;1
0;KZ75125KZT2069100104;2015-09-08;767;767;767;57;57;KZT;null;null;710;710;1
0;KZ75125KZT2069100104;2015-09-09;832;832;832;65;65;KZT;null;null;767;767;1
0;KZ75125KZT2069100104;2015-09-10;919;919;919;87;87;KZT;null;null;832;832;1
0;KZ75125KZT2069100104;2015-09-11;829;829;829;null;null;KZT;90;90;919;919;1
0;KZ75125KZT2069100104;2015-09-12;849;849;849;20;20;KZT;null;null;829;829;1
0;KZ75125KZT2069100104;2015-09-13;824;824;824;null;null;KZT;25;25;849;849;1
0;KZ75125KZT2069100104;2015-09-14;779;779;779;null;null;KZT;45;45;824;824;1
0;KZ75125KZT2069100104;2015-09-15;835;835;835;56;56;KZT;null;null;779;779;1
0;KZ75125KZT2069100104;2015-09-16;877;877;877;42;42;KZT;null;null;835;835;1
0;KZ75125KZT2069100104;2015-09-17;926;926;926;49;49;KZT;null;null;877;877;1
0;KZ75125KZT2069100104;2015-09-18;855;855;855;null;null;KZT;71;71;926;926;1
0;KZ75125KZT2069100104;2015-09-19;870;870;870;15;15;KZT;null;null;855;855;1
0;KZ75125KZT2069100104;2015-09-20;780;780;780;null;null;KZT;90;90;870;870;1
0;KZ75125KZT2069100104;2015-09-21;801;801;801;21;21;KZT;null;null;780;780;1
0;KZ75125KZT2069100104;2015-09-22;801;801;801;null;null;KZT;0;0;801;801;1
0;KZ75125KZT2069100104;2015-09-23;747;747;747;null;null;KZT;54;54;801;801;1
0;KZ75125KZT2069100104;2015-09-24;832;832;832;85;85;KZT;null;null;747;747;1
0;KZ75125KZT2069100104;2015-09-25;925;925;925;93;93;KZT;null;null;832;832;1
0;KZ75125KZT2069100104;2015-09-26;925;925;925;null;null;KZT;0;0;925;925;1
0;KZ75125KZT2069100104;2015-09-27;869;869;869;null;null;KZT;56;56;925;925;1
0;KZ75125KZT2069100104;2015-09-28;925;925;925;56;56;KZT;null;null;869;869;1
0;KZ75125KZT2069100104;2015-09-29;863;863;863;null;null;KZT;62;62;925;925;1
0;KZ75125KZT2069100104;2015-09-30;905;905;905;42;42;KZT;null;null;863;863;1
0;KZ75125KZT2069100104;2015-10-01;879;879;879;null;null;KZT;26;26;905;905;1
0;KZ75125KZT2069100104;2015-10-02;820;820;820;null;null;KZT;59;59;879;879;1
0;KZ75125KZT2069100104;2015-10-03;906;906;906;86;86;KZT;null;null;820;820;1
0;KZ75125KZT2069100104;2015-10-04;907;907;907;1;1;KZT;null;null;906;906;1
0;KZ75125KZT2069100104;2015-10-05;973;973;973;66;66;KZT;null;null;907;907;1
0;KZ75125KZT2069100104;2015-10-06;1069;1069;1069;96;96;KZT;null;null;973;973;1
0;KZ75125KZT2069100104;2015-10-07;1018;1018;1018;null;null;KZT;51;51;1069;1069;1
0;KZ75125KZT2069100104;2015-10-08;1042;1042;1042;24;24;KZT;null;null;1018;1018;1
0;KZ75125KZT2069100104;2015-10-09;1086;1086;1086;44;44;KZT;null;null;1042;1042;1
0;KZ75125KZT2069100104;2015-10-10;1080;1080;1080;null;null;KZT;6;6;1086;1086;1
0;KZ75125KZT2069100104;2015-10-11;988;988;988;null;null;KZT;92;92;1080;1080;1
0;KZ75125KZT2069100104;2015-10-12;975;975;975;null;null;KZT;13;13;988;988;1
0;KZ75125KZT2069100104;2015-10-13;969;969;969;null;null;KZT;6;6;975;975;1
0;KZ75125KZT2069100104;2015-10-14;1057;1057;1057;88;88;KZT;null;null;969;969;1
0;KZ75125KZT2069100104;2015-10-15;960;960;960;null;null;KZT;97;97;1057;1057;1
0;KZ75125KZT2069100104;2015-10-16;896;896;896;null;null;KZT;64;64;960;960;1
0;KZ75125KZT2069100104;2015-10-17;877;877;877;null;null;KZT;19;19;896;896;1
0;KZ75125KZT2069100104;2015-10-18;852;852;852;null;null;KZT;25;25;877;877;1
0;KZ75125KZT2069100104;2015-10-19;844;844;844;null;null;KZT;8;8;852;852;1
0;KZ75125KZT2069100104;2015-10-20;907;907;907;63;63;KZT;null;null;844;844;1
0;KZ75125KZT2069100104;2015-10-21;865;865;865;null;null;KZT;42;42;907;907;1
0;KZ75125KZT2069100104;2015-10-22;935;935;935;70;70;KZT;null;null;865;865;1
0;KZ75125KZT2069100104;2015-10-23;928;928;928;null;null;KZT;7;7;935;935;1
0;KZ75125KZT2069100104;2015-10-24;941;941;941;13;13;KZT;null;null;928;928;1
0;KZ75125KZT2069100104;2015-10-25;864;864;864;null;null;KZT;77;77;941;941;1
0;KZ75125KZT2069100104;2015-10-26;898;898;898;34;34;KZT;null;null;864;864;1
0;KZ75125KZT2069100104;2015-10-27;961;961;961;63;63;KZT;null;null;898;898;1
0;KZ75125KZT2069100104;2015-10-28;968;968;968;7;7;KZT;null;null;961;961;1
0;KZ75125KZT2069100104;2015-10-29;906;906;906;null;null;KZT;62;62;968;968;1
0;KZ75125KZT2069100104;2015-10-30;953;953;953;47;47;KZT;null;null;906;906;1
0;KZ75125KZT2069100104;2015-10-31;895;895;895;null;null;KZT;58;58;953;953;1
0;KZ75125KZT2069100104;2015-11-01;797;797;797;null;null;KZT;98;98;895;895;1
0;KZ75125KZT2069100104;2015-11-02;767;767;767;null;null;KZT;30;30;797;797;1
0;KZ75125KZT2069100104;2015-11-03;738;738;738;null;null;KZT;29;29;767;767;1
0;KZ75125KZT2069100104;2015-11-04;733;733;733;null;null;KZT;5;5;738;738;1
0;KZ75125KZT2069100104;2015-11-05;662;662;662;null;null;KZT;71;71;733;733;1
0;KZ75125KZT2069100104;2015-11-06;576;576;576;null;null;KZT;86;86;662;662;1
0;KZ75125KZT2069100104;2015-11-07;502;502;502;null;null;KZT;74;74;576;576;1
0;KZ75125KZT2069100104;2015-11-08;440;440;440;null;null;KZT;62;62;502;502;1
0;KZ75125KZT2069100104;2015-11-09;482;482;482;42;42;KZT;null;null;440;440;1
0;KZ75125KZT2069100104;2015-11-10;500;500;500;18;18;KZT;null;null;482;482;1
0;KZ75125KZT2069100104;2015-11-11;558;558;558;58;58;KZT;null;null;500;500;1
0;KZ75125KZT2069100104;2015-11-12;554;554;554;null;null;KZT;4;4;558;558;1
0;KZ75125KZT2069100104;2015-11-13;586;586;586;32;32;KZT;null;null;554;554;1
0;KZ75125KZT2069100104;2015-11-14;520;520;520;null;null;KZT;66;66;586;586;1
0;KZ75125KZT2069100104;2015-11-15;482;482;482;null;null;KZT;38;38;520;520;1
0;KZ75125KZT2069100104;2015-11-16;518;518;518;36;36;KZT;null;null;482;482;1
0;KZ75125KZT2069100104;2015-11-17;577;577;577;59;59;KZT;null;null;518;518;1
0;KZ75125KZT2069100104;2015-11-18;563;563;563;null;null;KZT;14;14;577;577;1
0;KZ75125KZT2069100104;2015-11-19;547;547;547;null;null;KZT;16;16;563;563;1
0;KZ75125KZT2069100104;2015-11-20;530;530;530;null;null;KZT;17;17;547;547;1
0;KZ75125KZT2069100104;2015-11-21;440;440;440;null;null;KZT;90;90;530;530;1
0;KZ75125KZT2069100104;2015-11-22;539;539;539;99;99;KZT;null;null;440;440;1
0;KZ75125KZT2069100104;2015-11-23;504;504;504;null;null;KZT;35;35;539;539;1
0;KZ75125KZT2069100104;2015-11-24;532;532;532;28;28;KZT;null;null;504;504;1
0;KZ75125KZT2069100104;2015-11-25;620;620;620;88;88;KZT;null;null;532;532;1
0;KZ75125KZT2069100104;2015-11-26;673;673;673;53;53;KZT;null;null;620;620;1
0;KZ75125KZT2069100104;2015-11-27;695;695;695;22;22;KZT;null;null;673;673;1
0;KZ75125KZT2069100104;2015-11-28;735;735;735;40;40;KZT;null;null;695;695;1
0;KZ75125KZT2069100104;2015-11-29;815;815;815;80;80;KZT;null;null;735;735;1
0;KZ75125KZT2069100104;2015-11-30;858;858;858;43;43;KZT;null;null;815;815;1
0;KZ75125KZT2069100104;2015-12-01;763;763;763;null;null;KZT;95;95;858;858;1
0;KZ75125KZT2069100104;2015-12-02;744;744;744;null;null;KZT;19;19;763;763;1
0;KZ75125KZT2069100104;2015-12-03;663;663;663;null;null;KZT;81;81;744;744;1
0;KZ75125KZT2069100104;2015-12-04;692;692;692;29;29;KZT;null;null;663;663;1
0;KZ75125KZT2069100104;2015-12-05;754;754;754;62;62;KZT;null;null;692;692;1
0;KZ75125KZT2069100104;2015-12-06;675;675;675;null;null;KZT;79;79;754;754;1
0;KZ75125KZT2069100104;2015-12-07;617;617;617;null;null;KZT;58;58;675;675;1
0;KZ75125KZT2069100104;2015-12-08;534;534;534;null;null;KZT;83;83;617;617;1
0;KZ75125KZT2069100104;2015-12-09;593;593;593;59;59;KZT;null;null;534;534;1
0;KZ75125KZT2069100104;2015-12-10;535;535;535;null;null;KZT;58;58;593;593;1
0;KZ75125KZT2069100104;2015-12-11;542;542;542;7;7;KZT;null;null;535;535;1
0;KZ75125KZT2069100104;2015-12-12;517;517;517;null;null;KZT;25;25;542;542;1
0;KZ75125KZT2069100104;2015-12-13;442;442;442;null;null;KZT;75;75;517;517;1
0;KZ75125KZT2069100104;2015-12-14;428;428;428;null;null;KZT;14;14;442;442;1
0;KZ75125KZT2069100104;2015-12-15;369;369;369;null;null;KZT;59;59;428;428;1
0;KZ75125KZT2069100104;2015-12-16;310;310;310;null;null;KZT;59;59;369;369;1
0;KZ75125KZT2069100104;2015-12-17;393;393;393;83;83;KZT;null;null;310;310;1
0;KZ75125KZT2069100104;2015-12-18;332;332;332;null;null;KZT;61;61;393;393;1
0;KZ75125KZT2069100104;2015-12-19;254;254;254;null;null;KZT;78;78;332;332;1
0;KZ75125KZT2069100104;2015-12-20;317;317;317;63;63;KZT;null;null;254;254;1
0;KZ75125KZT2069100104;2015-12-21;386;386;386;69;69;KZT;null;null;317;317;1
0;KZ75125KZT2069100104;2015-12-22;435;435;435;49;49;KZT;null;null;386;386;1
0;KZ75125KZT2069100104;2015-12-23;458;458;458;23;23;KZT;null;null;435;435;1
0;KZ75125KZT2069100104;2015-12-24;509;509;509;51;51;KZT;null;null;458;458;1
0;KZ75125KZT2069100104;2015-12-25;500;500;500;null;null;KZT;9;9;509;509;1
0;KZ75125KZT2069100104;2015-12-26;546;546;546;46;46;KZT;null;null;500;500;1
0;KZ75125KZT2069100104;2015-12-27;519;519;519;null;null;KZT;27;27;546;546;1
0;KZ75125KZT2069100104;2015-12-28;475;475;475;null;null;KZT;44;44;519;519;1
0;KZ75125KZT2069100104;2015-12-29;521;521;521;46;46;KZT;null;null;475;475;1
0;KZ75125KZT2069100104;2015-12-30;553;553;553;32;32;KZT;null;null;521;521;1
0;KZ75125KZT2069100104;2015-12-31;628;628;628;75;75;KZT;null;null;553;553;1
0;KZ75125KZT2069100104;2016-01-01;633;633;633;5;5;KZT;null;null;628;628;1
0;KZ75125KZT2069100104;2016-01-02;597;597;597;null;null;KZT;36;36;633;633;1
0;KZ75125KZT2069100104;2016-01-03;545;545;545;null;null;KZT;52;52;597;597;1
0;KZ75125KZT2069100104;2016-01-04;643;643;643;98;98;KZT;null;null;545;545;1
0;KZ75125KZT2069100104;2016-01-05;574;574;574;null;null;KZT;69;69;643;643;1
0;KZ75125KZT2069100104;2016-01-06;648;648;648;74;74;KZT;null;null;574;574;1
0;KZ75125KZT2069100104;2016-01-07;600;600;600;null;null;KZT;48;48;648;648;1
0;KZ75125KZT2069100104;2016-01-08;506;506;506;null;null;KZT;94;94;600;600;1
0;KZ75125KZT2069100104;2016-01-09;450;450;450;null;null;KZT;56;56;506;506;1
0;KZ75125KZT2069100104;2016-01-10;529;529;529;79;79;KZT;null;null;450;450;1
0;KZ75125KZT2069100104;2016-01-11;604;604;604;75;75;KZT;null;null;529;529;1
0;KZ75125KZT2069100104;2016-01-12;666;666;666;62;62;KZT;null;null;604;604;1
0;KZ75125KZT2069100104;2016-01-13;625;625;625;null;null;KZT;41;41;666;666;1
0;KZ75125KZT2069100104;2016-01-14;637;637;637;12;12;KZT;null;null;625;625;1
0;KZ75125KZT2069100104;2016-01-15;732;732;732;95;95;KZT;null;null;637;637;1
0;KZ75125KZT2069100104;2016-01-16;733;733;733;1;1;KZT;null;null;732;732;1
0;KZ75125KZT2069100104;2016-01-17;641;641;641;null;null;KZT;92;92;733;733;1
0;KZ75125KZT2069100104;2016-01-18;582;582;582;null;null;KZT;59;59;641;641;1
0;KZ75125KZT2069100104;2016-01-19;647;647;647;65;65;KZT;null;null;582;582;1
0;KZ75125KZT2069100104;2016-01-20;564;564;564;null;null;KZT;83;83;647;647;1
0;KZ75125KZT2069100104;2016-01-21;646;646;646;82;82;KZT;null;null;564;564;1
0;KZ75125KZT2069100104;2016-01-22;655;655;655;9;9;KZT;null;null;646;646;1
0;KZ75125KZT2069100104;2016-01-23;648;648;648;null;null;KZT;7;7;655;655;1
0;KZ75125KZT2069100104;2016-01-24;739;739;739;91;91;KZT;null;null;648;648;1
0;KZ75125KZT2069100104;2016-01-25;738;738;738;null;null;KZT;1;1;739;739;1
0;KZ75125KZT2069100104;2016-01-26;763;763;763;25;25;KZT;null;null;738;738;1
0;KZ75125KZT2069100104;2016-01-27;845;845;845;82;82;KZT;null;null;763;763;1
0;KZ75125KZT2069100104;2016-01-28;748;748;748;null;null;KZT;97;97;845;845;1
0;KZ75125KZT2069100104;2016-01-29;704;704;704;null;null;KZT;44;44;748;748;1
0;KZ75125KZT2069100104;2016-01-30;680;680;680;null;null;KZT;24;24;704;704;1
0;KZ75125KZT2069100104;2016-01-31;594;594;594;null;null;KZT;86;86;680;680;1
0;KZ75125KZT2069100104;2016-02-01;641;641;641;47;47;KZT;null;null;594;594;1
0;KZ75125KZT2069100104;2016-02-02;608;608;608;null;null;KZT;33;33;641;641;1
0;KZ75125KZT2069100104;2016-02-03;654;654;654;46;46;KZT;null;null;608;608;1
0;KZ75125KZT2069100104;2016-02-04;728;728;728;74;74;KZT;null;null;654;654;1
0;KZ75125KZT2069100104;2016-02-05;766;766;766;38;38;KZT;null;null;728;728;1
0;KZ75125KZT2069100104;2016-02-06;791;791;791;25;25;KZT;null;null;766;766;1
0;KZ75125KZT2069100104;2016-02-07;886;886;886;95;95;KZT;null;null;791;791;1
0;KZ75125KZT2069100104;2016-02-08;920;920;920;34;34;KZT;null;null;886;886;1
0;KZ75125KZT2069100104;2016-02-09;993;993;993;73;73;KZT;null;null;920;920;1
0;KZ75125KZT2069100104;2016-02-10;1024;1024;1024;31;31;KZT;null;null;993;993;1
0;KZ75125KZT2069100104;2016-02-11;1039;1039;1039;15;15;KZT;null;null;1024;1024;1
0;KZ75125KZT2069100104;2016-02-12;1044;1044;1044;5;5;KZT;null;null;1039;1039;1
0;KZ75125KZT2069100104;2016-02-13;1105;1105;1105;61;61;KZT;null;null;1044;1044;1
0;KZ75125KZT2069100104;2016-02-14;1017;1017;1017;null;null;KZT;88;88;1105;1105;1
0;KZ75125KZT2069100104;2016-02-15;1020;1020;1020;3;3;KZT;null;null;1017;1017;1
0;KZ75125KZT2069100104;2016-02-16;1105;1105;1105;85;85;KZT;null;null;1020;1020;1
0;KZ75125KZT2069100104;2016-02-17;1098;1098;1098;null;null;KZT;7;7;1105;1105;1
0;KZ75125KZT2069100104;2016-02-18;1106;1106;1106;8;8;KZT;null;null;1098;1098;1
0;KZ75125KZT2069100104;2016-02-19;1113;1113;1113;7;7;KZT;null;null;1106;1106;1
0;KZ75125KZT2069100104;2016-02-20;1136;1136;1136;23;23;KZT;null;null;1113;1113;1
0;KZ75125KZT2069100104;2016-02-21;1216;1216;1216;80;80;KZT;null;null;1136;1136;1
0;KZ75125KZT2069100104;2016-02-22;1177;1177;1177;null;null;KZT;39;39;1216;1216;1
0;KZ75125KZT2069100104;2016-02-23;1111;1111;1111;null;null;KZT;66;66;1177;1177;1
0;KZ75125KZT2069100104;2016-02-24;1033;1033;1033;null;null;KZT;78;78;1111;1111;1
0;KZ75125KZT2069100104;2016-02-25;1132;1132;1132;99;99;KZT;null;null;1033;1033;1
0;KZ75125KZT2069100104;2016-02-26;1184;1184;1184;52;52;KZT;null;null;1132;1132;1
0;KZ75125KZT2069100104;2016-02-27;1222;1222;1222;38;38;KZT;null;null;1184;1184;1
0;KZ75125KZT2069100104;2016-02-28;1142;1142;1142;null;null;KZT;80;80;1222;1222;1
0;KZ75125KZT2069100104;2016-02-29;1045;1045;1045;null;null;KZT;97;97;1142;1142;1
0;KZ75125KZT2069100104;2016-03-01;1069;1069;1069;24;24;KZT;null;null;1045;1045;1
0;KZ75125KZT2069100104;2016-03-02;1064;1064;1064;null;null;KZT;5;5;1069;1069;1
0;KZ75125KZT2069100104;2016-03-03;998;998;998;null;null;KZT;66;66;1064;1064;1
0;KZ75125KZT2069100104;2016-03-04;1080;1080;1080;82;82;KZT;null;null;998;998;1
0;KZ75125KZT2069100104;2016-03-05;1074;1074;1074;null;null;KZT;6;6;1080;1080;1
0;KZ75125KZT2069100104;2016-03-06;1005;1005;1005;null;null;KZT;69;69;1074;1074;1
0;KZ75125KZT2069100104;2016-03-07;928;928;928;null;null;KZT;77;77;1005;1005;1
0;KZ75125KZT2069100104;2016-03-08;1011;1011;1011;83;83;KZT;null;null;928;928;1
0;KZ75125KZT2069100104;2016-03-09;963;963;963;null;null;KZT;48;48;1011;1011;1
0;KZ75125KZT2069100104;2016-03-10;920;920;920;null;null;KZT;43;43;963;963;1
0;KZ75125KZT2069100104;2016-03-11;961;961;961;41;41;KZT;null;null;920;920;1
0;KZ75125KZT2069100104;2016-03-12;931;931;931;null;null;KZT;30;30;961;961;1
0;KZ75125KZT2069100104;2016-03-13;1004;1004;1004;73;73;KZT;null;null;931;931;1
0;KZ75125KZT2069100104;2016-03-14;1088;1088;1088;84;84;KZT;null;null;1004;1004;1
0;KZ75125KZT2069100104;2016-03-15;1185;1185;1185;97;97;KZT;null;null;1088;1088;1
0;KZ75125KZT2069100104;2016-03-16;1173;1173;1173;null;null;KZT;12;12;1185;1185;1
0;KZ75125KZT2069100104;2016-03-17;1106;1106;1106;null;null;KZT;67;67;1173;1173;1
0;KZ75125KZT2069100104;2016-03-18;1110;1110;1110;4;4;KZT;null;null;1106;1106;1
0;KZ75125KZT2069100104;2016-03-19;1194;1194;1194;84;84;KZT;null;null;1110;1110;1
0;KZ75125KZT2069100104;2016-03-20;1122;1122;1122;null;null;KZT;72;72;1194;1194;1
0;KZ75125KZT2069100104;2016-03-21;1066;1066;1066;null;null;KZT;56;56;1122;1122;1
0;KZ75125KZT2069100104;2016-03-22;1009;1009;1009;null;null;KZT;57;57;1066;1066;1
0;KZ75125KZT2069100104;2016-03-23;1094;1094;1094;85;85;KZT;null;null;1009;1009;1
0;KZ75125KZT2069100104;2016-03-24;1070;1070;1070;null;null;KZT;24;24;1094;1094;1
0;KZ75125KZT2069100104;2016-03-25;1161;1161;1161;91;91;KZT;null;null;1070;1070;1
0;KZ75125KZT2069100104;2016-03-26;1118;1118;1118;null;null;KZT;43;43;1161;1161;1
0;KZ75125KZT2069100104;2016-03-27;1170;1170;1170;52;52;KZT;null;null;1118;1118;1
0;KZ75125KZT2069100104;2016-03-28;1123;1123;1123;null;null;KZT;47;47;1170;1170;1
0;KZ75125KZT2069100104;2016-03-29;1188;1188;1188;65;65;KZT;null;null;1123;1123;1
0;KZ75125KZT2069100104;2016-03-30;1130;1130;1130;null;null;KZT;58;58;1188;1188;1
0;KZ75125KZT2069100104;2016-03-31;1088;1088;1088;null;null;KZT;42;42;1130;1130;1
0;KZ75125KZT2069100104;2016-04-01;1022;1022;1022;null;null;KZT;66;66;1088;1088;1
0;KZ75125KZT2069100104;2016-04-02;991;991;991;null;null;KZT;31;31;1022;1022;1
0;KZ75125KZT2069100104;2016-04-03;1080;1080;1080;89;89;KZT;null;null;991;991;1
0;KZ75125KZT2069100104;2016-04-04;1152;1152;1152;72;72;KZT;null;null;1080;1080;1
0;KZ75125KZT2069100104;2016-04-05;1129;1129;1129;null;null;KZT;23;23;1152;1152;1
0;KZ75125KZT2069100104;2016-04-06;1172;1172;1172;43;43;KZT;null;null;1129;1129;1
0;KZ75125KZT2069100104;2016-04-07;1237;1237;1237;65;65;KZT;null;null;1172;1172;1
0;KZ75125KZT2069100104;2016-04-08;1252;1252;1252;15;15;KZT;null;null;1237;1237;1
0;KZ75125KZT2069100104;2016-04-09;1199;1199;1199;null;null;KZT;53;53;1252;1252;1
0;KZ75125KZT2069100104;2016-04-10;1180;1180;1180;null;null;KZT;19;19;1199;1199;1
0;KZ75125KZT2069100104;2016-04-11;1155;1155;1155;null;null;KZT;25;25;1180;1180;1
0;KZ75125KZT2069100104;2016-04-12;1246;1246;1246;91;91;KZT;null;null;1155;1155;1
0;KZ75125KZT2069100104;2016-04-13;1189;1189;1189;null;null;KZT;57;57;1246;1246;1
0;KZ75125KZT2069100104;2016-04-14;1133;1133;1133;null;null;KZT;56;56;1189;1189;1
0;KZ75125KZT2069100104;2016-04-15;1208;1208;1208;75;75;KZT;null;null;1133;1133;1
0;KZ75125KZT2069100104;2016-04-16;1224;1224;1224;16;16;KZT;null;null;1208;1208;1
0;KZ75125KZT2069100104;2016-04-17;1252;1252;1252;28;28;KZT;null;null;1224;1224;1
0;KZ75125KZT2069100104;2016-04-18;1245;1245;1245;null;null;KZT;7;7;1252;1252;1
0;KZ75125KZT2069100104;2016-04-19;1213;1213;1213;null;null;KZT;32;32;1245;1245;1
0;KZ75125KZT2069100104;2016-04-20;1284;1284;1284;71;71;KZT;null;null;1213;1213;1
0;KZ75125KZT2069100104;2016-04-21;1352;1352;1352;68;68;KZT;null;null;1284;1284;1
0;KZ75125KZT2069100104;2016-04-22;1385;1385;1385;33;33;KZT;null;null;1352;1352;1
0;KZ75125KZT2069100104;2016-04-23;1417;1417;1417;32;32;KZT;null;null;1385;1385;1
0;KZ75125KZT2069100104;2016-04-24;1364;1364;1364;null;null;KZT;53;53;1417;1417;1
0;KZ75125KZT2069100104;2016-04-25;1390;1390;1390;26;26;KZT;null;null;1364;1364;1
0;KZ75125KZT2069100104;2016-04-26;1410;1410;1410;20;20;KZT;null;null;1390;1390;1
0;KZ75125KZT2069100104;2016-04-27;1463;1463;1463;53;53;KZT;null;null;1410;1410;1
0;KZ75125KZT2069100104;2016-04-28;1411;1411;1411;null;null;KZT;52;52;1463;1463;1
0;KZ75125KZT2069100104;2016-04-29;1351;1351;1351;null;null;KZT;60;60;1411;1411;1
0;KZ75125KZT2069100104;2016-04-30;1435;1435;1435;84;84;KZT;null;null;1351;1351;1
0;KZ75125KZT2069100104;2016-05-01;1342;1342;1342;null;null;KZT;93;93;1435;1435;1
0;KZ75125KZT2069100104;2016-05-02;1279;1279;1279;null;null;KZT;63;63;1342;1342;1
0;KZ75125KZT2069100104;2016-05-03;1372;1372;1372;93;93;KZT;null;null;1279;1279;1
0;KZ75125KZT2069100104;2016-05-04;1438;1438;1438;66;66;KZT;null;null;1372;1372;1
0;KZ75125KZT2069100104;2016-05-05;1430;1430;1430;null;null;KZT;8;8;1438;1438;1
0;KZ75125KZT2069100104;2016-05-06;1472;1472;1472;42;42;KZT;null;null;1430;1430;1
0;KZ75125KZT2069100104;2016-05-07;1440;1440;1440;null;null;KZT;32;32;1472;1472;1
0;KZ75125KZT2069100104;2016-05-08;1425;1425;1425;null;null;KZT;15;15;1440;1440;1
0;KZ75125KZT2069100104;2016-05-09;1376;1376;1376;null;null;KZT;49;49;1425;1425;1
0;KZ75125KZT2069100104;2016-05-10;1300;1300;1300;null;null;KZT;76;76;1376;1376;1
0;KZ75125KZT2069100104;2016-05-11;1263;1263;1263;null;null;KZT;37;37;1300;1300;1
0;KZ75125KZT2069100104;2016-05-12;1277;1277;1277;14;14;KZT;null;null;1263;1263;1
0;KZ75125KZT2069100104;2016-05-13;1239;1239;1239;null;null;KZT;38;38;1277;1277;1
0;KZ75125KZT2069100104;2016-05-14;1152;1152;1152;null;null;KZT;87;87;1239;1239;1
0;KZ75125KZT2069100104;2016-05-15;1106;1106;1106;null;null;KZT;46;46;1152;1152;1
0;KZ75125KZT2069100104;2016-05-16;1192;1192;1192;86;86;KZT;null;null;1106;1106;1
0;KZ75125KZT2069100104;2016-05-17;1171;1171;1171;null;null;KZT;21;21;1192;1192;1
0;KZ75125KZT2069100104;2016-05-18;1142;1142;1142;null;null;KZT;29;29;1171;1171;1
0;KZ75125KZT2069100104;2016-05-19;1047;1047;1047;null;null;KZT;95;95;1142;1142;1
0;KZ75125KZT2069100104;2016-05-20;949;949;949;null;null;KZT;98;98;1047;1047;1
0;KZ75125KZT2069100104;2016-05-21;898;898;898;null;null;KZT;51;51;949;949;1
0;KZ75125KZT2069100104;2016-05-22;903;903;903;5;5;KZT;null;null;898;898;1
0;KZ75125KZT2069100104;2016-05-23;878;878;878;null;null;KZT;25;25;903;903;1
0;KZ75125KZT2069100104;2016-05-24;838;838;838;null;null;KZT;40;40;878;878;1
0;KZ75125KZT2069100104;2016-05-25;932;932;932;94;94;KZT;null;null;838;838;1
0;KZ75125KZT2069100104;2016-05-26;870;870;870;null;null;KZT;62;62;932;932;1
0;KZ75125KZT2069100104;2016-05-27;779;779;779;null;null;KZT;91;91;870;870;1
0;KZ75125KZT2069100104;2016-05-28;754;754;754;null;null;KZT;25;25;779;779;1
0;KZ75125KZT2069100104;2016-05-29;737;737;737;null;null;KZT;17;17;754;754;1
0;KZ75125KZT2069100104;2016-05-30;740;740;740;3;3;KZT;null;null;737;737;1
0;KZ75125KZT2069100104;2016-05-31;791;791;791;51;51;KZT;null;null;740;740;1
0;KZ75125KZT2069100104;2016-06-01;848;848;848;57;57;KZT;null;null;791;791;1
0;KZ75125KZT2069100104;2016-06-02;764;764;764;null;null;KZT;84;84;848;848;1
0;KZ75125KZT2069100104;2016-06-03;673;673;673;null;null;KZT;91;91;764;764;1
0;KZ75125KZT2069100104;2016-06-04;739;739;739;66;66;KZT;null;null;673;673;1
0;KZ75125KZT2069100104;2016-06-05;698;698;698;null;null;KZT;41;41;739;739;1
0;KZ75125KZT2069100104;2016-06-06;662;662;662;null;null;KZT;36;36;698;698;1
0;KZ75125KZT2069100104;2016-06-07;603;603;603;null;null;KZT;59;59;662;662;1
0;KZ75125KZT2069100104;2016-06-08;519;519;519;null;null;KZT;84;84;603;603;1
0;KZ75125KZT2069100104;2016-06-09;582;582;582;63;63;KZT;null;null;519;519;1
0;KZ75125KZT2069100104;2016-06-10;536;536;536;null;null;KZT;46;46;582;582;1
0;KZ75125KZT2069100104;2016-06-11;536;536;536;null;null;KZT;0;0;536;536;1
0;KZ75125KZT2069100104;2016-06-12;541;541;541;5;5;KZT;null;null;536;536;1
0;KZ75125KZT2069100104;2016-06-13;585;585;585;44;44;KZT;null;null;541;541;1
0;KZ75125KZT2069100104;2016-06-14;656;656;656;71;71;KZT;null;null;585;585;1
0;KZ75125KZT2069100104;2016-06-15;714;714;714;58;58;KZT;null;null;656;656;1
0;KZ75125KZT2069100104;2016-06-16;732;732;732;18;18;KZT;null;null;714;714;1
0;KZ75125KZT2069100104;2016-06-17;677;677;677;null;null;KZT;55;55;732;732;1
0;KZ75125KZT2069100104;2016-06-18;750;750;750;73;73;KZT;null;null;677;677;1
0;KZ75125KZT2069100104;2016-06-19;764;764;764;14;14;KZT;null;null;750;750;1
0;KZ75125KZT2069100104;2016-06-20;803;803;803;39;39;KZT;null;null;764;764;1
0;KZ75125KZT2069100104;2016-06-21;719;719;719;null;null;KZT;84;84;803;803;1
0;KZ75125KZT2069100104;2016-06-22;746;746;746;27;27;KZT;null;null;719;719;1
0;KZ75125KZT2069100104;2016-06-23;747;747;747;1;1;KZT;null;null;746;746;1
0;KZ75125KZT2069100104;2016-06-24;760;760;760;13;13;KZT;null;null;747;747;1
0;KZ75125KZT2069100104;2016-06-25;728;728;728;null;null;KZT;32;32;760;760;1
0;KZ75125KZT2069100104;2016-06-26;741;741;741;13;13;KZT;null;null;728;728;1
0;KZ75125KZT2069100104;2016-06-27;821;821;821;80;80;KZT;null;null;741;741;1
0;KZ75125KZT2069100104;2016-06-28;805;805;805;null;null;KZT;16;16;821;821;1
0;KZ75125KZT2069100104;2016-06-29;835;835;835;30;30;KZT;null;null;805;805;1
0;KZ75125KZT2069100104;2016-06-30;907;907;907;72;72;KZT;null;null;835;835;1
0;KZ75125KZT2069100104;2016-07-01;907;907;907;null;null;KZT;0;0;907;907;1
0;KZ75125KZT2069100104;2016-07-02;863;863;863;null;null;KZT;44;44;907;907;1
0;KZ75125KZT2069100104;2016-07-03;857;857;857;null;null;KZT;6;6;863;863;1
0;KZ75125KZT2069100104;2016-07-04;836;836;836;null;null;KZT;21;21;857;857;1
0;KZ75125KZT2069100104;2016-07-05;901;901;901;65;65;KZT;null;null;836;836;1
0;KZ75125KZT2069100104;2016-07-06;923;923;923;22;22;KZT;null;null;901;901;1
0;KZ75125KZT2069100104;2016-07-07;908;908;908;null;null;KZT;15;15;923;923;1
0;KZ75125KZT2069100104;2016-07-08;949;949;949;41;41;KZT;null;null;908;908;1
0;KZ75125KZT2069100104;2016-07-09;908;908;908;null;null;KZT;41;41;949;949;1
0;KZ75125KZT2069100104;2016-07-10;843;843;843;null;null;KZT;65;65;908;908;1
0;KZ75125KZT2069100104;2016-07-11;873;873;873;30;30;KZT;null;null;843;843;1
0;KZ75125KZT2069100104;2016-07-12;855;855;855;null;null;KZT;18;18;873;873;1
0;KZ75125KZT2069100104;2016-07-13;825;825;825;null;null;KZT;30;30;855;855;1
0;KZ75125KZT2069100104;2016-07-14;874;874;874;49;49;KZT;null;null;825;825;1
0;KZ75125KZT2069100104;2016-07-15;917;917;917;43;43;KZT;null;null;874;874;1
0;KZ75125KZT2069100104;2016-07-16;827;827;827;null;null;KZT;90;90;917;917;1
0;KZ75125KZT2069100104;2016-07-17;807;807;807;null;null;KZT;20;20;827;827;1
0;KZ75125KZT2069100104;2016-07-18;712;712;712;null;null;KZT;95;95;807;807;1
0;KZ75125KZT2069100104;2016-07-19;756;756;756;44;44;KZT;null;null;712;712;1
0;KZ75125KZT2069100104;2016-07-20;818;818;818;62;62;KZT;null;null;756;756;1
0;KZ75125KZT2069100104;2016-07-21;811;811;811;null;null;KZT;7;7;818;818;1
0;KZ75125KZT2069100104;2016-07-22;797;797;797;null;null;KZT;14;14;811;811;1
0;KZ75125KZT2069100104;2016-07-23;800;800;800;3;3;KZT;null;null;797;797;1
0;KZ75125KZT2069100104;2016-07-24;871;871;871;71;71;KZT;null;null;800;800;1
0;KZ75125KZT2069100104;2016-07-25;833;833;833;null;null;KZT;38;38;871;871;1
0;KZ75125KZT2069100104;2016-07-26;748;748;748;null;null;KZT;85;85;833;833;1
0;KZ75125KZT2069100104;2016-07-27;650;650;650;null;null;KZT;98;98;748;748;1
0;KZ75125KZT2069100104;2016-07-28;599;599;599;null;null;KZT;51;51;650;650;1
0;KZ75125KZT2069100104;2016-07-29;606;606;606;7;7;KZT;null;null;599;599;1
0;KZ75125KZT2069100104;2016-07-30;596;596;596;null;null;KZT;10;10;606;606;1
0;KZ75125KZT2069100104;2016-07-31;545;545;545;null;null;KZT;51;51;596;596;1
0;KZ75125KZT2069100104;2016-08-01;586;586;586;41;41;KZT;null;null;545;545;1
0;KZ75125KZT2069100104;2016-08-02;671;671;671;85;85;KZT;null;null;586;586;1
0;KZ75125KZT2069100104;2016-08-03;675;675;675;4;4;KZT;null;null;671;671;1
0;KZ75125KZT2069100104;2016-08-04;642;642;642;null;null;KZT;33;33;675;675;1
0;KZ75125KZT2069100104;2016-08-05;627;627;627;null;null;KZT;15;15;642;642;1
0;KZ75125KZT2069100104;2016-08-06;632;632;632;5;5;KZT;null;null;627;627;1
0;KZ75125KZT2069100104;2016-08-07;597;597;597;null;null;KZT;35;35;632;632;1
0;KZ75125KZT2069100104;2016-08-08;570;570;570;null;null;KZT;27;27;597;597;1
0;KZ75125KZT2069100104;2016-08-09;497;497;497;null;null;KZT;73;73;570;570;1
0;KZ75125KZT2069100104;2016-08-10;426;426;426;null;null;KZT;71;71;497;497;1
0;KZ75125KZT2069100104;2016-08-11;496;496;496;70;70;KZT;null;null;426;426;1
0;KZ75125KZT2069100104;2016-08-12;401;401;401;null;null;KZT;95;95;496;496;1
0;KZ75125KZT2069100104;2016-08-13;402;402;402;1;1;KZT;null;null;401;401;1
0;KZ75125KZT2069100104;2016-08-14;357;357;357;null;null;KZT;45;45;402;402;1
0;KZ75125KZT2069100104;2016-08-15;335;335;335;null;null;KZT;22;22;357;357;1
0;KZ75125KZT2069100104;2016-08-16;262;262;262;null;null;KZT;73;73;335;335;1
0;KZ75125KZT2069100104;2016-08-17;340;340;340;78;78;KZT;null;null;262;262;1
0;KZ75125KZT2069100104;2016-08-18;274;274;274;null;null;KZT;66;66;340;340;1
0;KZ75125KZT2069100104;2016-08-19;345;345;345;71;71;KZT;null;null;274;274;1
0;KZ75125KZT2069100104;2016-08-20;269;269;269;null;null;KZT;76;76;345;345;1
0;KZ75125KZT2069100104;2016-08-21;319;319;319;50;50;KZT;null;null;269;269;1
0;KZ75125KZT2069100104;2016-08-22;256;256;256;null;null;KZT;63;63;319;319;1
0;KZ75125KZT2069100104;2016-08-23;354;354;354;98;98;KZT;null;null;256;256;1
0;KZ75125KZT2069100104;2016-08-24;317;317;317;null;null;KZT;37;37;354;354;1
0;KZ75125KZT2069100104;2016-08-25;267;267;267;null;null;KZT;50;50;317;317;1
0;KZ75125KZT2069100104;2016-08-26;319;319;319;52;52;KZT;null;null;267;267;1
0;KZ75125KZT2069100104;2016-08-27;295;295;295;null;null;KZT;24;24;319;319;1
0;KZ75125KZT2069100104;2016-08-28;205;205;205;null;null;KZT;90;90;295;295;1
0;KZ75125KZT2069100104;2016-08-29;176;176;176;null;null;KZT;29;29;205;205;1
0;KZ75125KZT2069100104;2016-08-30;87;87;87;null;null;KZT;89;89;176;176;1
0;KZ75125KZT2069100104;2016-08-31;62;62;62;null;null;KZT;25;25;87;87;1
0;KZ75125KZT2069100104;2016-09-01;106;106;106;44;44;KZT;null;null;62;62;1
0;KZ75125KZT2069100104;2016-09-02;182;182;182;76;76;KZT;null;null;106;106;1
0;KZ75125KZT2069100104;2016-09-03;201;201;201;19;19;KZT;null;null;182;182;1
0;KZ75125KZT2069100104;2016-09-04;113;113;113;null;null;KZT;88;88;201;201;1
0;KZ75125KZT2069100104;2016-09-05;90;90;90;null;null;KZT;23;23;113;113;1
0;KZ75125KZT2069100104;2016-09-06;105;105;105;15;15;KZT;null;null;90;90;1
0;KZ75125KZT2069100104;2016-09-07;164;164;164;59;59;KZT;null;null;105;105;1
0;KZ75125KZT2069100104;2016-09-08;96;96;96;null;null;KZT;68;68;164;164;1
0;KZ75125KZT2069100104;2016-09-09;172;172;172;76;76;KZT;null;null;96;96;1
0;KZ75125KZT2069100104;2016-09-10;96;96;96;null;null;KZT;76;76;172;172;1
0;KZ75125KZT2069100104;2016-09-11;32;32;32;null;null;KZT;64;64;96;96;1
0;KZ75125KZT2069100104;2016-09-12;66;66;66;34;34;KZT;null;null;32;32;1
0;KZ75125KZT2069100104;2016-09-13;60;60;60;null;null;KZT;6;6;66;66;1
0;KZ75125KZT2069100104;2016-09-14;75;75;75;15;15;KZT;null;null;60;60;1
0;KZ75125KZT2069100104;2016-09-15;49;49;49;null;null;KZT;26;26;75;75;1
0;KZ75125KZT2069100104;2016-09-16;96;96;96;47;47;KZT;null;null;49;49;1
0;KZ75125KZT2069100104;2016-09-17;37;37;37;null;null;KZT;59;59;96;96;1
0;KZ75125KZT2069100104;2016-09-18;21;21;21;null;null;KZT;16;16;37;37;1
0;KZ75125KZT2069100104;2016-09-19;-24;-24;-24;null;null;KZT;45;45;21;21;1
0;KZ75125KZT2069100104;2016-09-20;40;40;40;64;64;KZT;null;null;-24;-24;1
0;KZ75125KZT2069100104;2016-09-21;-41;-41;-41;null;null;KZT;81;81;40;40;1
0;KZ75125KZT2069100104;2016-09-22;-56;-56;-56;null;null;KZT;15;15;-41;-41;1
0;KZ75125KZT2069100104;2016-09-23;-135;-135;-135;null;null;KZT;79;79;-56;-56;1
0;KZ75125KZT2069100104;2016-09-24;-74;-74;-74;61;61;KZT;null;null;-135;-135;1
0;KZ75125KZT2069100104;2016-09-25;-96;-96;-96;null;null;KZT;22;22;-74;-74;1
0;KZ75125KZT2069100104;2016-09-26;-98;-98;-98;null;null;KZT;2;2;-96;-96;1
0;KZ75125KZT2069100104;2016-09-27;-59;-59;-59;39;39;KZT;null;null;-98;-98;1
0;KZ75125KZT2069100104;2016-09-28;-142;-142;-142;null;null;KZT;83;83;-59;-59;1
0;KZ75125KZT2069100104;2016-09-29;-162;-162;-162;null;null;KZT;20;20;-142;-142;1
0;KZ75125KZT2069100104;2016-09-30;-198;-198;-198;null;null;KZT;36;36;-162;-162;1
0;KZ75125KZT2069100104;2016-10-01;-238;-238;-238;null;null;KZT;40;40;-198;-198;1
0;KZ75125KZT2069100104;2016-10-02;-157;-157;-157;81;81;KZT;null;null;-238;-238;1
0;KZ75125KZT2069100104;2016-10-03;-242;-242;-242;null;null;KZT;85;85;-157;-157;1
0;KZ75125KZT2069100104;2016-10-04;-276;-276;-276;null;null;KZT;34;34;-242;-242;1
0;KZ75125KZT2069100104;2016-10-05;-210;-210;-210;66;66;KZT;null;null;-276;-276;1
0;KZ75125KZT2069100104;2016-10-06;-143;-143;-143;67;67;KZT;null;null;-210;-210;1
0;KZ75125KZT2069100104;2016-10-07;-92;-92;-92;51;51;KZT;null;null;-143;-143;1
0;KZ75125KZT2069100104;2016-10-08;-189;-189;-189;null;null;KZT;97;97;-92;-92;1
0;KZ75125KZT2069100104;2016-10-09;-128;-128;-128;61;61;KZT;null;null;-189;-189;1
0;KZ75125KZT2069100104;2016-10-10;-82;-82;-82;46;46;KZT;null;null;-128;-128;1
0;KZ75125KZT2069100104;2016-10-11;-14;-14;-14;68;68;KZT;null;null;-82;-82;1
0;KZ75125KZT2069100104;2016-10-12;-86;-86;-86;null;null;KZT;72;72;-14;-14;1
0;KZ75125KZT2069100104;2016-10-13;-118;-118;-118;null;null;KZT;32;32;-86;-86;1
0;KZ75125KZT2069100104;2016-10-14;-134;-134;-134;null;null;KZT;16;16;-118;-118;1
0;KZ75125KZT2069100104;2016-10-15;-167;-167;-167;null;null;KZT;33;33;-134;-134;1
0;KZ75125KZT2069100104;2016-10-16;-91;-91;-91;76;76;KZT;null;null;-167;-167;1
0;KZ75125KZT2069100104;2016-10-17;-28;-28;-28;63;63;KZT;null;null;-91;-91;1
0;KZ75125KZT2069100104;2016-10-18;-27;-27;-27;1;1;KZT;null;null;-28;-28;1
0;KZ75125KZT2069100104;2016-10-19;-99;-99;-99;null;null;KZT;72;72;-27;-27;1
0;KZ75125KZT2069100104;2016-10-20;-13;-13;-13;86;86;KZT;null;null;-99;-99;1
0;KZ75125KZT2069100104;2016-10-21;60;60;60;73;73;KZT;null;null;-13;-13;1
0;KZ75125KZT2069100104;2016-10-22;19;19;19;null;null;KZT;41;41;60;60;1
0;KZ75125KZT2069100104;2016-10-23;11;11;11;null;null;KZT;8;8;19;19;1
0;KZ75125KZT2069100104;2016-10-24;-55;-55;-55;null;null;KZT;66;66;11;11;1
0;KZ75125KZT2069100104;2016-10-25;-108;-108;-108;null;null;KZT;53;53;-55;-55;1
0;KZ75125KZT2069100104;2016-10-26;-47;-47;-47;61;61;KZT;null;null;-108;-108;1
0;KZ75125KZT2069100104;2016-10-27;-8;-8;-8;39;39;KZT;null;null;-47;-47;1
0;KZ75125KZT2069100104;2016-10-28;-74;-74;-74;null;null;KZT;66;66;-8;-8;1
0;KZ75125KZT2069100104;2016-10-29;-15;-15;-15;59;59;KZT;null;null;-74;-74;1
0;KZ75125KZT2069100104;2016-10-30;-28;-28;-28;null;null;KZT;13;13;-15;-15;1
0;KZ75125KZT2069100104;2016-10-31;-89;-89;-89;null;null;KZT;61;61;-28;-28;1
0;KZ75125KZT2069100104;2016-11-01;-120;-120;-120;null;null;KZT;31;31;-89;-89;1
0;KZ75125KZT2069100104;2016-11-02;-157;-157;-157;null;null;KZT;37;37;-120;-120;1
0;KZ75125KZT2069100104;2016-11-03;-163;-163;-163;null;null;KZT;6;6;-157;-157;1
0;KZ75125KZT2069100104;2016-11-04;-148;-148;-148;15;15;KZT;null;null;-163;-163;1
0;KZ75125KZT2069100104;2016-11-05;-80;-80;-80;68;68;KZT;null;null;-148;-148;1
0;KZ75125KZT2069100104;2016-11-06;-143;-143;-143;null;null;KZT;63;63;-80;-80;1
0;KZ75125KZT2069100104;2016-11-07;-238;-238;-238;null;null;KZT;95;95;-143;-143;1
0;KZ75125KZT2069100104;2016-11-08;-227;-227;-227;11;11;KZT;null;null;-238;-238;1
0;KZ75125KZT2069100104;2016-11-09;-193;-193;-193;34;34;KZT;null;null;-227;-227;1
0;KZ75125KZT2069100104;2016-11-10;-216;-216;-216;null;null;KZT;23;23;-193;-193;1
0;KZ75125KZT2069100104;2016-11-11;-202;-202;-202;14;14;KZT;null;null;-216;-216;1
0;KZ75125KZT2069100104;2016-11-12;-131;-131;-131;71;71;KZT;null;null;-202;-202;1
0;KZ75125KZT2069100104;2016-11-13;-61;-61;-61;70;70;KZT;null;null;-131;-131;1
0;KZ75125KZT2069100104;2016-11-14;-44;-44;-44;17;17;KZT;null;null;-61;-61;1
0;KZ75125KZT2069100104;2016-11-15;-96;-96;-96;null;null;KZT;52;52;-44;-44;1
0;KZ75125KZT2069100104;2016-11-16;-126;-126;-126;null;null;KZT;30;30;-96;-96;1
0;KZ75125KZT2069100104;2016-11-17;-163;-163;-163;null;null;KZT;37;37;-126;-126;1
0;KZ75125KZT2069100104;2016-11-18;-88;-88;-88;75;75;KZT;null;null;-163;-163;1
0;KZ75125KZT2069100104;2016-11-19;-57;-57;-57;31;31;KZT;null;null;-88;-88;1
0;KZ75125KZT2069100104;2016-11-20;-44;-44;-44;13;13;KZT;null;null;-57;-57;1
0;KZ75125KZT2069100104;2016-11-21;-40;-40;-40;4;4;KZT;null;null;-44;-44;1
0;KZ75125KZT2069100104;2016-11-22;-61;-61;-61;null;null;KZT;21;21;-40;-40;1
0;KZ75125KZT2069100104;2016-11-23;-10;-10;-10;51;51;KZT;null;null;-61;-61;1
0;KZ75125KZT2069100104;2016-11-24;8;8;8;18;18;KZT;null;null;-10;-10;1
0;KZ75125KZT2069100104;2016-11-25;29;29;29;21;21;KZT;null;null;8;8;1
0;KZ75125KZT2069100104;2016-11-26;-64;-64;-64;null;null;KZT;93;93;29;29;1
0;KZ75125KZT2069100104;2016-11-27;-55;-55;-55;9;9;KZT;null;null;-64;-64;1
0;KZ75125KZT2069100104;2016-11-28;-53;-53;-53;2;2;KZT;null;null;-55;-55;1
0;KZ75125KZT2069100104;2016-11-29;-31;-31;-31;22;22;KZT;null;null;-53;-53;1
0;KZ75125KZT2069100104;2016-11-30;20;20;20;51;51;KZT;null;null;-31;-31;1
0;KZ75125KZT2069100104;2016-12-01;-61;-61;-61;null;null;KZT;81;81;20;20;1
0;KZ75125KZT2069100104;2016-12-02;36;36;36;97;97;KZT;null;null;-61;-61;1
0;KZ75125KZT2069100104;2016-12-03;20;20;20;null;null;KZT;16;16;36;36;1
0;KZ75125KZT2069100104;2016-12-04;89;89;89;69;69;KZT;null;null;20;20;1
0;KZ75125KZT2069100104;2016-12-05;99;99;99;10;10;KZT;null;null;89;89;1
0;KZ75125KZT2069100104;2016-12-06;185;185;185;86;86;KZT;null;null;99;99;1
0;KZ75125KZT2069100104;2016-12-07;135;135;135;null;null;KZT;50;50;185;185;1
0;KZ75125KZT2069100104;2016-12-08;113;113;113;null;null;KZT;22;22;135;135;1
0;KZ75125KZT2069100104;2016-12-09;32;32;32;null;null;KZT;81;81;113;113;1
0;KZ75125KZT2069100104;2016-12-10;101;101;101;69;69;KZT;null;null;32;32;1
0;KZ75125KZT2069100104;2016-12-11;120;120;120;19;19;KZT;null;null;101;101;1
0;KZ75125KZT2069100104;2016-12-12;86;86;86;null;null;KZT;34;34;120;120;1
0;KZ75125KZT2069100104;2016-12-13;158;158;158;72;72;KZT;null;null;86;86;1
0;KZ75125KZT2069100104;2016-12-14;110;110;110;null;null;KZT;48;48;158;158;1
0;KZ75125KZT2069100104;2016-12-15;116;116;116;6;6;KZT;null;null;110;110;1
0;KZ75125KZT2069100104;2016-12-16;158;158;158;42;42;KZT;null;null;116;116;1
0;KZ75125KZT2069100104;2016-12-17;75;75;75;null;null;KZT;83;83;158;158;1
0;KZ75125KZT2069100104;2016-12-18;75;75;75;null;null;KZT;0;0;75;75;1
0;KZ75125KZT2069100104;2016-12-19;174;174;174;99;99;KZT;null;null;75;75;1
0;KZ75125KZT2069100104;2016-12-20;79;79;79;null;null;KZT;95;95;174;174;1
0;KZ75125KZT2069100104;2016-12-21;63;63;63;null;null;KZT;16;16;79;79;1
0;KZ75125KZT2069100104;2016-12-22;34;34;34;null;null;KZT;29;29;63;63;1
0;KZ75125KZT2069100104;2016-12-23;101;101;101;67;67;KZT;null;null;34;34;1
0;KZ75125KZT2069100104;2016-12-24;36;36;36;null;null;KZT;65;65;101;101;1
0;KZ75125KZT2069100104;2016-12-25;41;41;41;5;5;KZT;null;null;36;36;1
0;KZ75125KZT2069100104;2016-12-26;-42;-42;-42;null;null;KZT;83;83;41;41;1
0;KZ75125KZT2069100104;2016-12-27;-27;-27;-27;15;15;KZT;null;null;-42;-42;1
0;KZ75125KZT2069100104;2016-12-28;-60;-60;-60;null;null;KZT;33;33;-27;-27;1
0;KZ75125KZT2069100104;2016-12-29;-40;-40;-40;20;20;KZT;null;null;-60;-60;1
0;KZ75125KZT2069100104;2016-12-30;-136;-136;-136;null;null;KZT;96;96;-40;-40;1
0;KZ75125KZT2069100104;2016-12-31;-41;-41;-41;95;95;KZT;null;null;-136;-136;1
0;KZ75125KZT2069100104;2017-01-01;-3;-3;-3;38;38;KZT;null;null;-41;-41;1
0;KZ75125KZT2069100104;2017-01-02;-63;-63;-63;null;null;KZT;60;60;-3;-3;1
0;KZ75125KZT2069100104;2017-01-03;-120;-120;-120;null;null;KZT;57;57;-63;-63;1
0;KZ75125KZT2069100104;2017-01-04;-117;-117;-117;3;3;KZT;null;null;-120;-120;1
0;KZ75125KZT2069100104;2017-01-05;-177;-177;-177;null;null;KZT;60;60;-117;-117;1
0;KZ75125KZT2069100104;2017-01-06;-182;-182;-182;null;null;KZT;5;5;-177;-177;1
0;KZ75125KZT2069100104;2017-01-07;-155;-155;-155;27;27;KZT;null;null;-182;-182;1
0;KZ75125KZT2069100104;2017-01-08;-102;-102;-102;53;53;KZT;null;null;-155;-155;1
0;KZ75125KZT2069100104;2017-01-09;-89;-89;-89;13;13;KZT;null;null;-102;-102;1
0;KZ75125KZT2069100104;2017-01-10;-151;-151;-151;null;null;KZT;62;62;-89;-89;1
0;KZ75125KZT2069100104;2017-01-11;-59;-59;-59;92;92;KZT;null;null;-151;-151;1
0;KZ75125KZT2069100104;2017-01-12;-68;-68;-68;null;null;KZT;9;9;-59;-59;1
0;KZ75125KZT2069100104;2017-01-13;-151;-151;-151;null;null;KZT;83;83;-68;-68;1
0;KZ75125KZT2069100104;2017-01-14;-159;-159;-159;null;null;KZT;8;8;-151;-151;1
0;KZ75125KZT2069100104;2017-01-15;-204;-204;-204;null;null;KZT;45;45;-159;-159;1
0;KZ75125KZT2069100104;2017-01-16;-150;-150;-150;54;54;KZT;null;null;-204;-204;1
0;KZ75125KZT2069100104;2017-01-17;-186;-186;-186;null;null;KZT;36;36;-150;-150;1
0;KZ75125KZT2069100104;2017-01-18;-222;-222;-222;null;null;KZT;36;36;-186;-186;1
0;KZ75125KZT2069100104;2017-01-19;-300;-300;-300;null;null;KZT;78;78;-222;-222;1
0;KZ75125KZT2069100104;2017-01-20;-369;-369;-369;null;null;KZT;69;69;-300;-300;1
0;KZ75125KZT2069100104;2017-01-21;-393;-393;-393;null;null;KZT;24;24;-369;-369;1
0;KZ75125KZT2069100104;2017-01-22;-365;-365;-365;28;28;KZT;null;null;-393;-393;1
0;KZ75125KZT2069100104;2017-01-23;-357;-357;-357;8;8;KZT;null;null;-365;-365;1
0;KZ75125KZT2069100104;2017-01-24;-440;-440;-440;null;null;KZT;83;83;-357;-357;1
0;KZ75125KZT2069100104;2017-01-25;-489;-489;-489;null;null;KZT;49;49;-440;-440;1
0;KZ75125KZT2069100104;2017-01-26;-448;-448;-448;41;41;KZT;null;null;-489;-489;1
0;KZ75125KZT2069100104;2017-01-27;-421;-421;-421;27;27;KZT;null;null;-448;-448;1
0;KZ75125KZT2069100104;2017-01-28;-465;-465;-465;null;null;KZT;44;44;-421;-421;1
0;KZ75125KZT2069100104;2017-01-29;-439;-439;-439;26;26;KZT;null;null;-465;-465;1
0;KZ75125KZT2069100104;2017-01-30;-508;-508;-508;null;null;KZT;69;69;-439;-439;1
0;KZ75125KZT2069100104;2017-01-31;-587;-587;-587;null;null;KZT;79;79;-508;-508;1
0;KZ75125KZT2069100104;2017-02-01;-583;-583;-583;4;4;KZT;null;null;-587;-587;1
0;KZ75125KZT2069100104;2017-02-02;-528;-528;-528;55;55;KZT;null;null;-583;-583;1
0;KZ75125KZT2069100104;2017-02-03;-511;-511;-511;17;17;KZT;null;null;-528;-528;1
0;KZ75125KZT2069100104;2017-02-04;-428;-428;-428;83;83;KZT;null;null;-511;-511;1
0;KZ75125KZT2069100104;2017-02-05;-505;-505;-505;null;null;KZT;77;77;-428;-428;1
0;KZ75125KZT2069100104;2017-02-06;-555;-555;-555;null;null;KZT;50;50;-505;-505;1
0;KZ75125KZT2069100104;2017-02-07;-603;-603;-603;null;null;KZT;48;48;-555;-555;1
0;KZ75125KZT2069100104;2017-02-08;-578;-578;-578;25;25;KZT;null;null;-603;-603;1
0;KZ75125KZT2069100104;2017-02-09;-546;-546;-546;32;32;KZT;null;null;-578;-578;1
0;KZ75125KZT2069100104;2017-02-10;-506;-506;-506;40;40;KZT;null;null;-546;-546;1
0;KZ75125KZT2069100104;2017-02-11;-468;-468;-468;38;38;KZT;null;null;-506;-506;1
0;KZ75125KZT2069100104;2017-02-12;-561;-561;-561;null;null;KZT;93;93;-468;-468;1
0;KZ75125KZT2069100104;2017-02-13;-594;-594;-594;null;null;KZT;33;33;-561;-561;1
0;KZ75125KZT2069100104;2017-02-14;-582;-582;-582;12;12;KZT;null;null;-594;-594;1
0;KZ75125KZT2069100104;2017-02-15;-660;-660;-660;null;null;KZT;78;78;-582;-582;1
0;KZ75125KZT2069100104;2017-02-16;-661;-661;-661;null;null;KZT;1;1;-660;-660;1
0;KZ75125KZT2069100104;2017-02-17;-675;-675;-675;null;null;KZT;14;14;-661;-661;1
0;KZ75125KZT2069100104;2017-02-18;-752;-752;-752;null;null;KZT;77;77;-675;-675;1
0;KZ75125KZT2069100104;2017-02-19;-720;-720;-720;32;32;KZT;null;null;-752;-752;1
0;KZ75125KZT2069100104;2017-02-20;-781;-781;-781;null;null;KZT;61;61;-720;-720;1
0;KZ75125KZT2069100104;2017-02-21;-845;-845;-845;null;null;KZT;64;64;-781;-781;1
0;KZ75125KZT2069100104;2017-02-22;-865;-865;-865;null;null;KZT;20;20;-845;-845;1
0;KZ75125KZT2069100104;2017-02-23;-897;-897;-897;null;null;KZT;32;32;-865;-865;1
0;KZ75125KZT2069100104;2017-02-24;-864;-864;-864;33;33;KZT;null;null;-897;-897;1
0;KZ75125KZT2069100104;2017-02-25;-905;-905;-905;null;null;KZT;41;41;-864;-864;1
0;KZ75125KZT2069100104;2017-02-26;-910;-910;-910;null;null;KZT;5;5;-905;-905;1
0;KZ75125KZT2069100104;2017-02-27;-927;-927;-927;null;null;KZT;17;17;-910;-910;1
0;KZ75125KZT2069100104;2017-02-28;-974;-974;-974;null;null;KZT;47;47;-927;-927;1
0;KZ75125KZT2069100104;2017-03-01;-934;-934;-934;40;40;KZT;null;null;-974;-974;1
0;KZ75125KZT2069100104;2017-03-02;-927;-927;-927;7;7;KZT;null;null;-934;-934;1
0;KZ75125KZT2069100104;2017-03-03;-847;-847;-847;80;80;KZT;null;null;-927;-927;1
0;KZ75125KZT2069100104;2017-03-04;-854;-854;-854;null;null;KZT;7;7;-847;-847;1
0;KZ75125KZT2069100104;2017-03-05;-904;-904;-904;null;null;KZT;50;50;-854;-854;1
0;KZ75125KZT2069100104;2017-03-06;-978;-978;-978;null;null;KZT;74;74;-904;-904;1
0;KZ75125KZT2069100104;2017-03-07;-1001;-1001;-1001;null;null;KZT;23;23;-978;-978;1
0;KZ75125KZT2069100104;2017-03-08;-953;-953;-953;48;48;KZT;null;null;-1001;-1001;1
0;KZ75125KZT2069100104;2017-03-09;-876;-876;-876;77;77;KZT;null;null;-953;-953;1
0;KZ75125KZT2069100104;2017-03-10;-825;-825;-825;51;51;KZT;null;null;-876;-876;1
0;KZ75125KZT2069100104;2017-03-11;-756;-756;-756;69;69;KZT;null;null;-825;-825;1
0;KZ75125KZT2069100104;2017-03-12;-829;-829;-829;null;null;KZT;73;73;-756;-756;1
0;KZ75125KZT2069100104;2017-03-13;-906;-906;-906;null;null;KZT;77;77;-829;-829;1
0;KZ75125KZT2069100104;2017-03-14;-939;-939;-939;null;null;KZT;33;33;-906;-906;1
0;KZ75125KZT2069100104;2017-03-15;-1025;-1025;-1025;null;null;KZT;86;86;-939;-939;1
0;KZ75125KZT2069100104;2017-03-16;-970;-970;-970;55;55;KZT;null;null;-1025;-1025;1
0;KZ75125KZT2069100104;2017-03-17;-912;-912;-912;58;58;KZT;null;null;-970;-970;1
0;KZ75125KZT2069100104;2017-03-18;-957;-957;-957;null;null;KZT;45;45;-912;-912;1
0;KZ75125KZT2069100104;2017-03-19;-862;-862;-862;95;95;KZT;null;null;-957;-957;1
0;KZ75125KZT2069100104;2017-03-20;-858;-858;-858;4;4;KZT;null;null;-862;-862;1
0;KZ75125KZT2069100104;2017-03-21;-793;-793;-793;65;65;KZT;null;null;-858;-858;1
0;KZ75125KZT2069100104;2017-03-22;-809;-809;-809;null;null;KZT;16;16;-793;-793;1
0;KZ75125KZT2069100104;2017-03-23;-845;-845;-845;null;null;KZT;36;36;-809;-809;1
0;KZ75125KZT2069100104;2017-03-24;-933;-933;-933;null;null;KZT;88;88;-845;-845;1
0;KZ75125KZT2069100104;2017-03-25;-1027;-1027;-1027;null;null;KZT;94;94;-933;-933;1
0;KZ75125KZT2069100104;2017-03-26;-968;-968;-968;59;59;KZT;null;null;-1027;-1027;1
0;KZ75125KZT2069100104;2017-03-27;-969;-969;-969;null;null;KZT;1;1;-968;-968;1
0;KZ75125KZT2069100104;2017-03-28;-1027;-1027;-1027;null;null;KZT;58;58;-969;-969;1
0;KZ75125KZT2069100104;2017-03-29;-960;-960;-960;67;67;KZT;null;null;-1027;-1027;1
0;KZ75125KZT2069100104;2017-03-30;-900;-900;-900;60;60;KZT;null;null;-960;-960;1
0;KZ75125KZT2069100104;2017-03-31;-953;-953;-953;null;null;KZT;53;53;-900;-900;1
0;KZ75125KZT2069100104;2017-04-01;-923;-923;-923;30;30;KZT;null;null;-953;-953;1
0;KZ75125KZT2069100104;2017-04-02;-963;-963;-963;null;null;KZT;40;40;-923;-923;1
0;KZ75125KZT2069100104;2017-04-03;-953;-953;-953;10;10;KZT;null;null;-963;-963;1
0;KZ75125KZT2069100104;2017-04-04;-1022;-1022;-1022;null;null;KZT;69;69;-953;-953;1
0;KZ75125KZT2069100104;2017-04-05;-947;-947;-947;75;75;KZT;null;null;-1022;-1022;1
0;KZ75125KZT2069100104;2017-04-06;-911;-911;-911;36;36;KZT;null;null;-947;-947;1
0;KZ75125KZT2069100104;2017-04-07;-817;-817;-817;94;94;KZT;null;null;-911;-911;1
0;KZ75125KZT2069100104;2017-04-08;-773;-773;-773;44;44;KZT;null;null;-817;-817;1
0;KZ75125KZT2069100104;2017-04-09;-848;-848;-848;null;null;KZT;75;75;-773;-773;1
0;KZ75125KZT2069100104;2017-04-10;-804;-804;-804;44;44;KZT;null;null;-848;-848;1
0;KZ75125KZT2069100104;2017-04-11;-718;-718;-718;86;86;KZT;null;null;-804;-804;1
0;KZ75125KZT2069100104;2017-04-12;-711;-711;-711;7;7;KZT;null;null;-718;-718;1
0;KZ75125KZT2069100104;2017-04-13;-643;-643;-643;68;68;KZT;null;null;-711;-711;1
0;KZ75125KZT2069100104;2017-04-14;-670;-670;-670;null;null;KZT;27;27;-643;-643;1
0;KZ75125KZT2069100104;2017-04-15;-668;-668;-668;2;2;KZT;null;null;-670;-670;1
0;KZ75125KZT2069100104;2017-04-16;-577;-577;-577;91;91;KZT;null;null;-668;-668;1
0;KZ75125KZT2069100104;2017-04-17;-569;-569;-569;8;8;KZT;null;null;-577;-577;1
0;KZ75125KZT2069100104;2017-04-18;-637;-637;-637;null;null;KZT;68;68;-569;-569;1
0;KZ75125KZT2069100104;2017-04-19;-600;-600;-600;37;37;KZT;null;null;-637;-637;1
0;KZ75125KZT2069100104;2017-04-20;-625;-625;-625;null;null;KZT;25;25;-600;-600;1
0;KZ75125KZT2069100104;2017-04-21;-532;-532;-532;93;93;KZT;null;null;-625;-625;1
0;KZ75125KZT2069100104;2017-04-22;-589;-589;-589;null;null;KZT;57;57;-532;-532;1
0;KZ75125KZT2069100104;2017-04-23;-500;-500;-500;89;89;KZT;null;null;-589;-589;1
0;KZ75125KZT2069100104;2017-04-24;-524;-524;-524;null;null;KZT;24;24;-500;-500;1
0;KZ75125KZT2069100104;2017-04-25;-592;-592;-592;null;null;KZT;68;68;-524;-524;1
0;KZ75125KZT2069100104;2017-04-26;-528;-528;-528;64;64;KZT;null;null;-592;-592;1
0;KZ75125KZT2069100104;2017-04-27;-485;-485;-485;43;43;KZT;null;null;-528;-528;1
0;KZ75125KZT2069100104;2017-04-28;-560;-560;-560;null;null;KZT;75;75;-485;-485;1
0;KZ75125KZT2069100104;2017-04-29;-582;-582;-582;null;null;KZT;22;22;-560;-560;1
0;KZ75125KZT2069100104;2017-04-30;-644;-644;-644;null;null;KZT;62;62;-582;-582;1
0;KZ75125KZT2069100104;2017-05-01;-556;-556;-556;88;88;KZT;null;null;-644;-644;1
0;KZ75125KZT2069100104;2017-05-02;-465;-465;-465;91;91;KZT;null;null;-556;-556;1
0;KZ75125KZT2069100104;2017-05-03;-393;-393;-393;72;72;KZT;null;null;-465;-465;1
0;KZ75125KZT2069100104;2017-05-04;-313;-313;-313;80;80;KZT;null;null;-393;-393;1
0;KZ75125KZT2069100104;2017-05-05;-410;-410;-410;null;null;KZT;97;97;-313;-313;1
0;KZ75125KZT2069100104;2017-05-06;-465;-465;-465;null;null;KZT;55;55;-410;-410;1
0;KZ75125KZT2069100104;2017-05-07;-405;-405;-405;60;60;KZT;null;null;-465;-465;1
0;KZ75125KZT2069100104;2017-05-08;-314;-314;-314;91;91;KZT;null;null;-405;-405;1
0;KZ75125KZT2069100104;2017-05-09;-410;-410;-410;null;null;KZT;96;96;-314;-314;1
0;KZ75125KZT2069100104;2017-05-10;-346;-346;-346;64;64;KZT;null;null;-410;-410;1
0;KZ75125KZT2069100104;2017-05-11;-288;-288;-288;58;58;KZT;null;null;-346;-346;1
0;KZ75125KZT2069100104;2017-05-12;-203;-203;-203;85;85;KZT;null;null;-288;-288;1
0;KZ75125KZT2069100104;2017-05-13;-259;-259;-259;null;null;KZT;56;56;-203;-203;1
0;KZ75125KZT2069100104;2017-05-14;-231;-231;-231;28;28;KZT;null;null;-259;-259;1
0;KZ75125KZT2069100104;2017-05-15;-280;-280;-280;null;null;KZT;49;49;-231;-231;1
0;KZ75125KZT2069100104;2017-05-16;-354;-354;-354;null;null;KZT;74;74;-280;-280;1
0;KZ75125KZT2069100104;2017-05-17;-449;-449;-449;null;null;KZT;95;95;-354;-354;1
0;KZ75125KZT2069100104;2017-05-18;-445;-445;-445;4;4;KZT;null;null;-449;-449;1
0;KZ75125KZT2069100104;2017-05-19;-430;-430;-430;15;15;KZT;null;null;-445;-445;1
0;KZ75125KZT2069100104;2017-05-20;-518;-518;-518;null;null;KZT;88;88;-430;-430;1
0;KZ75125KZT2069100104;2017-05-21;-451;-451;-451;67;67;KZT;null;null;-518;-518;1
0;KZ75125KZT2069100104;2017-05-22;-401;-401;-401;50;50;KZT;null;null;-451;-451;1
0;KZ75125KZT2069100104;2017-05-23;-382;-382;-382;19;19;KZT;null;null;-401;-401;1
0;KZ75125KZT2069100104;2017-05-24;-392;-392;-392;null;null;KZT;10;10;-382;-382;1
0;KZ75125KZT2069100104;2017-05-25;-326;-326;-326;66;66;KZT;null;null;-392;-392;1
0;KZ75125KZT2069100104;2017-05-26;-328;-328;-328;null;null;KZT;2;2;-326;-326;1
0;KZ75125KZT2069100104;2017-05-27;-394;-394;-394;null;null;KZT;66;66;-328;-328;1
0;KZ75125KZT2069100104;2017-05-28;-358;-358;-358;36;36;KZT;null;null;-394;-394;1
0;KZ75125KZT2069100104;2017-05-29;-424;-424;-424;null;null;KZT;66;66;-358;-358;1
0;KZ75125KZT2069100104;2017-05-30;-407;-407;-407;17;17;KZT;null;null;-424;-424;1
0;KZ75125KZT2069100104;2017-05-31;-477;-477;-477;null;null;KZT;70;70;-407;-407;1
0;KZ75125KZT2069100104;2017-06-01;-391;-391;-391;86;86;KZT;null;null;-477;-477;1
0;KZ75125KZT2069100104;2017-06-02;-468;-468;-468;null;null;KZT;77;77;-391;-391;1
0;KZ75125KZT2069100104;2017-06-03;-466;-466;-466;2;2;KZT;null;null;-468;-468;1
0;KZ75125KZT2069100104;2017-06-04;-520;-520;-520;null;null;KZT;54;54;-466;-466;1
0;KZ75125KZT2069100104;2017-06-05;-442;-442;-442;78;78;KZT;null;null;-520;-520;1
0;KZ75125KZT2069100104;2017-06-06;-466;-466;-466;null;null;KZT;24;24;-442;-442;1
0;KZ75125KZT2069100104;2017-06-07;-560;-560;-560;null;null;KZT;94;94;-466;-466;1
0;KZ75125KZT2069100104;2017-06-08;-622;-622;-622;null;null;KZT;62;62;-560;-560;1
0;KZ75125KZT2069100104;2017-06-09;-691;-691;-691;null;null;KZT;69;69;-622;-622;1
0;KZ75125KZT2069100104;2017-06-10;-767;-767;-767;null;null;KZT;76;76;-691;-691;1
0;KZ75125KZT2069100104;2017-06-11;-819;-819;-819;null;null;KZT;52;52;-767;-767;1

0;KZ75125EUR2069100105;2015-05-12;113;113;56.5;null;null;EUR;30;15;143;71.5;0.5
0;KZ75125EUR2069100105;2015-05-13;105;105;52.5;null;null;EUR;8;4;113;56.5;0.5
0;KZ75125EUR2069100105;2015-05-14;69;69;34.5;null;null;EUR;36;18;105;52.5;0.5
0;KZ75125EUR2069100105;2015-05-15;7;7;3.5;null;null;EUR;62;31;69;34.5;0.5
0;KZ75125EUR2069100105;2015-05-16;71;71;35.5;64;32;EUR;null;null;7;3.5;0.5
0;KZ75125EUR2069100105;2015-05-17;-23;-23;-11.5;null;null;EUR;94;47;71;35.5;0.5
0;KZ75125EUR2069100105;2015-05-18;-8;-8;-4;15;7.5;EUR;null;null;-23;-11.5;0.5
0;KZ75125EUR2069100105;2015-05-19;-63;-63;-31.5;null;null;EUR;55;27.5;-8;-4;0.5
0;KZ75125EUR2069100105;2015-05-20;-121;-121;-60.5;null;null;EUR;58;29;-63;-31.5;0.5
0;KZ75125EUR2069100105;2015-05-21;-28;-28;-14;93;46.5;EUR;null;null;-121;-60.5;0.5
0;KZ75125EUR2069100105;2015-05-22;31;31;15.5;59;29.5;EUR;null;null;-28;-14;0.5
0;KZ75125EUR2069100105;2015-05-23;125;125;62.5;94;47;EUR;null;null;31;15.5;0.5
0;KZ75125EUR2069100105;2015-05-24;199;199;99.5;74;37;EUR;null;null;125;62.5;0.5
0;KZ75125EUR2069100105;2015-05-25;249;249;124.5;50;25;EUR;null;null;199;99.5;0.5
0;KZ75125EUR2069100105;2015-05-26;223;223;111.5;null;null;EUR;26;13;249;124.5;0.5
0;KZ75125EUR2069100105;2015-05-27;293;293;146.5;70;35;EUR;null;null;223;111.5;0.5
0;KZ75125EUR2069100105;2015-05-28;330;330;165;37;18.5;EUR;null;null;293;146.5;0.5
0;KZ75125EUR2069100105;2015-05-29;261;261;130.5;null;null;EUR;69;34.5;330;165;0.5
0;KZ75125EUR2069100105;2015-05-30;244;244;122;null;null;EUR;17;8.5;261;130.5;0.5
0;KZ75125EUR2069100105;2015-05-31;153;153;76.5;null;null;EUR;91;45.5;244;122;0.5
0;KZ75125EUR2069100105;2015-06-01;92;92;46;null;null;EUR;61;30.5;153;76.5;0.5
0;KZ75125EUR2069100105;2015-06-02;35;35;17.5;null;null;EUR;57;28.5;92;46;0.5
0;KZ75125EUR2069100105;2015-06-03;35;35;17.5;null;null;EUR;0;0;35;17.5;0.5
0;KZ75125EUR2069100105;2015-06-04;56;56;28;21;10.5;EUR;null;null;35;17.5;0.5
0;KZ75125EUR2069100105;2015-06-05;91;91;45.5;35;17.5;EUR;null;null;56;28;0.5
0;KZ75125EUR2069100105;2015-06-06;185;185;92.5;94;47;EUR;null;null;91;45.5;0.5
0;KZ75125EUR2069100105;2015-06-07;191;191;95.5;6;3;EUR;null;null;185;92.5;0.5
0;KZ75125EUR2069100105;2015-06-08;263;263;131.5;72;36;EUR;null;null;191;95.5;0.5
0;KZ75125EUR2069100105;2015-06-09;197;197;98.5;null;null;EUR;66;33;263;131.5;0.5
0;KZ75125EUR2069100105;2015-06-10;176;176;88;null;null;EUR;21;10.5;197;98.5;0.5
0;KZ75125EUR2069100105;2015-06-11;252;252;126;76;38;EUR;null;null;176;88;0.5
0;KZ75125EUR2069100105;2015-06-12;343;343;171.5;91;45.5;EUR;null;null;252;126;0.5
0;KZ75125EUR2069100105;2015-06-13;372;372;186;29;14.5;EUR;null;null;343;171.5;0.5
0;KZ75125EUR2069100105;2015-06-14;356;356;178;null;null;EUR;16;8;372;186;0.5
0;KZ75125EUR2069100105;2015-06-15;319;319;159.5;null;null;EUR;37;18.5;356;178;0.5
0;KZ75125EUR2069100105;2015-06-16;282;282;141;null;null;EUR;37;18.5;319;159.5;0.5
0;KZ75125EUR2069100105;2015-06-17;335;335;167.5;53;26.5;EUR;null;null;282;141;0.5
0;KZ75125EUR2069100105;2015-06-18;375;375;187.5;40;20;EUR;null;null;335;167.5;0.5
0;KZ75125EUR2069100105;2015-06-19;369;369;184.5;null;null;EUR;6;3;375;187.5;0.5
0;KZ75125EUR2069100105;2015-06-20;375;375;187.5;6;3;EUR;null;null;369;184.5;0.5
0;KZ75125EUR2069100105;2015-06-21;441;441;220.5;66;33;EUR;null;null;375;187.5;0.5
0;KZ75125EUR2069100105;2015-06-22;495;495;247.5;54;27;EUR;null;null;441;220.5;0.5
0;KZ75125EUR2069100105;2015-06-23;447;447;223.5;null;null;EUR;48;24;495;247.5;0.5
0;KZ75125EUR2069100105;2015-06-24;544;544;272;97;48.5;EUR;null;null;447;223.5;0.5
0;KZ75125EUR2069100105;2015-06-25;460;460;230;null;null;EUR;84;42;544;272;0.5
0;KZ75125EUR2069100105;2015-06-26;533;533;266.5;73;36.5;EUR;null;null;460;230;0.5
0;KZ75125EUR2069100105;2015-06-27;475;475;237.5;null;null;EUR;58;29;533;266.5;0.5
0;KZ75125EUR2069100105;2015-06-28;387;387;193.5;null;null;EUR;88;44;475;237.5;0.5
0;KZ75125EUR2069100105;2015-06-29;345;345;172.5;null;null;EUR;42;21;387;193.5;0.5
0;KZ75125EUR2069100105;2015-06-30;401;401;200.5;56;28;EUR;null;null;345;172.5;0.5
0;KZ75125EUR2069100105;2015-07-01;420;420;210;19;9.5;EUR;null;null;401;200.5;0.5
0;KZ75125EUR2069100105;2015-07-02;393;393;196.5;null;null;EUR;27;13.5;420;210;0.5
0;KZ75125EUR2069100105;2015-07-03;295;295;147.5;null;null;EUR;98;49;393;196.5;0.5
0;KZ75125EUR2069100105;2015-07-04;238;238;119;null;null;EUR;57;28.5;295;147.5;0.5
0;KZ75125EUR2069100105;2015-07-05;195;195;97.5;null;null;EUR;43;21.5;238;119;0.5
0;KZ75125EUR2069100105;2015-07-06;103;103;51.5;null;null;EUR;92;46;195;97.5;0.5
0;KZ75125EUR2069100105;2015-07-07;61;61;30.5;null;null;EUR;42;21;103;51.5;0.5
0;KZ75125EUR2069100105;2015-07-08;-22;-22;-11;null;null;EUR;83;41.5;61;30.5;0.5
0;KZ75125EUR2069100105;2015-07-09;-80;-80;-40;null;null;EUR;58;29;-22;-11;0.5
0;KZ75125EUR2069100105;2015-07-10;-177;-177;-88.5;null;null;EUR;97;48.5;-80;-40;0.5
0;KZ75125EUR2069100105;2015-07-11;-231;-231;-115.5;null;null;EUR;54;27;-177;-88.5;0.5
0;KZ75125EUR2069100105;2015-07-12;-257;-257;-128.5;null;null;EUR;26;13;-231;-115.5;0.5
0;KZ75125EUR2069100105;2015-07-13;-172;-172;-86;85;42.5;EUR;null;null;-257;-128.5;0.5
0;KZ75125EUR2069100105;2015-07-14;-246;-246;-123;null;null;EUR;74;37;-172;-86;0.5
0;KZ75125EUR2069100105;2015-07-15;-226;-226;-113;20;10;EUR;null;null;-246;-123;0.5
0;KZ75125EUR2069100105;2015-07-16;-218;-218;-109;8;4;EUR;null;null;-226;-113;0.5
0;KZ75125EUR2069100105;2015-07-17;-122;-122;-61;96;48;EUR;null;null;-218;-109;0.5
0;KZ75125EUR2069100105;2015-07-18;-145;-145;-72.5;null;null;EUR;23;11.5;-122;-61;0.5
0;KZ75125EUR2069100105;2015-07-19;-132;-132;-66;13;6.5;EUR;null;null;-145;-72.5;0.5
0;KZ75125EUR2069100105;2015-07-20;-74;-74;-37;58;29;EUR;null;null;-132;-66;0.5
0;KZ75125EUR2069100105;2015-07-21;-86;-86;-43;null;null;EUR;12;6;-74;-37;0.5
0;KZ75125EUR2069100105;2015-07-22;-126;-126;-63;null;null;EUR;40;20;-86;-43;0.5
0;KZ75125EUR2069100105;2015-07-23;-97;-97;-48.5;29;14.5;EUR;null;null;-126;-63;0.5
0;KZ75125EUR2069100105;2015-07-24;-90;-90;-45;7;3.5;EUR;null;null;-97;-48.5;0.5
0;KZ75125EUR2069100105;2015-07-25;-5;-5;-2.5;85;42.5;EUR;null;null;-90;-45;0.5
0;KZ75125EUR2069100105;2015-07-26;77;77;38.5;82;41;EUR;null;null;-5;-2.5;0.5
0;KZ75125EUR2069100105;2015-07-27;62;62;31;null;null;EUR;15;7.5;77;38.5;0.5
0;KZ75125EUR2069100105;2015-07-28;71;71;35.5;9;4.5;EUR;null;null;62;31;0.5
0;KZ75125EUR2069100105;2015-07-29;7;7;3.5;null;null;EUR;64;32;71;35.5;0.5
0;KZ75125EUR2069100105;2015-07-30;-73;-73;-36.5;null;null;EUR;80;40;7;3.5;0.5
0;KZ75125EUR2069100105;2015-07-31;-53;-53;-26.5;20;10;EUR;null;null;-73;-36.5;0.5
0;KZ75125EUR2069100105;2015-08-01;-106;-106;-53;null;null;EUR;53;26.5;-53;-26.5;0.5
0;KZ75125EUR2069100105;2015-08-02;-132;-132;-66;null;null;EUR;26;13;-106;-53;0.5
0;KZ75125EUR2069100105;2015-08-03;-149;-149;-74.5;null;null;EUR;17;8.5;-132;-66;0.5
0;KZ75125EUR2069100105;2015-08-04;-62;-62;-31;87;43.5;EUR;null;null;-149;-74.5;0.5
0;KZ75125EUR2069100105;2015-08-05;-120;-120;-60;null;null;EUR;58;29;-62;-31;0.5
0;KZ75125EUR2069100105;2015-08-06;-84;-84;-42;36;18;EUR;null;null;-120;-60;0.5
0;KZ75125EUR2069100105;2015-08-07;-44;-44;-22;40;20;EUR;null;null;-84;-42;0.5
0;KZ75125EUR2069100105;2015-08-08;31;31;15.5;75;37.5;EUR;null;null;-44;-22;0.5
0;KZ75125EUR2069100105;2015-08-09;2;2;1;null;null;EUR;29;14.5;31;15.5;0.5
0;KZ75125EUR2069100105;2015-08-10;-93;-93;-46.5;null;null;EUR;95;47.5;2;1;0.5
0;KZ75125EUR2069100105;2015-08-11;-5;-5;-2.5;88;44;EUR;null;null;-93;-46.5;0.5
0;KZ75125EUR2069100105;2015-08-12;82;82;41;87;43.5;EUR;null;null;-5;-2.5;0.5
0;KZ75125EUR2069100105;2015-08-13;166;166;83;84;42;EUR;null;null;82;41;0.5
0;KZ75125EUR2069100105;2015-08-14;108;108;54;null;null;EUR;58;29;166;83;0.5
0;KZ75125EUR2069100105;2015-08-15;121;121;60.5;13;6.5;EUR;null;null;108;54;0.5
0;KZ75125EUR2069100105;2015-08-16;145;145;72.5;24;12;EUR;null;null;121;60.5;0.5
0;KZ75125EUR2069100105;2015-08-17;72;72;36;null;null;EUR;73;36.5;145;72.5;0.5
0;KZ75125EUR2069100105;2015-08-18;152;152;76;80;40;EUR;null;null;72;36;0.5
0;KZ75125EUR2069100105;2015-08-19;208;208;104;56;28;EUR;null;null;152;76;0.5
0;KZ75125EUR2069100105;2015-08-20;302;302;151;94;47;EUR;null;null;208;104;0.5
0;KZ75125EUR2069100105;2015-08-21;390;390;195;88;44;EUR;null;null;302;151;0.5
0;KZ75125EUR2069100105;2015-08-22;339;339;169.5;null;null;EUR;51;25.5;390;195;0.5
0;KZ75125EUR2069100105;2015-08-23;402;402;201;63;31.5;EUR;null;null;339;169.5;0.5
0;KZ75125EUR2069100105;2015-08-24;331;331;165.5;null;null;EUR;71;35.5;402;201;0.5
0;KZ75125EUR2069100105;2015-08-25;290;290;145;null;null;EUR;41;20.5;331;165.5;0.5
0;KZ75125EUR2069100105;2015-08-26;229;229;114.5;null;null;EUR;61;30.5;290;145;0.5
0;KZ75125EUR2069100105;2015-08-27;149;149;74.5;null;null;EUR;80;40;229;114.5;0.5
0;KZ75125EUR2069100105;2015-08-28;224;224;112;75;37.5;EUR;null;null;149;74.5;0.5
0;KZ75125EUR2069100105;2015-08-29;156;156;78;null;null;EUR;68;34;224;112;0.5
0;KZ75125EUR2069100105;2015-08-30;236;236;118;80;40;EUR;null;null;156;78;0.5
0;KZ75125EUR2069100105;2015-08-31;280;280;140;44;22;EUR;null;null;236;118;0.5
0;KZ75125EUR2069100105;2015-09-01;251;251;125.5;null;null;EUR;29;14.5;280;140;0.5
0;KZ75125EUR2069100105;2015-09-02;215;215;107.5;null;null;EUR;36;18;251;125.5;0.5
0;KZ75125EUR2069100105;2015-09-03;240;240;120;25;12.5;EUR;null;null;215;107.5;0.5
0;KZ75125EUR2069100105;2015-09-04;210;210;105;null;null;EUR;30;15;240;120;0.5
0;KZ75125EUR2069100105;2015-09-05;257;257;128.5;47;23.5;EUR;null;null;210;105;0.5
0;KZ75125EUR2069100105;2015-09-06;241;241;120.5;null;null;EUR;16;8;257;128.5;0.5
0;KZ75125EUR2069100105;2015-09-07;186;186;93;null;null;EUR;55;27.5;241;120.5;0.5
0;KZ75125EUR2069100105;2015-09-08;260;260;130;74;37;EUR;null;null;186;93;0.5
0;KZ75125EUR2069100105;2015-09-09;298;298;149;38;19;EUR;null;null;260;130;0.5
0;KZ75125EUR2069100105;2015-09-10;276;276;138;null;null;EUR;22;11;298;149;0.5
0;KZ75125EUR2069100105;2015-09-11;187;187;93.5;null;null;EUR;89;44.5;276;138;0.5
0;KZ75125EUR2069100105;2015-09-12;234;234;117;47;23.5;EUR;null;null;187;93.5;0.5
0;KZ75125EUR2069100105;2015-09-13;169;169;84.5;null;null;EUR;65;32.5;234;117;0.5
0;KZ75125EUR2069100105;2015-09-14;221;221;110.5;52;26;EUR;null;null;169;84.5;0.5
0;KZ75125EUR2069100105;2015-09-15;262;262;131;41;20.5;EUR;null;null;221;110.5;0.5
0;KZ75125EUR2069100105;2015-09-16;352;352;176;90;45;EUR;null;null;262;131;0.5
0;KZ75125EUR2069100105;2015-09-17;280;280;140;null;null;EUR;72;36;352;176;0.5
0;KZ75125EUR2069100105;2015-09-18;316;316;158;36;18;EUR;null;null;280;140;0.5
0;KZ75125EUR2069100105;2015-09-19;242;242;121;null;null;EUR;74;37;316;158;0.5
0;KZ75125EUR2069100105;2015-09-20;151;151;75.5;null;null;EUR;91;45.5;242;121;0.5
0;KZ75125EUR2069100105;2015-09-21;105;105;52.5;null;null;EUR;46;23;151;75.5;0.5
0;KZ75125EUR2069100105;2015-09-22;157;157;78.5;52;26;EUR;null;null;105;52.5;0.5
0;KZ75125EUR2069100105;2015-09-23;198;198;99;41;20.5;EUR;null;null;157;78.5;0.5
0;KZ75125EUR2069100105;2015-09-24;131;131;65.5;null;null;EUR;67;33.5;198;99;0.5
0;KZ75125EUR2069100105;2015-09-25;69;69;34.5;null;null;EUR;62;31;131;65.5;0.5
0;KZ75125EUR2069100105;2015-09-26;156;156;78;87;43.5;EUR;null;null;69;34.5;0.5
0;KZ75125EUR2069100105;2015-09-27;120;120;60;null;null;EUR;36;18;156;78;0.5
0;KZ75125EUR2069100105;2015-09-28;168;168;84;48;24;EUR;null;null;120;60;0.5
0;KZ75125EUR2069100105;2015-09-29;203;203;101.5;35;17.5;EUR;null;null;168;84;0.5
0;KZ75125EUR2069100105;2015-09-30;230;230;115;27;13.5;EUR;null;null;203;101.5;0.5
0;KZ75125EUR2069100105;2015-10-01;227;227;113.5;null;null;EUR;3;1.5;230;115;0.5
0;KZ75125EUR2069100105;2015-10-02;269;269;134.5;42;21;EUR;null;null;227;113.5;0.5
0;KZ75125EUR2069100105;2015-10-03;367;367;183.5;98;49;EUR;null;null;269;134.5;0.5
0;KZ75125EUR2069100105;2015-10-04;368;368;184;1;0.5;EUR;null;null;367;183.5;0.5
0;KZ75125EUR2069100105;2015-10-05;424;424;212;56;28;EUR;null;null;368;184;0.5
0;KZ75125EUR2069100105;2015-10-06;381;381;190.5;null;null;EUR;43;21.5;424;212;0.5
0;KZ75125EUR2069100105;2015-10-07;407;407;203.5;26;13;EUR;null;null;381;190.5;0.5
0;KZ75125EUR2069100105;2015-10-08;468;468;234;61;30.5;EUR;null;null;407;203.5;0.5
0;KZ75125EUR2069100105;2015-10-09;567;567;283.5;99;49.5;EUR;null;null;468;234;0.5
0;KZ75125EUR2069100105;2015-10-10;655;655;327.5;88;44;EUR;null;null;567;283.5;0.5
0;KZ75125EUR2069100105;2015-10-11;560;560;280;null;null;EUR;95;47.5;655;327.5;0.5
0;KZ75125EUR2069100105;2015-10-12;514;514;257;null;null;EUR;46;23;560;280;0.5
0;KZ75125EUR2069100105;2015-10-13;552;552;276;38;19;EUR;null;null;514;257;0.5
0;KZ75125EUR2069100105;2015-10-14;609;609;304.5;57;28.5;EUR;null;null;552;276;0.5
0;KZ75125EUR2069100105;2015-10-15;689;689;344.5;80;40;EUR;null;null;609;304.5;0.5
0;KZ75125EUR2069100105;2015-10-16;606;606;303;null;null;EUR;83;41.5;689;344.5;0.5
0;KZ75125EUR2069100105;2015-10-17;664;664;332;58;29;EUR;null;null;606;303;0.5
0;KZ75125EUR2069100105;2015-10-18;569;569;284.5;null;null;EUR;95;47.5;664;332;0.5
0;KZ75125EUR2069100105;2015-10-19;642;642;321;73;36.5;EUR;null;null;569;284.5;0.5
0;KZ75125EUR2069100105;2015-10-20;557;557;278.5;null;null;EUR;85;42.5;642;321;0.5
0;KZ75125EUR2069100105;2015-10-21;467;467;233.5;null;null;EUR;90;45;557;278.5;0.5
0;KZ75125EUR2069100105;2015-10-22;509;509;254.5;42;21;EUR;null;null;467;233.5;0.5
0;KZ75125EUR2069100105;2015-10-23;597;597;298.5;88;44;EUR;null;null;509;254.5;0.5
0;KZ75125EUR2069100105;2015-10-24;632;632;316;35;17.5;EUR;null;null;597;298.5;0.5
0;KZ75125EUR2069100105;2015-10-25;641;641;320.5;9;4.5;EUR;null;null;632;316;0.5
0;KZ75125EUR2069100105;2015-10-26;588;588;294;null;null;EUR;53;26.5;641;320.5;0.5
0;KZ75125EUR2069100105;2015-10-27;520;520;260;null;null;EUR;68;34;588;294;0.5
0;KZ75125EUR2069100105;2015-10-28;571;571;285.5;51;25.5;EUR;null;null;520;260;0.5
0;KZ75125EUR2069100105;2015-10-29;503;503;251.5;null;null;EUR;68;34;571;285.5;0.5
0;KZ75125EUR2069100105;2015-10-30;432;432;216;null;null;EUR;71;35.5;503;251.5;0.5
0;KZ75125EUR2069100105;2015-10-31;498;498;249;66;33;EUR;null;null;432;216;0.5
0;KZ75125EUR2069100105;2015-11-01;525;525;262.5;27;13.5;EUR;null;null;498;249;0.5
0;KZ75125EUR2069100105;2015-11-02;447;447;223.5;null;null;EUR;78;39;525;262.5;0.5
0;KZ75125EUR2069100105;2015-11-03;399;399;199.5;null;null;EUR;48;24;447;223.5;0.5
0;KZ75125EUR2069100105;2015-11-04;427;427;213.5;28;14;EUR;null;null;399;199.5;0.5
0;KZ75125EUR2069100105;2015-11-05;471;471;235.5;44;22;EUR;null;null;427;213.5;0.5
0;KZ75125EUR2069100105;2015-11-06;423;423;211.5;null;null;EUR;48;24;471;235.5;0.5
0;KZ75125EUR2069100105;2015-11-07;473;473;236.5;50;25;EUR;null;null;423;211.5;0.5
0;KZ75125EUR2069100105;2015-11-08;500;500;250;27;13.5;EUR;null;null;473;236.5;0.5
0;KZ75125EUR2069100105;2015-11-09;507;507;253.5;7;3.5;EUR;null;null;500;250;0.5
0;KZ75125EUR2069100105;2015-11-10;425;425;212.5;null;null;EUR;82;41;507;253.5;0.5
0;KZ75125EUR2069100105;2015-11-11;350;350;175;null;null;EUR;75;37.5;425;212.5;0.5
0;KZ75125EUR2069100105;2015-11-12;434;434;217;84;42;EUR;null;null;350;175;0.5
0;KZ75125EUR2069100105;2015-11-13;466;466;233;32;16;EUR;null;null;434;217;0.5
0;KZ75125EUR2069100105;2015-11-14;561;561;280.5;95;47.5;EUR;null;null;466;233;0.5
0;KZ75125EUR2069100105;2015-11-15;586;586;293;25;12.5;EUR;null;null;561;280.5;0.5
0;KZ75125EUR2069100105;2015-11-16;561;561;280.5;null;null;EUR;25;12.5;586;293;0.5
0;KZ75125EUR2069100105;2015-11-17;532;532;266;null;null;EUR;29;14.5;561;280.5;0.5
0;KZ75125EUR2069100105;2015-11-18;519;519;259.5;null;null;EUR;13;6.5;532;266;0.5
0;KZ75125EUR2069100105;2015-11-19;532;532;266;13;6.5;EUR;null;null;519;259.5;0.5
0;KZ75125EUR2069100105;2015-11-20;509;509;254.5;null;null;EUR;23;11.5;532;266;0.5
0;KZ75125EUR2069100105;2015-11-21;414;414;207;null;null;EUR;95;47.5;509;254.5;0.5
0;KZ75125EUR2069100105;2015-11-22;422;422;211;8;4;EUR;null;null;414;207;0.5
0;KZ75125EUR2069100105;2015-11-23;423;423;211.5;1;0.5;EUR;null;null;422;211;0.5
0;KZ75125EUR2069100105;2015-11-24;460;460;230;37;18.5;EUR;null;null;423;211.5;0.5
0;KZ75125EUR2069100105;2015-11-25;361;361;180.5;null;null;EUR;99;49.5;460;230;0.5
0;KZ75125EUR2069100105;2015-11-26;339;339;169.5;null;null;EUR;22;11;361;180.5;0.5
0;KZ75125EUR2069100105;2015-11-27;244;244;122;null;null;EUR;95;47.5;339;169.5;0.5
0;KZ75125EUR2069100105;2015-11-28;207;207;103.5;null;null;EUR;37;18.5;244;122;0.5
0;KZ75125EUR2069100105;2015-11-29;140;140;70;null;null;EUR;67;33.5;207;103.5;0.5
0;KZ75125EUR2069100105;2015-11-30;55;55;27.5;null;null;EUR;85;42.5;140;70;0.5
0;KZ75125EUR2069100105;2015-12-01;-26;-26;-13;null;null;EUR;81;40.5;55;27.5;0.5
0;KZ75125EUR2069100105;2015-12-02;56;56;28;82;41;EUR;null;null;-26;-13;0.5
0;KZ75125EUR2069100105;2015-12-03;143;143;71.5;87;43.5;EUR;null;null;56;28;0.5
0;KZ75125EUR2069100105;2015-12-04;218;218;109;75;37.5;EUR;null;null;143;71.5;0.5
0;KZ75125EUR2069100105;2015-12-05;229;229;114.5;11;5.5;EUR;null;null;218;109;0.5
0;KZ75125EUR2069100105;2015-12-06;186;186;93;null;null;EUR;43;21.5;229;114.5;0.5
0;KZ75125EUR2069100105;2015-12-07;163;163;81.5;null;null;EUR;23;11.5;186;93;0.5
0;KZ75125EUR2069100105;2015-12-08;110;110;55;null;null;EUR;53;26.5;163;81.5;0.5
0;KZ75125EUR2069100105;2015-12-09;109;109;54.5;null;null;EUR;1;0.5;110;55;0.5
0;KZ75125EUR2069100105;2015-12-10;39;39;19.5;null;null;EUR;70;35;109;54.5;0.5
0;KZ75125EUR2069100105;2015-12-11;73;73;36.5;34;17;EUR;null;null;39;19.5;0.5
0;KZ75125EUR2069100105;2015-12-12;20;20;10;null;null;EUR;53;26.5;73;36.5;0.5
0;KZ75125EUR2069100105;2015-12-13;-8;-8;-4;null;null;EUR;28;14;20;10;0.5
0;KZ75125EUR2069100105;2015-12-14;-58;-58;-29;null;null;EUR;50;25;-8;-4;0.5
0;KZ75125EUR2069100105;2015-12-15;-113;-113;-56.5;null;null;EUR;55;27.5;-58;-29;0.5
0;KZ75125EUR2069100105;2015-12-16;-183;-183;-91.5;null;null;EUR;70;35;-113;-56.5;0.5
0;KZ75125EUR2069100105;2015-12-17;-282;-282;-141;null;null;EUR;99;49.5;-183;-91.5;0.5
0;KZ75125EUR2069100105;2015-12-18;-284;-284;-142;null;null;EUR;2;1;-282;-141;0.5
0;KZ75125EUR2069100105;2015-12-19;-320;-320;-160;null;null;EUR;36;18;-284;-142;0.5
0;KZ75125EUR2069100105;2015-12-20;-290;-290;-145;30;15;EUR;null;null;-320;-160;0.5
0;KZ75125EUR2069100105;2015-12-21;-260;-260;-130;30;15;EUR;null;null;-290;-145;0.5
0;KZ75125EUR2069100105;2015-12-22;-177;-177;-88.5;83;41.5;EUR;null;null;-260;-130;0.5
0;KZ75125EUR2069100105;2015-12-23;-129;-129;-64.5;48;24;EUR;null;null;-177;-88.5;0.5
0;KZ75125EUR2069100105;2015-12-24;-157;-157;-78.5;null;null;EUR;28;14;-129;-64.5;0.5
0;KZ75125EUR2069100105;2015-12-25;-117;-117;-58.5;40;20;EUR;null;null;-157;-78.5;0.5
0;KZ75125EUR2069100105;2015-12-26;-104;-104;-52;13;6.5;EUR;null;null;-117;-58.5;0.5
0;KZ75125EUR2069100105;2015-12-27;-140;-140;-70;null;null;EUR;36;18;-104;-52;0.5
0;KZ75125EUR2069100105;2015-12-28;-231;-231;-115.5;null;null;EUR;91;45.5;-140;-70;0.5
0;KZ75125EUR2069100105;2015-12-29;-288;-288;-144;null;null;EUR;57;28.5;-231;-115.5;0.5
0;KZ75125EUR2069100105;2015-12-30;-310;-310;-155;null;null;EUR;22;11;-288;-144;0.5
0;KZ75125EUR2069100105;2015-12-31;-272;-272;-136;38;19;EUR;null;null;-310;-155;0.5
0;KZ75125EUR2069100105;2016-01-01;-342;-342;-171;null;null;EUR;70;35;-272;-136;0.5
0;KZ75125EUR2069100105;2016-01-02;-319;-319;-159.5;23;11.5;EUR;null;null;-342;-171;0.5
0;KZ75125EUR2069100105;2016-01-03;-406;-406;-203;null;null;EUR;87;43.5;-319;-159.5;0.5
0;KZ75125EUR2069100105;2016-01-04;-490;-490;-245;null;null;EUR;84;42;-406;-203;0.5
0;KZ75125EUR2069100105;2016-01-05;-402;-402;-201;88;44;EUR;null;null;-490;-245;0.5
0;KZ75125EUR2069100105;2016-01-06;-367;-367;-183.5;35;17.5;EUR;null;null;-402;-201;0.5
0;KZ75125EUR2069100105;2016-01-07;-435;-435;-217.5;null;null;EUR;68;34;-367;-183.5;0.5
0;KZ75125EUR2069100105;2016-01-08;-388;-388;-194;47;23.5;EUR;null;null;-435;-217.5;0.5
0;KZ75125EUR2069100105;2016-01-09;-357;-357;-178.5;31;15.5;EUR;null;null;-388;-194;0.5
0;KZ75125EUR2069100105;2016-01-10;-362;-362;-181;null;null;EUR;5;2.5;-357;-178.5;0.5
0;KZ75125EUR2069100105;2016-01-11;-308;-308;-154;54;27;EUR;null;null;-362;-181;0.5
0;KZ75125EUR2069100105;2016-01-12;-370;-370;-185;null;null;EUR;62;31;-308;-154;0.5
0;KZ75125EUR2069100105;2016-01-13;-328;-328;-164;42;21;EUR;null;null;-370;-185;0.5
0;KZ75125EUR2069100105;2016-01-14;-331;-331;-165.5;null;null;EUR;3;1.5;-328;-164;0.5
0;KZ75125EUR2069100105;2016-01-15;-261;-261;-130.5;70;35;EUR;null;null;-331;-165.5;0.5
0;KZ75125EUR2069100105;2016-01-16;-323;-323;-161.5;null;null;EUR;62;31;-261;-130.5;0.5
0;KZ75125EUR2069100105;2016-01-17;-326;-326;-163;null;null;EUR;3;1.5;-323;-161.5;0.5
0;KZ75125EUR2069100105;2016-01-18;-384;-384;-192;null;null;EUR;58;29;-326;-163;0.5
0;KZ75125EUR2069100105;2016-01-19;-395;-395;-197.5;null;null;EUR;11;5.5;-384;-192;0.5
0;KZ75125EUR2069100105;2016-01-20;-434;-434;-217;null;null;EUR;39;19.5;-395;-197.5;0.5
0;KZ75125EUR2069100105;2016-01-21;-476;-476;-238;null;null;EUR;42;21;-434;-217;0.5
0;KZ75125EUR2069100105;2016-01-22;-552;-552;-276;null;null;EUR;76;38;-476;-238;0.5
0;KZ75125EUR2069100105;2016-01-23;-572;-572;-286;null;null;EUR;20;10;-552;-276;0.5
0;KZ75125EUR2069100105;2016-01-24;-492;-492;-246;80;40;EUR;null;null;-572;-286;0.5
0;KZ75125EUR2069100105;2016-01-25;-451;-451;-225.5;41;20.5;EUR;null;null;-492;-246;0.5
0;KZ75125EUR2069100105;2016-01-26;-401;-401;-200.5;50;25;EUR;null;null;-451;-225.5;0.5
0;KZ75125EUR2069100105;2016-01-27;-401;-401;-200.5;null;null;EUR;0;0;-401;-200.5;0.5
0;KZ75125EUR2069100105;2016-01-28;-497;-497;-248.5;null;null;EUR;96;48;-401;-200.5;0.5
0;KZ75125EUR2069100105;2016-01-29;-582;-582;-291;null;null;EUR;85;42.5;-497;-248.5;0.5
0;KZ75125EUR2069100105;2016-01-30;-500;-500;-250;82;41;EUR;null;null;-582;-291;0.5
0;KZ75125EUR2069100105;2016-01-31;-502;-502;-251;null;null;EUR;2;1;-500;-250;0.5
0;KZ75125EUR2069100105;2016-02-01;-551;-551;-275.5;null;null;EUR;49;24.5;-502;-251;0.5
0;KZ75125EUR2069100105;2016-02-02;-529;-529;-264.5;22;11;EUR;null;null;-551;-275.5;0.5
0;KZ75125EUR2069100105;2016-02-03;-448;-448;-224;81;40.5;EUR;null;null;-529;-264.5;0.5
0;KZ75125EUR2069100105;2016-02-04;-494;-494;-247;null;null;EUR;46;23;-448;-224;0.5
0;KZ75125EUR2069100105;2016-02-05;-535;-535;-267.5;null;null;EUR;41;20.5;-494;-247;0.5
0;KZ75125EUR2069100105;2016-02-06;-473;-473;-236.5;62;31;EUR;null;null;-535;-267.5;0.5
0;KZ75125EUR2069100105;2016-02-07;-444;-444;-222;29;14.5;EUR;null;null;-473;-236.5;0.5
0;KZ75125EUR2069100105;2016-02-08;-451;-451;-225.5;null;null;EUR;7;3.5;-444;-222;0.5
0;KZ75125EUR2069100105;2016-02-09;-470;-470;-235;null;null;EUR;19;9.5;-451;-225.5;0.5
0;KZ75125EUR2069100105;2016-02-10;-470;-470;-235;null;null;EUR;0;0;-470;-235;0.5
0;KZ75125EUR2069100105;2016-02-11;-544;-544;-272;null;null;EUR;74;37;-470;-235;0.5
0;KZ75125EUR2069100105;2016-02-12;-561;-561;-280.5;null;null;EUR;17;8.5;-544;-272;0.5
0;KZ75125EUR2069100105;2016-02-13;-634;-634;-317;null;null;EUR;73;36.5;-561;-280.5;0.5
0;KZ75125EUR2069100105;2016-02-14;-624;-624;-312;10;5;EUR;null;null;-634;-317;0.5
0;KZ75125EUR2069100105;2016-02-15;-593;-593;-296.5;31;15.5;EUR;null;null;-624;-312;0.5
0;KZ75125EUR2069100105;2016-02-16;-674;-674;-337;null;null;EUR;81;40.5;-593;-296.5;0.5
0;KZ75125EUR2069100105;2016-02-17;-722;-722;-361;null;null;EUR;48;24;-674;-337;0.5
0;KZ75125EUR2069100105;2016-02-18;-751;-751;-375.5;null;null;EUR;29;14.5;-722;-361;0.5
0;KZ75125EUR2069100105;2016-02-19;-725;-725;-362.5;26;13;EUR;null;null;-751;-375.5;0.5
0;KZ75125EUR2069100105;2016-02-20;-697;-697;-348.5;28;14;EUR;null;null;-725;-362.5;0.5
0;KZ75125EUR2069100105;2016-02-21;-653;-653;-326.5;44;22;EUR;null;null;-697;-348.5;0.5
0;KZ75125EUR2069100105;2016-02-22;-566;-566;-283;87;43.5;EUR;null;null;-653;-326.5;0.5
0;KZ75125EUR2069100105;2016-02-23;-609;-609;-304.5;null;null;EUR;43;21.5;-566;-283;0.5
0;KZ75125EUR2069100105;2016-02-24;-554;-554;-277;55;27.5;EUR;null;null;-609;-304.5;0.5
0;KZ75125EUR2069100105;2016-02-25;-499;-499;-249.5;55;27.5;EUR;null;null;-554;-277;0.5
0;KZ75125EUR2069100105;2016-02-26;-560;-560;-280;null;null;EUR;61;30.5;-499;-249.5;0.5
0;KZ75125EUR2069100105;2016-02-27;-617;-617;-308.5;null;null;EUR;57;28.5;-560;-280;0.5
0;KZ75125EUR2069100105;2016-02-28;-526;-526;-263;91;45.5;EUR;null;null;-617;-308.5;0.5
0;KZ75125EUR2069100105;2016-02-29;-587;-587;-293.5;null;null;EUR;61;30.5;-526;-263;0.5
0;KZ75125EUR2069100105;2016-03-01;-579;-579;-289.5;8;4;EUR;null;null;-587;-293.5;0.5
0;KZ75125EUR2069100105;2016-03-02;-531;-531;-265.5;48;24;EUR;null;null;-579;-289.5;0.5
0;KZ75125EUR2069100105;2016-03-03;-598;-598;-299;null;null;EUR;67;33.5;-531;-265.5;0.5
0;KZ75125EUR2069100105;2016-03-04;-576;-576;-288;22;11;EUR;null;null;-598;-299;0.5
0;KZ75125EUR2069100105;2016-03-05;-567;-567;-283.5;9;4.5;EUR;null;null;-576;-288;0.5
0;KZ75125EUR2069100105;2016-03-06;-561;-561;-280.5;6;3;EUR;null;null;-567;-283.5;0.5
0;KZ75125EUR2069100105;2016-03-07;-485;-485;-242.5;76;38;EUR;null;null;-561;-280.5;0.5
0;KZ75125EUR2069100105;2016-03-08;-458;-458;-229;27;13.5;EUR;null;null;-485;-242.5;0.5
0;KZ75125EUR2069100105;2016-03-09;-363;-363;-181.5;95;47.5;EUR;null;null;-458;-229;0.5
0;KZ75125EUR2069100105;2016-03-10;-298;-298;-149;65;32.5;EUR;null;null;-363;-181.5;0.5
0;KZ75125EUR2069100105;2016-03-11;-343;-343;-171.5;null;null;EUR;45;22.5;-298;-149;0.5
0;KZ75125EUR2069100105;2016-03-12;-404;-404;-202;null;null;EUR;61;30.5;-343;-171.5;0.5
0;KZ75125EUR2069100105;2016-03-13;-449;-449;-224.5;null;null;EUR;45;22.5;-404;-202;0.5
0;KZ75125EUR2069100105;2016-03-14;-373;-373;-186.5;76;38;EUR;null;null;-449;-224.5;0.5
0;KZ75125EUR2069100105;2016-03-15;-354;-354;-177;19;9.5;EUR;null;null;-373;-186.5;0.5
0;KZ75125EUR2069100105;2016-03-16;-427;-427;-213.5;null;null;EUR;73;36.5;-354;-177;0.5
0;KZ75125EUR2069100105;2016-03-17;-350;-350;-175;77;38.5;EUR;null;null;-427;-213.5;0.5
0;KZ75125EUR2069100105;2016-03-18;-444;-444;-222;null;null;EUR;94;47;-350;-175;0.5
0;KZ75125EUR2069100105;2016-03-19;-430;-430;-215;14;7;EUR;null;null;-444;-222;0.5
0;KZ75125EUR2069100105;2016-03-20;-388;-388;-194;42;21;EUR;null;null;-430;-215;0.5
0;KZ75125EUR2069100105;2016-03-21;-383;-383;-191.5;5;2.5;EUR;null;null;-388;-194;0.5
0;KZ75125EUR2069100105;2016-03-22;-359;-359;-179.5;24;12;EUR;null;null;-383;-191.5;0.5
0;KZ75125EUR2069100105;2016-03-23;-292;-292;-146;67;33.5;EUR;null;null;-359;-179.5;0.5
0;KZ75125EUR2069100105;2016-03-24;-217;-217;-108.5;75;37.5;EUR;null;null;-292;-146;0.5
0;KZ75125EUR2069100105;2016-03-25;-278;-278;-139;null;null;EUR;61;30.5;-217;-108.5;0.5
0;KZ75125EUR2069100105;2016-03-26;-189;-189;-94.5;89;44.5;EUR;null;null;-278;-139;0.5
0;KZ75125EUR2069100105;2016-03-27;-180;-180;-90;9;4.5;EUR;null;null;-189;-94.5;0.5
0;KZ75125EUR2069100105;2016-03-28;-136;-136;-68;44;22;EUR;null;null;-180;-90;0.5
0;KZ75125EUR2069100105;2016-03-29;-56;-56;-28;80;40;EUR;null;null;-136;-68;0.5
0;KZ75125EUR2069100105;2016-03-30;9;9;4.5;65;32.5;EUR;null;null;-56;-28;0.5
0;KZ75125EUR2069100105;2016-03-31;92;92;46;83;41.5;EUR;null;null;9;4.5;0.5
0;KZ75125EUR2069100105;2016-04-01;128;128;64;36;18;EUR;null;null;92;46;0.5
0;KZ75125EUR2069100105;2016-04-02;46;46;23;null;null;EUR;82;41;128;64;0.5
0;KZ75125EUR2069100105;2016-04-03;-32;-32;-16;null;null;EUR;78;39;46;23;0.5
0;KZ75125EUR2069100105;2016-04-04;28;28;14;60;30;EUR;null;null;-32;-16;0.5
0;KZ75125EUR2069100105;2016-04-05;-37;-37;-18.5;null;null;EUR;65;32.5;28;14;0.5
0;KZ75125EUR2069100105;2016-04-06;28;28;14;65;32.5;EUR;null;null;-37;-18.5;0.5
0;KZ75125EUR2069100105;2016-04-07;103;103;51.5;75;37.5;EUR;null;null;28;14;0.5
0;KZ75125EUR2069100105;2016-04-08;82;82;41;null;null;EUR;21;10.5;103;51.5;0.5
0;KZ75125EUR2069100105;2016-04-09;63;63;31.5;null;null;EUR;19;9.5;82;41;0.5
0;KZ75125EUR2069100105;2016-04-10;111;111;55.5;48;24;EUR;null;null;63;31.5;0.5
0;KZ75125EUR2069100105;2016-04-11;114;114;57;3;1.5;EUR;null;null;111;55.5;0.5
0;KZ75125EUR2069100105;2016-04-12;157;157;78.5;43;21.5;EUR;null;null;114;57;0.5
0;KZ75125EUR2069100105;2016-04-13;90;90;45;null;null;EUR;67;33.5;157;78.5;0.5
0;KZ75125EUR2069100105;2016-04-14;137;137;68.5;47;23.5;EUR;null;null;90;45;0.5
0;KZ75125EUR2069100105;2016-04-15;221;221;110.5;84;42;EUR;null;null;137;68.5;0.5
0;KZ75125EUR2069100105;2016-04-16;136;136;68;null;null;EUR;85;42.5;221;110.5;0.5
0;KZ75125EUR2069100105;2016-04-17;55;55;27.5;null;null;EUR;81;40.5;136;68;0.5
0;KZ75125EUR2069100105;2016-04-18;86;86;43;31;15.5;EUR;null;null;55;27.5;0.5
0;KZ75125EUR2069100105;2016-04-19;115;115;57.5;29;14.5;EUR;null;null;86;43;0.5
0;KZ75125EUR2069100105;2016-04-20;39;39;19.5;null;null;EUR;76;38;115;57.5;0.5
0;KZ75125EUR2069100105;2016-04-21;100;100;50;61;30.5;EUR;null;null;39;19.5;0.5
0;KZ75125EUR2069100105;2016-04-22;153;153;76.5;53;26.5;EUR;null;null;100;50;0.5
0;KZ75125EUR2069100105;2016-04-23;159;159;79.5;6;3;EUR;null;null;153;76.5;0.5
0;KZ75125EUR2069100105;2016-04-24;160;160;80;1;0.5;EUR;null;null;159;79.5;0.5
0;KZ75125EUR2069100105;2016-04-25;254;254;127;94;47;EUR;null;null;160;80;0.5
0;KZ75125EUR2069100105;2016-04-26;175;175;87.5;null;null;EUR;79;39.5;254;127;0.5
0;KZ75125EUR2069100105;2016-04-27;198;198;99;23;11.5;EUR;null;null;175;87.5;0.5
0;KZ75125EUR2069100105;2016-04-28;212;212;106;14;7;EUR;null;null;198;99;0.5
0;KZ75125EUR2069100105;2016-04-29;279;279;139.5;67;33.5;EUR;null;null;212;106;0.5
0;KZ75125EUR2069100105;2016-04-30;341;341;170.5;62;31;EUR;null;null;279;139.5;0.5
0;KZ75125EUR2069100105;2016-05-01;433;433;216.5;92;46;EUR;null;null;341;170.5;0.5
0;KZ75125EUR2069100105;2016-05-02;353;353;176.5;null;null;EUR;80;40;433;216.5;0.5
0;KZ75125EUR2069100105;2016-05-03;342;342;171;null;null;EUR;11;5.5;353;176.5;0.5
0;KZ75125EUR2069100105;2016-05-04;278;278;139;null;null;EUR;64;32;342;171;0.5
0;KZ75125EUR2069100105;2016-05-05;326;326;163;48;24;EUR;null;null;278;139;0.5
0;KZ75125EUR2069100105;2016-05-06;276;276;138;null;null;EUR;50;25;326;163;0.5
0;KZ75125EUR2069100105;2016-05-07;362;362;181;86;43;EUR;null;null;276;138;0.5
0;KZ75125EUR2069100105;2016-05-08;322;322;161;null;null;EUR;40;20;362;181;0.5
0;KZ75125EUR2069100105;2016-05-09;391;391;195.5;69;34.5;EUR;null;null;322;161;0.5
0;KZ75125EUR2069100105;2016-05-10;379;379;189.5;null;null;EUR;12;6;391;195.5;0.5
0;KZ75125EUR2069100105;2016-05-11;432;432;216;53;26.5;EUR;null;null;379;189.5;0.5
0;KZ75125EUR2069100105;2016-05-12;402;402;201;null;null;EUR;30;15;432;216;0.5
0;KZ75125EUR2069100105;2016-05-13;461;461;230.5;59;29.5;EUR;null;null;402;201;0.5
0;KZ75125EUR2069100105;2016-05-14;444;444;222;null;null;EUR;17;8.5;461;230.5;0.5
0;KZ75125EUR2069100105;2016-05-15;531;531;265.5;87;43.5;EUR;null;null;444;222;0.5
0;KZ75125EUR2069100105;2016-05-16;627;627;313.5;96;48;EUR;null;null;531;265.5;0.5
0;KZ75125EUR2069100105;2016-05-17;568;568;284;null;null;EUR;59;29.5;627;313.5;0.5
0;KZ75125EUR2069100105;2016-05-18;591;591;295.5;23;11.5;EUR;null;null;568;284;0.5
0;KZ75125EUR2069100105;2016-05-19;524;524;262;null;null;EUR;67;33.5;591;295.5;0.5
0;KZ75125EUR2069100105;2016-05-20;524;524;262;null;null;EUR;0;0;524;262;0.5
0;KZ75125EUR2069100105;2016-05-21;552;552;276;28;14;EUR;null;null;524;262;0.5
0;KZ75125EUR2069100105;2016-05-22;461;461;230.5;null;null;EUR;91;45.5;552;276;0.5
0;KZ75125EUR2069100105;2016-05-23;435;435;217.5;null;null;EUR;26;13;461;230.5;0.5
0;KZ75125EUR2069100105;2016-05-24;461;461;230.5;26;13;EUR;null;null;435;217.5;0.5
0;KZ75125EUR2069100105;2016-05-25;373;373;186.5;null;null;EUR;88;44;461;230.5;0.5
0;KZ75125EUR2069100105;2016-05-26;377;377;188.5;4;2;EUR;null;null;373;186.5;0.5
0;KZ75125EUR2069100105;2016-05-27;354;354;177;null;null;EUR;23;11.5;377;188.5;0.5
0;KZ75125EUR2069100105;2016-05-28;438;438;219;84;42;EUR;null;null;354;177;0.5
0;KZ75125EUR2069100105;2016-05-29;535;535;267.5;97;48.5;EUR;null;null;438;219;0.5
0;KZ75125EUR2069100105;2016-05-30;463;463;231.5;null;null;EUR;72;36;535;267.5;0.5
0;KZ75125EUR2069100105;2016-05-31;541;541;270.5;78;39;EUR;null;null;463;231.5;0.5
0;KZ75125EUR2069100105;2016-06-01;523;523;261.5;null;null;EUR;18;9;541;270.5;0.5
0;KZ75125EUR2069100105;2016-06-02;469;469;234.5;null;null;EUR;54;27;523;261.5;0.5
0;KZ75125EUR2069100105;2016-06-03;445;445;222.5;null;null;EUR;24;12;469;234.5;0.5
0;KZ75125EUR2069100105;2016-06-04;370;370;185;null;null;EUR;75;37.5;445;222.5;0.5
0;KZ75125EUR2069100105;2016-06-05;402;402;201;32;16;EUR;null;null;370;185;0.5
0;KZ75125EUR2069100105;2016-06-06;405;405;202.5;3;1.5;EUR;null;null;402;201;0.5
0;KZ75125EUR2069100105;2016-06-07;432;432;216;27;13.5;EUR;null;null;405;202.5;0.5
0;KZ75125EUR2069100105;2016-06-08;483;483;241.5;51;25.5;EUR;null;null;432;216;0.5
0;KZ75125EUR2069100105;2016-06-09;430;430;215;null;null;EUR;53;26.5;483;241.5;0.5
0;KZ75125EUR2069100105;2016-06-10;494;494;247;64;32;EUR;null;null;430;215;0.5
0;KZ75125EUR2069100105;2016-06-11;414;414;207;null;null;EUR;80;40;494;247;0.5
0;KZ75125EUR2069100105;2016-06-12;455;455;227.5;41;20.5;EUR;null;null;414;207;0.5
0;KZ75125EUR2069100105;2016-06-13;414;414;207;null;null;EUR;41;20.5;455;227.5;0.5
0;KZ75125EUR2069100105;2016-06-14;445;445;222.5;31;15.5;EUR;null;null;414;207;0.5
0;KZ75125EUR2069100105;2016-06-15;368;368;184;null;null;EUR;77;38.5;445;222.5;0.5
0;KZ75125EUR2069100105;2016-06-16;317;317;158.5;null;null;EUR;51;25.5;368;184;0.5
0;KZ75125EUR2069100105;2016-06-17;338;338;169;21;10.5;EUR;null;null;317;158.5;0.5
0;KZ75125EUR2069100105;2016-06-18;375;375;187.5;37;18.5;EUR;null;null;338;169;0.5
0;KZ75125EUR2069100105;2016-06-19;306;306;153;null;null;EUR;69;34.5;375;187.5;0.5
0;KZ75125EUR2069100105;2016-06-20;396;396;198;90;45;EUR;null;null;306;153;0.5
0;KZ75125EUR2069100105;2016-06-21;482;482;241;86;43;EUR;null;null;396;198;0.5
0;KZ75125EUR2069100105;2016-06-22;507;507;253.5;25;12.5;EUR;null;null;482;241;0.5
0;KZ75125EUR2069100105;2016-06-23;526;526;263;19;9.5;EUR;null;null;507;253.5;0.5
0;KZ75125EUR2069100105;2016-06-24;558;558;279;32;16;EUR;null;null;526;263;0.5
0;KZ75125EUR2069100105;2016-06-25;564;564;282;6;3;EUR;null;null;558;279;0.5
0;KZ75125EUR2069100105;2016-06-26;626;626;313;62;31;EUR;null;null;564;282;0.5
0;KZ75125EUR2069100105;2016-06-27;534;534;267;null;null;EUR;92;46;626;313;0.5
0;KZ75125EUR2069100105;2016-06-28;477;477;238.5;null;null;EUR;57;28.5;534;267;0.5
0;KZ75125EUR2069100105;2016-06-29;389;389;194.5;null;null;EUR;88;44;477;238.5;0.5
0;KZ75125EUR2069100105;2016-06-30;421;421;210.5;32;16;EUR;null;null;389;194.5;0.5
0;KZ75125EUR2069100105;2016-07-01;366;366;183;null;null;EUR;55;27.5;421;210.5;0.5
0;KZ75125EUR2069100105;2016-07-02;372;372;186;6;3;EUR;null;null;366;183;0.5
0;KZ75125EUR2069100105;2016-07-03;380;380;190;8;4;EUR;null;null;372;186;0.5
0;KZ75125EUR2069100105;2016-07-04;349;349;174.5;null;null;EUR;31;15.5;380;190;0.5
0;KZ75125EUR2069100105;2016-07-05;355;355;177.5;6;3;EUR;null;null;349;174.5;0.5
0;KZ75125EUR2069100105;2016-07-06;438;438;219;83;41.5;EUR;null;null;355;177.5;0.5
0;KZ75125EUR2069100105;2016-07-07;450;450;225;12;6;EUR;null;null;438;219;0.5
0;KZ75125EUR2069100105;2016-07-08;445;445;222.5;null;null;EUR;5;2.5;450;225;0.5
0;KZ75125EUR2069100105;2016-07-09;452;452;226;7;3.5;EUR;null;null;445;222.5;0.5
0;KZ75125EUR2069100105;2016-07-10;526;526;263;74;37;EUR;null;null;452;226;0.5
0;KZ75125EUR2069100105;2016-07-11;431;431;215.5;null;null;EUR;95;47.5;526;263;0.5
0;KZ75125EUR2069100105;2016-07-12;501;501;250.5;70;35;EUR;null;null;431;215.5;0.5
0;KZ75125EUR2069100105;2016-07-13;478;478;239;null;null;EUR;23;11.5;501;250.5;0.5
0;KZ75125EUR2069100105;2016-07-14;406;406;203;null;null;EUR;72;36;478;239;0.5
0;KZ75125EUR2069100105;2016-07-15;495;495;247.5;89;44.5;EUR;null;null;406;203;0.5
0;KZ75125EUR2069100105;2016-07-16;460;460;230;null;null;EUR;35;17.5;495;247.5;0.5
0;KZ75125EUR2069100105;2016-07-17;496;496;248;36;18;EUR;null;null;460;230;0.5
0;KZ75125EUR2069100105;2016-07-18;543;543;271.5;47;23.5;EUR;null;null;496;248;0.5
0;KZ75125EUR2069100105;2016-07-19;498;498;249;null;null;EUR;45;22.5;543;271.5;0.5
0;KZ75125EUR2069100105;2016-07-20;580;580;290;82;41;EUR;null;null;498;249;0.5
0;KZ75125EUR2069100105;2016-07-21;490;490;245;null;null;EUR;90;45;580;290;0.5
0;KZ75125EUR2069100105;2016-07-22;393;393;196.5;null;null;EUR;97;48.5;490;245;0.5
0;KZ75125EUR2069100105;2016-07-23;436;436;218;43;21.5;EUR;null;null;393;196.5;0.5
0;KZ75125EUR2069100105;2016-07-24;414;414;207;null;null;EUR;22;11;436;218;0.5
0;KZ75125EUR2069100105;2016-07-25;464;464;232;50;25;EUR;null;null;414;207;0.5
0;KZ75125EUR2069100105;2016-07-26;473;473;236.5;9;4.5;EUR;null;null;464;232;0.5
0;KZ75125EUR2069100105;2016-07-27;388;388;194;null;null;EUR;85;42.5;473;236.5;0.5
0;KZ75125EUR2069100105;2016-07-28;318;318;159;null;null;EUR;70;35;388;194;0.5
0;KZ75125EUR2069100105;2016-07-29;342;342;171;24;12;EUR;null;null;318;159;0.5
0;KZ75125EUR2069100105;2016-07-30;252;252;126;null;null;EUR;90;45;342;171;0.5
0;KZ75125EUR2069100105;2016-07-31;212;212;106;null;null;EUR;40;20;252;126;0.5
0;KZ75125EUR2069100105;2016-08-01;145;145;72.5;null;null;EUR;67;33.5;212;106;0.5
0;KZ75125EUR2069100105;2016-08-02;63;63;31.5;null;null;EUR;82;41;145;72.5;0.5
0;KZ75125EUR2069100105;2016-08-03;102;102;51;39;19.5;EUR;null;null;63;31.5;0.5
0;KZ75125EUR2069100105;2016-08-04;126;126;63;24;12;EUR;null;null;102;51;0.5
0;KZ75125EUR2069100105;2016-08-05;89;89;44.5;null;null;EUR;37;18.5;126;63;0.5
0;KZ75125EUR2069100105;2016-08-06;25;25;12.5;null;null;EUR;64;32;89;44.5;0.5
0;KZ75125EUR2069100105;2016-08-07;53;53;26.5;28;14;EUR;null;null;25;12.5;0.5
0;KZ75125EUR2069100105;2016-08-08;-31;-31;-15.5;null;null;EUR;84;42;53;26.5;0.5
0;KZ75125EUR2069100105;2016-08-09;-108;-108;-54;null;null;EUR;77;38.5;-31;-15.5;0.5
0;KZ75125EUR2069100105;2016-08-10;-146;-146;-73;null;null;EUR;38;19;-108;-54;0.5
0;KZ75125EUR2069100105;2016-08-11;-128;-128;-64;18;9;EUR;null;null;-146;-73;0.5
0;KZ75125EUR2069100105;2016-08-12;-204;-204;-102;null;null;EUR;76;38;-128;-64;0.5
0;KZ75125EUR2069100105;2016-08-13;-282;-282;-141;null;null;EUR;78;39;-204;-102;0.5
0;KZ75125EUR2069100105;2016-08-14;-375;-375;-187.5;null;null;EUR;93;46.5;-282;-141;0.5
0;KZ75125EUR2069100105;2016-08-15;-411;-411;-205.5;null;null;EUR;36;18;-375;-187.5;0.5
0;KZ75125EUR2069100105;2016-08-16;-430;-430;-215;null;null;EUR;19;9.5;-411;-205.5;0.5
0;KZ75125EUR2069100105;2016-08-17;-351;-351;-175.5;79;39.5;EUR;null;null;-430;-215;0.5
0;KZ75125EUR2069100105;2016-08-18;-405;-405;-202.5;null;null;EUR;54;27;-351;-175.5;0.5
0;KZ75125EUR2069100105;2016-08-19;-490;-490;-245;null;null;EUR;85;42.5;-405;-202.5;0.5
0;KZ75125EUR2069100105;2016-08-20;-501;-501;-250.5;null;null;EUR;11;5.5;-490;-245;0.5
0;KZ75125EUR2069100105;2016-08-21;-463;-463;-231.5;38;19;EUR;null;null;-501;-250.5;0.5
0;KZ75125EUR2069100105;2016-08-22;-420;-420;-210;43;21.5;EUR;null;null;-463;-231.5;0.5
0;KZ75125EUR2069100105;2016-08-23;-417;-417;-208.5;3;1.5;EUR;null;null;-420;-210;0.5
0;KZ75125EUR2069100105;2016-08-24;-400;-400;-200;17;8.5;EUR;null;null;-417;-208.5;0.5
0;KZ75125EUR2069100105;2016-08-25;-343;-343;-171.5;57;28.5;EUR;null;null;-400;-200;0.5
0;KZ75125EUR2069100105;2016-08-26;-413;-413;-206.5;null;null;EUR;70;35;-343;-171.5;0.5
0;KZ75125EUR2069100105;2016-08-27;-350;-350;-175;63;31.5;EUR;null;null;-413;-206.5;0.5
0;KZ75125EUR2069100105;2016-08-28;-331;-331;-165.5;19;9.5;EUR;null;null;-350;-175;0.5
0;KZ75125EUR2069100105;2016-08-29;-385;-385;-192.5;null;null;EUR;54;27;-331;-165.5;0.5
0;KZ75125EUR2069100105;2016-08-30;-350;-350;-175;35;17.5;EUR;null;null;-385;-192.5;0.5
0;KZ75125EUR2069100105;2016-08-31;-253;-253;-126.5;97;48.5;EUR;null;null;-350;-175;0.5
0;KZ75125EUR2069100105;2016-09-01;-290;-290;-145;null;null;EUR;37;18.5;-253;-126.5;0.5
0;KZ75125EUR2069100105;2016-09-02;-365;-365;-182.5;null;null;EUR;75;37.5;-290;-145;0.5
0;KZ75125EUR2069100105;2016-09-03;-452;-452;-226;null;null;EUR;87;43.5;-365;-182.5;0.5
0;KZ75125EUR2069100105;2016-09-04;-488;-488;-244;null;null;EUR;36;18;-452;-226;0.5
0;KZ75125EUR2069100105;2016-09-05;-405;-405;-202.5;83;41.5;EUR;null;null;-488;-244;0.5
0;KZ75125EUR2069100105;2016-09-06;-346;-346;-173;59;29.5;EUR;null;null;-405;-202.5;0.5
0;KZ75125EUR2069100105;2016-09-07;-249;-249;-124.5;97;48.5;EUR;null;null;-346;-173;0.5
0;KZ75125EUR2069100105;2016-09-08;-330;-330;-165;null;null;EUR;81;40.5;-249;-124.5;0.5
0;KZ75125EUR2069100105;2016-09-09;-246;-246;-123;84;42;EUR;null;null;-330;-165;0.5
0;KZ75125EUR2069100105;2016-09-10;-157;-157;-78.5;89;44.5;EUR;null;null;-246;-123;0.5
0;KZ75125EUR2069100105;2016-09-11;-119;-119;-59.5;38;19;EUR;null;null;-157;-78.5;0.5
0;KZ75125EUR2069100105;2016-09-12;-148;-148;-74;null;null;EUR;29;14.5;-119;-59.5;0.5
0;KZ75125EUR2069100105;2016-09-13;-203;-203;-101.5;null;null;EUR;55;27.5;-148;-74;0.5
0;KZ75125EUR2069100105;2016-09-14;-187;-187;-93.5;16;8;EUR;null;null;-203;-101.5;0.5
0;KZ75125EUR2069100105;2016-09-15;-185;-185;-92.5;2;1;EUR;null;null;-187;-93.5;0.5
0;KZ75125EUR2069100105;2016-09-16;-182;-182;-91;3;1.5;EUR;null;null;-185;-92.5;0.5
0;KZ75125EUR2069100105;2016-09-17;-170;-170;-85;12;6;EUR;null;null;-182;-91;0.5
0;KZ75125EUR2069100105;2016-09-18;-232;-232;-116;null;null;EUR;62;31;-170;-85;0.5
0;KZ75125EUR2069100105;2016-09-19;-223;-223;-111.5;9;4.5;EUR;null;null;-232;-116;0.5
0;KZ75125EUR2069100105;2016-09-20;-285;-285;-142.5;null;null;EUR;62;31;-223;-111.5;0.5
0;KZ75125EUR2069100105;2016-09-21;-308;-308;-154;null;null;EUR;23;11.5;-285;-142.5;0.5
0;KZ75125EUR2069100105;2016-09-22;-372;-372;-186;null;null;EUR;64;32;-308;-154;0.5
0;KZ75125EUR2069100105;2016-09-23;-382;-382;-191;null;null;EUR;10;5;-372;-186;0.5
0;KZ75125EUR2069100105;2016-09-24;-428;-428;-214;null;null;EUR;46;23;-382;-191;0.5
0;KZ75125EUR2069100105;2016-09-25;-506;-506;-253;null;null;EUR;78;39;-428;-214;0.5
0;KZ75125EUR2069100105;2016-09-26;-418;-418;-209;88;44;EUR;null;null;-506;-253;0.5
0;KZ75125EUR2069100105;2016-09-27;-443;-443;-221.5;null;null;EUR;25;12.5;-418;-209;0.5
0;KZ75125EUR2069100105;2016-09-28;-374;-374;-187;69;34.5;EUR;null;null;-443;-221.5;0.5
0;KZ75125EUR2069100105;2016-09-29;-469;-469;-234.5;null;null;EUR;95;47.5;-374;-187;0.5
0;KZ75125EUR2069100105;2016-09-30;-496;-496;-248;null;null;EUR;27;13.5;-469;-234.5;0.5
0;KZ75125EUR2069100105;2016-10-01;-580;-580;-290;null;null;EUR;84;42;-496;-248;0.5
0;KZ75125EUR2069100105;2016-10-02;-493;-493;-246.5;87;43.5;EUR;null;null;-580;-290;0.5
0;KZ75125EUR2069100105;2016-10-03;-526;-526;-263;null;null;EUR;33;16.5;-493;-246.5;0.5
0;KZ75125EUR2069100105;2016-10-04;-466;-466;-233;60;30;EUR;null;null;-526;-263;0.5
0;KZ75125EUR2069100105;2016-10-05;-448;-448;-224;18;9;EUR;null;null;-466;-233;0.5
0;KZ75125EUR2069100105;2016-10-06;-500;-500;-250;null;null;EUR;52;26;-448;-224;0.5
0;KZ75125EUR2069100105;2016-10-07;-550;-550;-275;null;null;EUR;50;25;-500;-250;0.5
0;KZ75125EUR2069100105;2016-10-08;-503;-503;-251.5;47;23.5;EUR;null;null;-550;-275;0.5
0;KZ75125EUR2069100105;2016-10-09;-574;-574;-287;null;null;EUR;71;35.5;-503;-251.5;0.5
0;KZ75125EUR2069100105;2016-10-10;-551;-551;-275.5;23;11.5;EUR;null;null;-574;-287;0.5
0;KZ75125EUR2069100105;2016-10-11;-488;-488;-244;63;31.5;EUR;null;null;-551;-275.5;0.5
0;KZ75125EUR2069100105;2016-10-12;-526;-526;-263;null;null;EUR;38;19;-488;-244;0.5
0;KZ75125EUR2069100105;2016-10-13;-483;-483;-241.5;43;21.5;EUR;null;null;-526;-263;0.5
0;KZ75125EUR2069100105;2016-10-14;-398;-398;-199;85;42.5;EUR;null;null;-483;-241.5;0.5
0;KZ75125EUR2069100105;2016-10-15;-354;-354;-177;44;22;EUR;null;null;-398;-199;0.5
0;KZ75125EUR2069100105;2016-10-16;-445;-445;-222.5;null;null;EUR;91;45.5;-354;-177;0.5
0;KZ75125EUR2069100105;2016-10-17;-481;-481;-240.5;null;null;EUR;36;18;-445;-222.5;0.5
0;KZ75125EUR2069100105;2016-10-18;-401;-401;-200.5;80;40;EUR;null;null;-481;-240.5;0.5
0;KZ75125EUR2069100105;2016-10-19;-401;-401;-200.5;null;null;EUR;0;0;-401;-200.5;0.5
0;KZ75125EUR2069100105;2016-10-20;-335;-335;-167.5;66;33;EUR;null;null;-401;-200.5;0.5
0;KZ75125EUR2069100105;2016-10-21;-273;-273;-136.5;62;31;EUR;null;null;-335;-167.5;0.5
0;KZ75125EUR2069100105;2016-10-22;-199;-199;-99.5;74;37;EUR;null;null;-273;-136.5;0.5
0;KZ75125EUR2069100105;2016-10-23;-213;-213;-106.5;null;null;EUR;14;7;-199;-99.5;0.5
0;KZ75125EUR2069100105;2016-10-24;-295;-295;-147.5;null;null;EUR;82;41;-213;-106.5;0.5
0;KZ75125EUR2069100105;2016-10-25;-295;-295;-147.5;null;null;EUR;0;0;-295;-147.5;0.5
0;KZ75125EUR2069100105;2016-10-26;-220;-220;-110;75;37.5;EUR;null;null;-295;-147.5;0.5
0;KZ75125EUR2069100105;2016-10-27;-149;-149;-74.5;71;35.5;EUR;null;null;-220;-110;0.5
0;KZ75125EUR2069100105;2016-10-28;-123;-123;-61.5;26;13;EUR;null;null;-149;-74.5;0.5
0;KZ75125EUR2069100105;2016-10-29;-141;-141;-70.5;null;null;EUR;18;9;-123;-61.5;0.5
0;KZ75125EUR2069100105;2016-10-30;-153;-153;-76.5;null;null;EUR;12;6;-141;-70.5;0.5
0;KZ75125EUR2069100105;2016-10-31;-75;-75;-37.5;78;39;EUR;null;null;-153;-76.5;0.5
0;KZ75125EUR2069100105;2016-11-01;-60;-60;-30;15;7.5;EUR;null;null;-75;-37.5;0.5
0;KZ75125EUR2069100105;2016-11-02;-152;-152;-76;null;null;EUR;92;46;-60;-30;0.5
0;KZ75125EUR2069100105;2016-11-03;-227;-227;-113.5;null;null;EUR;75;37.5;-152;-76;0.5
0;KZ75125EUR2069100105;2016-11-04;-295;-295;-147.5;null;null;EUR;68;34;-227;-113.5;0.5
0;KZ75125EUR2069100105;2016-11-05;-234;-234;-117;61;30.5;EUR;null;null;-295;-147.5;0.5
0;KZ75125EUR2069100105;2016-11-06;-227;-227;-113.5;7;3.5;EUR;null;null;-234;-117;0.5
0;KZ75125EUR2069100105;2016-11-07;-246;-246;-123;null;null;EUR;19;9.5;-227;-113.5;0.5
0;KZ75125EUR2069100105;2016-11-08;-179;-179;-89.5;67;33.5;EUR;null;null;-246;-123;0.5
0;KZ75125EUR2069100105;2016-11-09;-226;-226;-113;null;null;EUR;47;23.5;-179;-89.5;0.5
0;KZ75125EUR2069100105;2016-11-10;-317;-317;-158.5;null;null;EUR;91;45.5;-226;-113;0.5
0;KZ75125EUR2069100105;2016-11-11;-223;-223;-111.5;94;47;EUR;null;null;-317;-158.5;0.5
0;KZ75125EUR2069100105;2016-11-12;-263;-263;-131.5;null;null;EUR;40;20;-223;-111.5;0.5
0;KZ75125EUR2069100105;2016-11-13;-292;-292;-146;null;null;EUR;29;14.5;-263;-131.5;0.5
0;KZ75125EUR2069100105;2016-11-14;-235;-235;-117.5;57;28.5;EUR;null;null;-292;-146;0.5
0;KZ75125EUR2069100105;2016-11-15;-149;-149;-74.5;86;43;EUR;null;null;-235;-117.5;0.5
0;KZ75125EUR2069100105;2016-11-16;-168;-168;-84;null;null;EUR;19;9.5;-149;-74.5;0.5
0;KZ75125EUR2069100105;2016-11-17;-222;-222;-111;null;null;EUR;54;27;-168;-84;0.5
0;KZ75125EUR2069100105;2016-11-18;-233;-233;-116.5;null;null;EUR;11;5.5;-222;-111;0.5
0;KZ75125EUR2069100105;2016-11-19;-194;-194;-97;39;19.5;EUR;null;null;-233;-116.5;0.5
0;KZ75125EUR2069100105;2016-11-20;-285;-285;-142.5;null;null;EUR;91;45.5;-194;-97;0.5
0;KZ75125EUR2069100105;2016-11-21;-257;-257;-128.5;28;14;EUR;null;null;-285;-142.5;0.5
0;KZ75125EUR2069100105;2016-11-22;-260;-260;-130;null;null;EUR;3;1.5;-257;-128.5;0.5
0;KZ75125EUR2069100105;2016-11-23;-241;-241;-120.5;19;9.5;EUR;null;null;-260;-130;0.5
0;KZ75125EUR2069100105;2016-11-24;-248;-248;-124;null;null;EUR;7;3.5;-241;-120.5;0.5
0;KZ75125EUR2069100105;2016-11-25;-300;-300;-150;null;null;EUR;52;26;-248;-124;0.5
0;KZ75125EUR2069100105;2016-11-26;-317;-317;-158.5;null;null;EUR;17;8.5;-300;-150;0.5
0;KZ75125EUR2069100105;2016-11-27;-363;-363;-181.5;null;null;EUR;46;23;-317;-158.5;0.5
0;KZ75125EUR2069100105;2016-11-28;-298;-298;-149;65;32.5;EUR;null;null;-363;-181.5;0.5
0;KZ75125EUR2069100105;2016-11-29;-201;-201;-100.5;97;48.5;EUR;null;null;-298;-149;0.5
0;KZ75125EUR2069100105;2016-11-30;-219;-219;-109.5;null;null;EUR;18;9;-201;-100.5;0.5
0;KZ75125EUR2069100105;2016-12-01;-129;-129;-64.5;90;45;EUR;null;null;-219;-109.5;0.5
0;KZ75125EUR2069100105;2016-12-02;-88;-88;-44;41;20.5;EUR;null;null;-129;-64.5;0.5
0;KZ75125EUR2069100105;2016-12-03;-101;-101;-50.5;null;null;EUR;13;6.5;-88;-44;0.5
0;KZ75125EUR2069100105;2016-12-04;-140;-140;-70;null;null;EUR;39;19.5;-101;-50.5;0.5
0;KZ75125EUR2069100105;2016-12-05;-68;-68;-34;72;36;EUR;null;null;-140;-70;0.5
0;KZ75125EUR2069100105;2016-12-06;-93;-93;-46.5;null;null;EUR;25;12.5;-68;-34;0.5
0;KZ75125EUR2069100105;2016-12-07;-180;-180;-90;null;null;EUR;87;43.5;-93;-46.5;0.5
0;KZ75125EUR2069100105;2016-12-08;-132;-132;-66;48;24;EUR;null;null;-180;-90;0.5
0;KZ75125EUR2069100105;2016-12-09;-171;-171;-85.5;null;null;EUR;39;19.5;-132;-66;0.5
0;KZ75125EUR2069100105;2016-12-10;-182;-182;-91;null;null;EUR;11;5.5;-171;-85.5;0.5
0;KZ75125EUR2069100105;2016-12-11;-120;-120;-60;62;31;EUR;null;null;-182;-91;0.5
0;KZ75125EUR2069100105;2016-12-12;-165;-165;-82.5;null;null;EUR;45;22.5;-120;-60;0.5
0;KZ75125EUR2069100105;2016-12-13;-183;-183;-91.5;null;null;EUR;18;9;-165;-82.5;0.5
0;KZ75125EUR2069100105;2016-12-14;-136;-136;-68;47;23.5;EUR;null;null;-183;-91.5;0.5
0;KZ75125EUR2069100105;2016-12-15;-158;-158;-79;null;null;EUR;22;11;-136;-68;0.5
0;KZ75125EUR2069100105;2016-12-16;-249;-249;-124.5;null;null;EUR;91;45.5;-158;-79;0.5
0;KZ75125EUR2069100105;2016-12-17;-234;-234;-117;15;7.5;EUR;null;null;-249;-124.5;0.5
0;KZ75125EUR2069100105;2016-12-18;-259;-259;-129.5;null;null;EUR;25;12.5;-234;-117;0.5
0;KZ75125EUR2069100105;2016-12-19;-299;-299;-149.5;null;null;EUR;40;20;-259;-129.5;0.5
0;KZ75125EUR2069100105;2016-12-20;-356;-356;-178;null;null;EUR;57;28.5;-299;-149.5;0.5
0;KZ75125EUR2069100105;2016-12-21;-338;-338;-169;18;9;EUR;null;null;-356;-178;0.5
0;KZ75125EUR2069100105;2016-12-22;-311;-311;-155.5;27;13.5;EUR;null;null;-338;-169;0.5
0;KZ75125EUR2069100105;2016-12-23;-367;-367;-183.5;null;null;EUR;56;28;-311;-155.5;0.5
0;KZ75125EUR2069100105;2016-12-24;-372;-372;-186;null;null;EUR;5;2.5;-367;-183.5;0.5
0;KZ75125EUR2069100105;2016-12-25;-364;-364;-182;8;4;EUR;null;null;-372;-186;0.5
0;KZ75125EUR2069100105;2016-12-26;-321;-321;-160.5;43;21.5;EUR;null;null;-364;-182;0.5
0;KZ75125EUR2069100105;2016-12-27;-360;-360;-180;null;null;EUR;39;19.5;-321;-160.5;0.5
0;KZ75125EUR2069100105;2016-12-28;-340;-340;-170;20;10;EUR;null;null;-360;-180;0.5
0;KZ75125EUR2069100105;2016-12-29;-370;-370;-185;null;null;EUR;30;15;-340;-170;0.5
0;KZ75125EUR2069100105;2016-12-30;-448;-448;-224;null;null;EUR;78;39;-370;-185;0.5
0;KZ75125EUR2069100105;2016-12-31;-471;-471;-235.5;null;null;EUR;23;11.5;-448;-224;0.5
0;KZ75125EUR2069100105;2017-01-01;-438;-438;-219;33;16.5;EUR;null;null;-471;-235.5;0.5
0;KZ75125EUR2069100105;2017-01-02;-397;-397;-198.5;41;20.5;EUR;null;null;-438;-219;0.5
0;KZ75125EUR2069100105;2017-01-03;-401;-401;-200.5;null;null;EUR;4;2;-397;-198.5;0.5
0;KZ75125EUR2069100105;2017-01-04;-477;-477;-238.5;null;null;EUR;76;38;-401;-200.5;0.5
0;KZ75125EUR2069100105;2017-01-05;-477;-477;-238.5;null;null;EUR;0;0;-477;-238.5;0.5
0;KZ75125EUR2069100105;2017-01-06;-452;-452;-226;25;12.5;EUR;null;null;-477;-238.5;0.5
0;KZ75125EUR2069100105;2017-01-07;-391;-391;-195.5;61;30.5;EUR;null;null;-452;-226;0.5
0;KZ75125EUR2069100105;2017-01-08;-481;-481;-240.5;null;null;EUR;90;45;-391;-195.5;0.5
0;KZ75125EUR2069100105;2017-01-09;-416;-416;-208;65;32.5;EUR;null;null;-481;-240.5;0.5
0;KZ75125EUR2069100105;2017-01-10;-387;-387;-193.5;29;14.5;EUR;null;null;-416;-208;0.5
0;KZ75125EUR2069100105;2017-01-11;-340;-340;-170;47;23.5;EUR;null;null;-387;-193.5;0.5
0;KZ75125EUR2069100105;2017-01-12;-331;-331;-165.5;9;4.5;EUR;null;null;-340;-170;0.5
0;KZ75125EUR2069100105;2017-01-13;-272;-272;-136;59;29.5;EUR;null;null;-331;-165.5;0.5
0;KZ75125EUR2069100105;2017-01-14;-173;-173;-86.5;99;49.5;EUR;null;null;-272;-136;0.5
0;KZ75125EUR2069100105;2017-01-15;-144;-144;-72;29;14.5;EUR;null;null;-173;-86.5;0.5
0;KZ75125EUR2069100105;2017-01-16;-161;-161;-80.5;null;null;EUR;17;8.5;-144;-72;0.5
0;KZ75125EUR2069100105;2017-01-17;-64;-64;-32;97;48.5;EUR;null;null;-161;-80.5;0.5
0;KZ75125EUR2069100105;2017-01-18;-31;-31;-15.5;33;16.5;EUR;null;null;-64;-32;0.5
0;KZ75125EUR2069100105;2017-01-19;-80;-80;-40;null;null;EUR;49;24.5;-31;-15.5;0.5
0;KZ75125EUR2069100105;2017-01-20;-73;-73;-36.5;7;3.5;EUR;null;null;-80;-40;0.5
0;KZ75125EUR2069100105;2017-01-21;-123;-123;-61.5;null;null;EUR;50;25;-73;-36.5;0.5
0;KZ75125EUR2069100105;2017-01-22;-144;-144;-72;null;null;EUR;21;10.5;-123;-61.5;0.5
0;KZ75125EUR2069100105;2017-01-23;-155;-155;-77.5;null;null;EUR;11;5.5;-144;-72;0.5
0;KZ75125EUR2069100105;2017-01-24;-96;-96;-48;59;29.5;EUR;null;null;-155;-77.5;0.5
0;KZ75125EUR2069100105;2017-01-25;-74;-74;-37;22;11;EUR;null;null;-96;-48;0.5
0;KZ75125EUR2069100105;2017-01-26;11;11;5.5;85;42.5;EUR;null;null;-74;-37;0.5
0;KZ75125EUR2069100105;2017-01-27;56;56;28;45;22.5;EUR;null;null;11;5.5;0.5
0;KZ75125EUR2069100105;2017-01-28;118;118;59;62;31;EUR;null;null;56;28;0.5
0;KZ75125EUR2069100105;2017-01-29;57;57;28.5;null;null;EUR;61;30.5;118;59;0.5
0;KZ75125EUR2069100105;2017-01-30;-40;-40;-20;null;null;EUR;97;48.5;57;28.5;0.5
0;KZ75125EUR2069100105;2017-01-31;12;12;6;52;26;EUR;null;null;-40;-20;0.5
0;KZ75125EUR2069100105;2017-02-01;37;37;18.5;25;12.5;EUR;null;null;12;6;0.5
0;KZ75125EUR2069100105;2017-02-02;110;110;55;73;36.5;EUR;null;null;37;18.5;0.5
0;KZ75125EUR2069100105;2017-02-03;120;120;60;10;5;EUR;null;null;110;55;0.5
0;KZ75125EUR2069100105;2017-02-04;131;131;65.5;11;5.5;EUR;null;null;120;60;0.5
0;KZ75125EUR2069100105;2017-02-05;181;181;90.5;50;25;EUR;null;null;131;65.5;0.5
0;KZ75125EUR2069100105;2017-02-06;248;248;124;67;33.5;EUR;null;null;181;90.5;0.5
0;KZ75125EUR2069100105;2017-02-07;205;205;102.5;null;null;EUR;43;21.5;248;124;0.5
0;KZ75125EUR2069100105;2017-02-08;161;161;80.5;null;null;EUR;44;22;205;102.5;0.5
0;KZ75125EUR2069100105;2017-02-09;119;119;59.5;null;null;EUR;42;21;161;80.5;0.5
0;KZ75125EUR2069100105;2017-02-10;65;65;32.5;null;null;EUR;54;27;119;59.5;0.5
0;KZ75125EUR2069100105;2017-02-11;27;27;13.5;null;null;EUR;38;19;65;32.5;0.5
0;KZ75125EUR2069100105;2017-02-12;117;117;58.5;90;45;EUR;null;null;27;13.5;0.5
0;KZ75125EUR2069100105;2017-02-13;207;207;103.5;90;45;EUR;null;null;117;58.5;0.5
0;KZ75125EUR2069100105;2017-02-14;191;191;95.5;null;null;EUR;16;8;207;103.5;0.5
0;KZ75125EUR2069100105;2017-02-15;141;141;70.5;null;null;EUR;50;25;191;95.5;0.5
0;KZ75125EUR2069100105;2017-02-16;83;83;41.5;null;null;EUR;58;29;141;70.5;0.5
0;KZ75125EUR2069100105;2017-02-17;163;163;81.5;80;40;EUR;null;null;83;41.5;0.5
0;KZ75125EUR2069100105;2017-02-18;133;133;66.5;null;null;EUR;30;15;163;81.5;0.5
0;KZ75125EUR2069100105;2017-02-19;200;200;100;67;33.5;EUR;null;null;133;66.5;0.5
0;KZ75125EUR2069100105;2017-02-20;227;227;113.5;27;13.5;EUR;null;null;200;100;0.5
0;KZ75125EUR2069100105;2017-02-21;188;188;94;null;null;EUR;39;19.5;227;113.5;0.5
0;KZ75125EUR2069100105;2017-02-22;242;242;121;54;27;EUR;null;null;188;94;0.5
0;KZ75125EUR2069100105;2017-02-23;323;323;161.5;81;40.5;EUR;null;null;242;121;0.5
0;KZ75125EUR2069100105;2017-02-24;357;357;178.5;34;17;EUR;null;null;323;161.5;0.5
0;KZ75125EUR2069100105;2017-02-25;332;332;166;null;null;EUR;25;12.5;357;178.5;0.5
0;KZ75125EUR2069100105;2017-02-26;291;291;145.5;null;null;EUR;41;20.5;332;166;0.5
0;KZ75125EUR2069100105;2017-02-27;303;303;151.5;12;6;EUR;null;null;291;145.5;0.5
0;KZ75125EUR2069100105;2017-02-28;326;326;163;23;11.5;EUR;null;null;303;151.5;0.5
0;KZ75125EUR2069100105;2017-03-01;316;316;158;null;null;EUR;10;5;326;163;0.5
0;KZ75125EUR2069100105;2017-03-02;238;238;119;null;null;EUR;78;39;316;158;0.5
0;KZ75125EUR2069100105;2017-03-03;207;207;103.5;null;null;EUR;31;15.5;238;119;0.5
0;KZ75125EUR2069100105;2017-03-04;112;112;56;null;null;EUR;95;47.5;207;103.5;0.5
0;KZ75125EUR2069100105;2017-03-05;87;87;43.5;null;null;EUR;25;12.5;112;56;0.5
0;KZ75125EUR2069100105;2017-03-06;98;98;49;11;5.5;EUR;null;null;87;43.5;0.5
0;KZ75125EUR2069100105;2017-03-07;153;153;76.5;55;27.5;EUR;null;null;98;49;0.5
0;KZ75125EUR2069100105;2017-03-08;193;193;96.5;40;20;EUR;null;null;153;76.5;0.5
0;KZ75125EUR2069100105;2017-03-09;287;287;143.5;94;47;EUR;null;null;193;96.5;0.5
0;KZ75125EUR2069100105;2017-03-10;374;374;187;87;43.5;EUR;null;null;287;143.5;0.5
0;KZ75125EUR2069100105;2017-03-11;401;401;200.5;27;13.5;EUR;null;null;374;187;0.5
0;KZ75125EUR2069100105;2017-03-12;410;410;205;9;4.5;EUR;null;null;401;200.5;0.5
0;KZ75125EUR2069100105;2017-03-13;328;328;164;null;null;EUR;82;41;410;205;0.5
0;KZ75125EUR2069100105;2017-03-14;332;332;166;4;2;EUR;null;null;328;164;0.5
0;KZ75125EUR2069100105;2017-03-15;331;331;165.5;null;null;EUR;1;0.5;332;166;0.5
0;KZ75125EUR2069100105;2017-03-16;378;378;189;47;23.5;EUR;null;null;331;165.5;0.5
0;KZ75125EUR2069100105;2017-03-17;429;429;214.5;51;25.5;EUR;null;null;378;189;0.5
0;KZ75125EUR2069100105;2017-03-18;429;429;214.5;null;null;EUR;0;0;429;214.5;0.5
0;KZ75125EUR2069100105;2017-03-19;516;516;258;87;43.5;EUR;null;null;429;214.5;0.5
0;KZ75125EUR2069100105;2017-03-20;426;426;213;null;null;EUR;90;45;516;258;0.5
0;KZ75125EUR2069100105;2017-03-21;496;496;248;70;35;EUR;null;null;426;213;0.5
0;KZ75125EUR2069100105;2017-03-22;434;434;217;null;null;EUR;62;31;496;248;0.5
0;KZ75125EUR2069100105;2017-03-23;346;346;173;null;null;EUR;88;44;434;217;0.5
0;KZ75125EUR2069100105;2017-03-24;400;400;200;54;27;EUR;null;null;346;173;0.5
0;KZ75125EUR2069100105;2017-03-25;346;346;173;null;null;EUR;54;27;400;200;0.5
0;KZ75125EUR2069100105;2017-03-26;270;270;135;null;null;EUR;76;38;346;173;0.5
0;KZ75125EUR2069100105;2017-03-27;198;198;99;null;null;EUR;72;36;270;135;0.5
0;KZ75125EUR2069100105;2017-03-28;137;137;68.5;null;null;EUR;61;30.5;198;99;0.5
0;KZ75125EUR2069100105;2017-03-29;45;45;22.5;null;null;EUR;92;46;137;68.5;0.5
0;KZ75125EUR2069100105;2017-03-30;25;25;12.5;null;null;EUR;20;10;45;22.5;0.5
0;KZ75125EUR2069100105;2017-03-31;59;59;29.5;34;17;EUR;null;null;25;12.5;0.5
0;KZ75125EUR2069100105;2017-04-01;79;79;39.5;20;10;EUR;null;null;59;29.5;0.5
0;KZ75125EUR2069100105;2017-04-02;82;82;41;3;1.5;EUR;null;null;79;39.5;0.5
0;KZ75125EUR2069100105;2017-04-03;59;59;29.5;null;null;EUR;23;11.5;82;41;0.5
0;KZ75125EUR2069100105;2017-04-04;-26;-26;-13;null;null;EUR;85;42.5;59;29.5;0.5
0;KZ75125EUR2069100105;2017-04-05;10;10;5;36;18;EUR;null;null;-26;-13;0.5
0;KZ75125EUR2069100105;2017-04-06;66;66;33;56;28;EUR;null;null;10;5;0.5
0;KZ75125EUR2069100105;2017-04-07;147;147;73.5;81;40.5;EUR;null;null;66;33;0.5
0;KZ75125EUR2069100105;2017-04-08;93;93;46.5;null;null;EUR;54;27;147;73.5;0.5
0;KZ75125EUR2069100105;2017-04-09;70;70;35;null;null;EUR;23;11.5;93;46.5;0.5
0;KZ75125EUR2069100105;2017-04-10;124;124;62;54;27;EUR;null;null;70;35;0.5
0;KZ75125EUR2069100105;2017-04-11;30;30;15;null;null;EUR;94;47;124;62;0.5
0;KZ75125EUR2069100105;2017-04-12;-26;-26;-13;null;null;EUR;56;28;30;15;0.5
0;KZ75125EUR2069100105;2017-04-13;-15;-15;-7.5;11;5.5;EUR;null;null;-26;-13;0.5
0;KZ75125EUR2069100105;2017-04-14;-19;-19;-9.5;null;null;EUR;4;2;-15;-7.5;0.5
0;KZ75125EUR2069100105;2017-04-15;74;74;37;93;46.5;EUR;null;null;-19;-9.5;0.5
0;KZ75125EUR2069100105;2017-04-16;12;12;6;null;null;EUR;62;31;74;37;0.5
0;KZ75125EUR2069100105;2017-04-17;-28;-28;-14;null;null;EUR;40;20;12;6;0.5
0;KZ75125EUR2069100105;2017-04-18;-116;-116;-58;null;null;EUR;88;44;-28;-14;0.5
0;KZ75125EUR2069100105;2017-04-19;-35;-35;-17.5;81;40.5;EUR;null;null;-116;-58;0.5
0;KZ75125EUR2069100105;2017-04-20;-96;-96;-48;null;null;EUR;61;30.5;-35;-17.5;0.5
0;KZ75125EUR2069100105;2017-04-21;-139;-139;-69.5;null;null;EUR;43;21.5;-96;-48;0.5
0;KZ75125EUR2069100105;2017-04-22;-223;-223;-111.5;null;null;EUR;84;42;-139;-69.5;0.5
0;KZ75125EUR2069100105;2017-04-23;-267;-267;-133.5;null;null;EUR;44;22;-223;-111.5;0.5
0;KZ75125EUR2069100105;2017-04-24;-290;-290;-145;null;null;EUR;23;11.5;-267;-133.5;0.5
0;KZ75125EUR2069100105;2017-04-25;-290;-290;-145;null;null;EUR;0;0;-290;-145;0.5
0;KZ75125EUR2069100105;2017-04-26;-258;-258;-129;32;16;EUR;null;null;-290;-145;0.5
0;KZ75125EUR2069100105;2017-04-27;-258;-258;-129;null;null;EUR;0;0;-258;-129;0.5
0;KZ75125EUR2069100105;2017-04-28;-230;-230;-115;28;14;EUR;null;null;-258;-129;0.5
0;KZ75125EUR2069100105;2017-04-29;-251;-251;-125.5;null;null;EUR;21;10.5;-230;-115;0.5
0;KZ75125EUR2069100105;2017-04-30;-233;-233;-116.5;18;9;EUR;null;null;-251;-125.5;0.5
0;KZ75125EUR2069100105;2017-05-01;-233;-233;-116.5;null;null;EUR;0;0;-233;-116.5;0.5
0;KZ75125EUR2069100105;2017-05-02;-149;-149;-74.5;84;42;EUR;null;null;-233;-116.5;0.5
0;KZ75125EUR2069100105;2017-05-03;-102;-102;-51;47;23.5;EUR;null;null;-149;-74.5;0.5
0;KZ75125EUR2069100105;2017-05-04;-54;-54;-27;48;24;EUR;null;null;-102;-51;0.5
0;KZ75125EUR2069100105;2017-05-05;-2;-2;-1;52;26;EUR;null;null;-54;-27;0.5
0;KZ75125EUR2069100105;2017-05-06;-40;-40;-20;null;null;EUR;38;19;-2;-1;0.5
0;KZ75125EUR2069100105;2017-05-07;11;11;5.5;51;25.5;EUR;null;null;-40;-20;0.5
0;KZ75125EUR2069100105;2017-05-08;3;3;1.5;null;null;EUR;8;4;11;5.5;0.5
0;KZ75125EUR2069100105;2017-05-09;38;38;19;35;17.5;EUR;null;null;3;1.5;0.5
0;KZ75125EUR2069100105;2017-05-10;69;69;34.5;31;15.5;EUR;null;null;38;19;0.5
0;KZ75125EUR2069100105;2017-05-11;42;42;21;null;null;EUR;27;13.5;69;34.5;0.5
0;KZ75125EUR2069100105;2017-05-12;49;49;24.5;7;3.5;EUR;null;null;42;21;0.5
0;KZ75125EUR2069100105;2017-05-13;11;11;5.5;null;null;EUR;38;19;49;24.5;0.5
0;KZ75125EUR2069100105;2017-05-14;-31;-31;-15.5;null;null;EUR;42;21;11;5.5;0.5
0;KZ75125EUR2069100105;2017-05-15;48;48;24;79;39.5;EUR;null;null;-31;-15.5;0.5
0;KZ75125EUR2069100105;2017-05-16;48;48;24;null;null;EUR;0;0;48;24;0.5
0;KZ75125EUR2069100105;2017-05-17;6;6;3;null;null;EUR;42;21;48;24;0.5
0;KZ75125EUR2069100105;2017-05-18;73;73;36.5;67;33.5;EUR;null;null;6;3;0.5
0;KZ75125EUR2069100105;2017-05-19;130;130;65;57;28.5;EUR;null;null;73;36.5;0.5
0;KZ75125EUR2069100105;2017-05-20;168;168;84;38;19;EUR;null;null;130;65;0.5
0;KZ75125EUR2069100105;2017-05-21;114;114;57;null;null;EUR;54;27;168;84;0.5
0;KZ75125EUR2069100105;2017-05-22;179;179;89.5;65;32.5;EUR;null;null;114;57;0.5
0;KZ75125EUR2069100105;2017-05-23;242;242;121;63;31.5;EUR;null;null;179;89.5;0.5
0;KZ75125EUR2069100105;2017-05-24;292;292;146;50;25;EUR;null;null;242;121;0.5
0;KZ75125EUR2069100105;2017-05-25;329;329;164.5;37;18.5;EUR;null;null;292;146;0.5
0;KZ75125EUR2069100105;2017-05-26;416;416;208;87;43.5;EUR;null;null;329;164.5;0.5
0;KZ75125EUR2069100105;2017-05-27;409;409;204.5;null;null;EUR;7;3.5;416;208;0.5
0;KZ75125EUR2069100105;2017-05-28;387;387;193.5;null;null;EUR;22;11;409;204.5;0.5
0;KZ75125EUR2069100105;2017-05-29;295;295;147.5;null;null;EUR;92;46;387;193.5;0.5
0;KZ75125EUR2069100105;2017-05-30;239;239;119.5;null;null;EUR;56;28;295;147.5;0.5
0;KZ75125EUR2069100105;2017-05-31;189;189;94.5;null;null;EUR;50;25;239;119.5;0.5
0;KZ75125EUR2069100105;2017-06-01;174;174;87;null;null;EUR;15;7.5;189;94.5;0.5
0;KZ75125EUR2069100105;2017-06-02;126;126;63;null;null;EUR;48;24;174;87;0.5
0;KZ75125EUR2069100105;2017-06-03;181;181;90.5;55;27.5;EUR;null;null;126;63;0.5
0;KZ75125EUR2069100105;2017-06-04;264;264;132;83;41.5;EUR;null;null;181;90.5;0.5
0;KZ75125EUR2069100105;2017-06-05;217;217;108.5;null;null;EUR;47;23.5;264;132;0.5
0;KZ75125EUR2069100105;2017-06-06;226;226;113;9;4.5;EUR;null;null;217;108.5;0.5
0;KZ75125EUR2069100105;2017-06-07;225;225;112.5;null;null;EUR;1;0.5;226;113;0.5
0;KZ75125EUR2069100105;2017-06-08;207;207;103.5;null;null;EUR;18;9;225;112.5;0.5
0;KZ75125EUR2069100105;2017-06-09;227;227;113.5;20;10;EUR;null;null;207;103.5;0.5
0;KZ75125EUR2069100105;2017-06-10;224;224;112;null;null;EUR;3;1.5;227;113.5;0.5
0;KZ75125EUR2069100105;2017-06-11;201;201;100.5;null;null;EUR;23;11.5;224;112;0.5
0;KZ75125EUR2069100105;2017-06-12;201;201;100.5;null;null;EUR;0;0;201;100.5;0.5


0;KZ75125KZT2069100106;2015-05-11;85;85;85;null;null;KZT;15;15;100;100;1
0;KZ75125KZT2069100106;2015-05-12;110;110;110;25;25;KZT;null;null;85;85;1
0;KZ75125KZT2069100106;2015-05-13;39;39;39;null;null;KZT;71;71;110;110;1
0;KZ75125KZT2069100106;2015-05-14;46;46;46;7;7;KZT;null;null;39;39;1
0;KZ75125KZT2069100106;2015-05-15;73;73;73;27;27;KZT;null;null;46;46;1
0;KZ75125KZT2069100106;2015-05-16;124;124;124;51;51;KZT;null;null;73;73;1
0;KZ75125KZT2069100106;2015-05-17;83;83;83;null;null;KZT;41;41;124;124;1
0;KZ75125KZT2069100106;2015-05-18;165;165;165;82;82;KZT;null;null;83;83;1
0;KZ75125KZT2069100106;2015-05-19;248;248;248;83;83;KZT;null;null;165;165;1
0;KZ75125KZT2069100106;2015-05-20;193;193;193;null;null;KZT;55;55;248;248;1
0;KZ75125KZT2069100106;2015-05-21;286;286;286;93;93;KZT;null;null;193;193;1
0;KZ75125KZT2069100106;2015-05-22;355;355;355;69;69;KZT;null;null;286;286;1
0;KZ75125KZT2069100106;2015-05-23;297;297;297;null;null;KZT;58;58;355;355;1
0;KZ75125KZT2069100106;2015-05-24;334;334;334;37;37;KZT;null;null;297;297;1
0;KZ75125KZT2069100106;2015-05-25;271;271;271;null;null;KZT;63;63;334;334;1
0;KZ75125KZT2069100106;2015-05-26;274;274;274;3;3;KZT;null;null;271;271;1
0;KZ75125KZT2069100106;2015-05-27;283;283;283;9;9;KZT;null;null;274;274;1
0;KZ75125KZT2069100106;2015-05-28;186;186;186;null;null;KZT;97;97;283;283;1
0;KZ75125KZT2069100106;2015-05-29;242;242;242;56;56;KZT;null;null;186;186;1
0;KZ75125KZT2069100106;2015-05-30;281;281;281;39;39;KZT;null;null;242;242;1
0;KZ75125KZT2069100106;2015-05-31;293;293;293;12;12;KZT;null;null;281;281;1
0;KZ75125KZT2069100106;2015-06-01;218;218;218;null;null;KZT;75;75;293;293;1
0;KZ75125KZT2069100106;2015-06-02;120;120;120;null;null;KZT;98;98;218;218;1
0;KZ75125KZT2069100106;2015-06-03;48;48;48;null;null;KZT;72;72;120;120;1
0;KZ75125KZT2069100106;2015-06-04;127;127;127;79;79;KZT;null;null;48;48;1
0;KZ75125KZT2069100106;2015-06-05;154;154;154;27;27;KZT;null;null;127;127;1
0;KZ75125KZT2069100106;2015-06-06;177;177;177;23;23;KZT;null;null;154;154;1
0;KZ75125KZT2069100106;2015-06-07;95;95;95;null;null;KZT;82;82;177;177;1
0;KZ75125KZT2069100106;2015-06-08;84;84;84;null;null;KZT;11;11;95;95;1
0;KZ75125KZT2069100106;2015-06-09;37;37;37;null;null;KZT;47;47;84;84;1
0;KZ75125KZT2069100106;2015-06-10;-38;-38;-38;null;null;KZT;75;75;37;37;1
0;KZ75125KZT2069100106;2015-06-11;32;32;32;70;70;KZT;null;null;-38;-38;1
0;KZ75125KZT2069100106;2015-06-12;108;108;108;76;76;KZT;null;null;32;32;1
0;KZ75125KZT2069100106;2015-06-13;79;79;79;null;null;KZT;29;29;108;108;1
0;KZ75125KZT2069100106;2015-06-14;102;102;102;23;23;KZT;null;null;79;79;1
0;KZ75125KZT2069100106;2015-06-15;159;159;159;57;57;KZT;null;null;102;102;1
0;KZ75125KZT2069100106;2015-06-16;176;176;176;17;17;KZT;null;null;159;159;1
0;KZ75125KZT2069100106;2015-06-17;173;173;173;null;null;KZT;3;3;176;176;1
0;KZ75125KZT2069100106;2015-06-18;267;267;267;94;94;KZT;null;null;173;173;1
0;KZ75125KZT2069100106;2015-06-19;334;334;334;67;67;KZT;null;null;267;267;1
0;KZ75125KZT2069100106;2015-06-20;285;285;285;null;null;KZT;49;49;334;334;1
0;KZ75125KZT2069100106;2015-06-21;292;292;292;7;7;KZT;null;null;285;285;1
0;KZ75125KZT2069100106;2015-06-22;362;362;362;70;70;KZT;null;null;292;292;1
0;KZ75125KZT2069100106;2015-06-23;400;400;400;38;38;KZT;null;null;362;362;1
0;KZ75125KZT2069100106;2015-06-24;496;496;496;96;96;KZT;null;null;400;400;1
0;KZ75125KZT2069100106;2015-06-25;561;561;561;65;65;KZT;null;null;496;496;1
0;KZ75125KZT2069100106;2015-06-26;538;538;538;null;null;KZT;23;23;561;561;1
0;KZ75125KZT2069100106;2015-06-27;529;529;529;null;null;KZT;9;9;538;538;1
0;KZ75125KZT2069100106;2015-06-28;603;603;603;74;74;KZT;null;null;529;529;1
0;KZ75125KZT2069100106;2015-06-29;586;586;586;null;null;KZT;17;17;603;603;1
0;KZ75125KZT2069100106;2015-06-30;595;595;595;9;9;KZT;null;null;586;586;1
0;KZ75125KZT2069100106;2015-07-01;543;543;543;null;null;KZT;52;52;595;595;1
0;KZ75125KZT2069100106;2015-07-02;464;464;464;null;null;KZT;79;79;543;543;1
0;KZ75125KZT2069100106;2015-07-03;415;415;415;null;null;KZT;49;49;464;464;1
0;KZ75125KZT2069100106;2015-07-04;423;423;423;8;8;KZT;null;null;415;415;1
0;KZ75125KZT2069100106;2015-07-05;325;325;325;null;null;KZT;98;98;423;423;1
0;KZ75125KZT2069100106;2015-07-06;357;357;357;32;32;KZT;null;null;325;325;1
0;KZ75125KZT2069100106;2015-07-07;437;437;437;80;80;KZT;null;null;357;357;1
0;KZ75125KZT2069100106;2015-07-08;475;475;475;38;38;KZT;null;null;437;437;1
0;KZ75125KZT2069100106;2015-07-09;567;567;567;92;92;KZT;null;null;475;475;1
0;KZ75125KZT2069100106;2015-07-10;643;643;643;76;76;KZT;null;null;567;567;1
0;KZ75125KZT2069100106;2015-07-11;548;548;548;null;null;KZT;95;95;643;643;1
0;KZ75125KZT2069100106;2015-07-12;476;476;476;null;null;KZT;72;72;548;548;1
0;KZ75125KZT2069100106;2015-07-13;562;562;562;86;86;KZT;null;null;476;476;1
0;KZ75125KZT2069100106;2015-07-14;565;565;565;3;3;KZT;null;null;562;562;1
0;KZ75125KZT2069100106;2015-07-15;569;569;569;4;4;KZT;null;null;565;565;1
0;KZ75125KZT2069100106;2015-07-16;648;648;648;79;79;KZT;null;null;569;569;1
0;KZ75125KZT2069100106;2015-07-17;652;652;652;4;4;KZT;null;null;648;648;1
0;KZ75125KZT2069100106;2015-07-18;596;596;596;null;null;KZT;56;56;652;652;1
0;KZ75125KZT2069100106;2015-07-19;686;686;686;90;90;KZT;null;null;596;596;1
0;KZ75125KZT2069100106;2015-07-20;649;649;649;null;null;KZT;37;37;686;686;1
0;KZ75125KZT2069100106;2015-07-21;610;610;610;null;null;KZT;39;39;649;649;1
0;KZ75125KZT2069100106;2015-07-22;638;638;638;28;28;KZT;null;null;610;610;1
0;KZ75125KZT2069100106;2015-07-23;669;669;669;31;31;KZT;null;null;638;638;1
0;KZ75125KZT2069100106;2015-07-24;755;755;755;86;86;KZT;null;null;669;669;1
0;KZ75125KZT2069100106;2015-07-25;810;810;810;55;55;KZT;null;null;755;755;1
0;KZ75125KZT2069100106;2015-07-26;729;729;729;null;null;KZT;81;81;810;810;1
0;KZ75125KZT2069100106;2015-07-27;694;694;694;null;null;KZT;35;35;729;729;1
0;KZ75125KZT2069100106;2015-07-28;672;672;672;null;null;KZT;22;22;694;694;1
0;KZ75125KZT2069100106;2015-07-29;759;759;759;87;87;KZT;null;null;672;672;1
0;KZ75125KZT2069100106;2015-07-30;682;682;682;null;null;KZT;77;77;759;759;1
0;KZ75125KZT2069100106;2015-07-31;718;718;718;36;36;KZT;null;null;682;682;1
0;KZ75125KZT2069100106;2015-08-01;700;700;700;null;null;KZT;18;18;718;718;1
0;KZ75125KZT2069100106;2015-08-02;750;750;750;50;50;KZT;null;null;700;700;1
0;KZ75125KZT2069100106;2015-08-03;799;799;799;49;49;KZT;null;null;750;750;1
0;KZ75125KZT2069100106;2015-08-04;833;833;833;34;34;KZT;null;null;799;799;1
0;KZ75125KZT2069100106;2015-08-05;834;834;834;1;1;KZT;null;null;833;833;1
0;KZ75125KZT2069100106;2015-08-06;834;834;834;null;null;KZT;0;0;834;834;1
0;KZ75125KZT2069100106;2015-08-07;840;840;840;6;6;KZT;null;null;834;834;1
0;KZ75125KZT2069100106;2015-08-08;890;890;890;50;50;KZT;null;null;840;840;1
0;KZ75125KZT2069100106;2015-08-09;884;884;884;null;null;KZT;6;6;890;890;1
0;KZ75125KZT2069100106;2015-08-10;897;897;897;13;13;KZT;null;null;884;884;1
0;KZ75125KZT2069100106;2015-08-11;888;888;888;null;null;KZT;9;9;897;897;1
0;KZ75125KZT2069100106;2015-08-12;955;955;955;67;67;KZT;null;null;888;888;1
0;KZ75125KZT2069100106;2015-08-13;976;976;976;21;21;KZT;null;null;955;955;1
0;KZ75125KZT2069100106;2015-08-14;943;943;943;null;null;KZT;33;33;976;976;1
0;KZ75125KZT2069100106;2015-08-15;874;874;874;null;null;KZT;69;69;943;943;1
0;KZ75125KZT2069100106;2015-08-16;823;823;823;null;null;KZT;51;51;874;874;1
0;KZ75125KZT2069100106;2015-08-17;824;824;824;1;1;KZT;null;null;823;823;1
0;KZ75125KZT2069100106;2015-08-18;859;859;859;35;35;KZT;null;null;824;824;1
0;KZ75125KZT2069100106;2015-08-19;920;920;920;61;61;KZT;null;null;859;859;1
0;KZ75125KZT2069100106;2015-08-20;990;990;990;70;70;KZT;null;null;920;920;1
0;KZ75125KZT2069100106;2015-08-21;981;981;981;null;null;KZT;9;9;990;990;1
0;KZ75125KZT2069100106;2015-08-22;1080;1080;1080;99;99;KZT;null;null;981;981;1
0;KZ75125KZT2069100106;2015-08-23;1148;1148;1148;68;68;KZT;null;null;1080;1080;1
0;KZ75125KZT2069100106;2015-08-24;1072;1072;1072;null;null;KZT;76;76;1148;1148;1
0;KZ75125KZT2069100106;2015-08-25;1020;1020;1020;null;null;KZT;52;52;1072;1072;1
0;KZ75125KZT2069100106;2015-08-26;1115;1115;1115;95;95;KZT;null;null;1020;1020;1
0;KZ75125KZT2069100106;2015-08-27;1136;1136;1136;21;21;KZT;null;null;1115;1115;1
0;KZ75125KZT2069100106;2015-08-28;1166;1166;1166;30;30;KZT;null;null;1136;1136;1
0;KZ75125KZT2069100106;2015-08-29;1188;1188;1188;22;22;KZT;null;null;1166;1166;1
0;KZ75125KZT2069100106;2015-08-30;1223;1223;1223;35;35;KZT;null;null;1188;1188;1
0;KZ75125KZT2069100106;2015-08-31;1270;1270;1270;47;47;KZT;null;null;1223;1223;1
0;KZ75125KZT2069100106;2015-09-01;1319;1319;1319;49;49;KZT;null;null;1270;1270;1
0;KZ75125KZT2069100106;2015-09-02;1338;1338;1338;19;19;KZT;null;null;1319;1319;1
0;KZ75125KZT2069100106;2015-09-03;1365;1365;1365;27;27;KZT;null;null;1338;1338;1
0;KZ75125KZT2069100106;2015-09-04;1406;1406;1406;41;41;KZT;null;null;1365;1365;1
0;KZ75125KZT2069100106;2015-09-05;1452;1452;1452;46;46;KZT;null;null;1406;1406;1
0;KZ75125KZT2069100106;2015-09-06;1458;1458;1458;6;6;KZT;null;null;1452;1452;1
0;KZ75125KZT2069100106;2015-09-07;1543;1543;1543;85;85;KZT;null;null;1458;1458;1
0;KZ75125KZT2069100106;2015-09-08;1532;1532;1532;null;null;KZT;11;11;1543;1543;1
0;KZ75125KZT2069100106;2015-09-09;1624;1624;1624;92;92;KZT;null;null;1532;1532;1
0;KZ75125KZT2069100106;2015-09-10;1601;1601;1601;null;null;KZT;23;23;1624;1624;1
0;KZ75125KZT2069100106;2015-09-11;1644;1644;1644;43;43;KZT;null;null;1601;1601;1
0;KZ75125KZT2069100106;2015-09-12;1634;1634;1634;null;null;KZT;10;10;1644;1644;1
0;KZ75125KZT2069100106;2015-09-13;1550;1550;1550;null;null;KZT;84;84;1634;1634;1
0;KZ75125KZT2069100106;2015-09-14;1498;1498;1498;null;null;KZT;52;52;1550;1550;1
0;KZ75125KZT2069100106;2015-09-15;1499;1499;1499;1;1;KZT;null;null;1498;1498;1
0;KZ75125KZT2069100106;2015-09-16;1429;1429;1429;null;null;KZT;70;70;1499;1499;1
0;KZ75125KZT2069100106;2015-09-17;1396;1396;1396;null;null;KZT;33;33;1429;1429;1
0;KZ75125KZT2069100106;2015-09-18;1419;1419;1419;23;23;KZT;null;null;1396;1396;1
0;KZ75125KZT2069100106;2015-09-19;1505;1505;1505;86;86;KZT;null;null;1419;1419;1
0;KZ75125KZT2069100106;2015-09-20;1508;1508;1508;3;3;KZT;null;null;1505;1505;1
0;KZ75125KZT2069100106;2015-09-21;1429;1429;1429;null;null;KZT;79;79;1508;1508;1
0;KZ75125KZT2069100106;2015-09-22;1363;1363;1363;null;null;KZT;66;66;1429;1429;1
0;KZ75125KZT2069100106;2015-09-23;1305;1305;1305;null;null;KZT;58;58;1363;1363;1
0;KZ75125KZT2069100106;2015-09-24;1216;1216;1216;null;null;KZT;89;89;1305;1305;1
0;KZ75125KZT2069100106;2015-09-25;1307;1307;1307;91;91;KZT;null;null;1216;1216;1
0;KZ75125KZT2069100106;2015-09-26;1395;1395;1395;88;88;KZT;null;null;1307;1307;1
0;KZ75125KZT2069100106;2015-09-27;1315;1315;1315;null;null;KZT;80;80;1395;1395;1
0;KZ75125KZT2069100106;2015-09-28;1299;1299;1299;null;null;KZT;16;16;1315;1315;1
0;KZ75125KZT2069100106;2015-09-29;1289;1289;1289;null;null;KZT;10;10;1299;1299;1
0;KZ75125KZT2069100106;2015-09-30;1243;1243;1243;null;null;KZT;46;46;1289;1289;1
0;KZ75125KZT2069100106;2015-10-01;1323;1323;1323;80;80;KZT;null;null;1243;1243;1
0;KZ75125KZT2069100106;2015-10-02;1403;1403;1403;80;80;KZT;null;null;1323;1323;1
0;KZ75125KZT2069100106;2015-10-03;1363;1363;1363;null;null;KZT;40;40;1403;1403;1
0;KZ75125KZT2069100106;2015-10-04;1382;1382;1382;19;19;KZT;null;null;1363;1363;1
0;KZ75125KZT2069100106;2015-10-05;1308;1308;1308;null;null;KZT;74;74;1382;1382;1
0;KZ75125KZT2069100106;2015-10-06;1367;1367;1367;59;59;KZT;null;null;1308;1308;1
0;KZ75125KZT2069100106;2015-10-07;1418;1418;1418;51;51;KZT;null;null;1367;1367;1
0;KZ75125KZT2069100106;2015-10-08;1384;1384;1384;null;null;KZT;34;34;1418;1418;1
0;KZ75125KZT2069100106;2015-10-09;1336;1336;1336;null;null;KZT;48;48;1384;1384;1
0;KZ75125KZT2069100106;2015-10-10;1351;1351;1351;15;15;KZT;null;null;1336;1336;1
0;KZ75125KZT2069100106;2015-10-11;1404;1404;1404;53;53;KZT;null;null;1351;1351;1
0;KZ75125KZT2069100106;2015-10-12;1464;1464;1464;60;60;KZT;null;null;1404;1404;1
0;KZ75125KZT2069100106;2015-10-13;1500;1500;1500;36;36;KZT;null;null;1464;1464;1
0;KZ75125KZT2069100106;2015-10-14;1473;1473;1473;null;null;KZT;27;27;1500;1500;1
0;KZ75125KZT2069100106;2015-10-15;1551;1551;1551;78;78;KZT;null;null;1473;1473;1
0;KZ75125KZT2069100106;2015-10-16;1479;1479;1479;null;null;KZT;72;72;1551;1551;1
0;KZ75125KZT2069100106;2015-10-17;1552;1552;1552;73;73;KZT;null;null;1479;1479;1
0;KZ75125KZT2069100106;2015-10-18;1649;1649;1649;97;97;KZT;null;null;1552;1552;1
0;KZ75125KZT2069100106;2015-10-19;1594;1594;1594;null;null;KZT;55;55;1649;1649;1
0;KZ75125KZT2069100106;2015-10-20;1604;1604;1604;10;10;KZT;null;null;1594;1594;1
0;KZ75125KZT2069100106;2015-10-21;1651;1651;1651;47;47;KZT;null;null;1604;1604;1
0;KZ75125KZT2069100106;2015-10-22;1579;1579;1579;null;null;KZT;72;72;1651;1651;1
0;KZ75125KZT2069100106;2015-10-23;1514;1514;1514;null;null;KZT;65;65;1579;1579;1
0;KZ75125KZT2069100106;2015-10-24;1424;1424;1424;null;null;KZT;90;90;1514;1514;1
0;KZ75125KZT2069100106;2015-10-25;1460;1460;1460;36;36;KZT;null;null;1424;1424;1
0;KZ75125KZT2069100106;2015-10-26;1518;1518;1518;58;58;KZT;null;null;1460;1460;1
0;KZ75125KZT2069100106;2015-10-27;1507;1507;1507;null;null;KZT;11;11;1518;1518;1
0;KZ75125KZT2069100106;2015-10-28;1449;1449;1449;null;null;KZT;58;58;1507;1507;1
0;KZ75125KZT2069100106;2015-10-29;1488;1488;1488;39;39;KZT;null;null;1449;1449;1
0;KZ75125KZT2069100106;2015-10-30;1446;1446;1446;null;null;KZT;42;42;1488;1488;1
0;KZ75125KZT2069100106;2015-10-31;1461;1461;1461;15;15;KZT;null;null;1446;1446;1
0;KZ75125KZT2069100106;2015-11-01;1540;1540;1540;79;79;KZT;null;null;1461;1461;1
0;KZ75125KZT2069100106;2015-11-02;1444;1444;1444;null;null;KZT;96;96;1540;1540;1
0;KZ75125KZT2069100106;2015-11-03;1468;1468;1468;24;24;KZT;null;null;1444;1444;1
0;KZ75125KZT2069100106;2015-11-04;1426;1426;1426;null;null;KZT;42;42;1468;1468;1
0;KZ75125KZT2069100106;2015-11-05;1384;1384;1384;null;null;KZT;42;42;1426;1426;1
0;KZ75125KZT2069100106;2015-11-06;1465;1465;1465;81;81;KZT;null;null;1384;1384;1
0;KZ75125KZT2069100106;2015-11-07;1521;1521;1521;56;56;KZT;null;null;1465;1465;1
0;KZ75125KZT2069100106;2015-11-08;1618;1618;1618;97;97;KZT;null;null;1521;1521;1
0;KZ75125KZT2069100106;2015-11-09;1614;1614;1614;null;null;KZT;4;4;1618;1618;1
0;KZ75125KZT2069100106;2015-11-10;1625;1625;1625;11;11;KZT;null;null;1614;1614;1
0;KZ75125KZT2069100106;2015-11-11;1693;1693;1693;68;68;KZT;null;null;1625;1625;1
0;KZ75125KZT2069100106;2015-11-12;1632;1632;1632;null;null;KZT;61;61;1693;1693;1
0;KZ75125KZT2069100106;2015-11-13;1625;1625;1625;null;null;KZT;7;7;1632;1632;1
0;KZ75125KZT2069100106;2015-11-14;1638;1638;1638;13;13;KZT;null;null;1625;1625;1
0;KZ75125KZT2069100106;2015-11-15;1651;1651;1651;13;13;KZT;null;null;1638;1638;1
0;KZ75125KZT2069100106;2015-11-16;1743;1743;1743;92;92;KZT;null;null;1651;1651;1
0;KZ75125KZT2069100106;2015-11-17;1833;1833;1833;90;90;KZT;null;null;1743;1743;1
0;KZ75125KZT2069100106;2015-11-18;1746;1746;1746;null;null;KZT;87;87;1833;1833;1
0;KZ75125KZT2069100106;2015-11-19;1666;1666;1666;null;null;KZT;80;80;1746;1746;1
0;KZ75125KZT2069100106;2015-11-20;1586;1586;1586;null;null;KZT;80;80;1666;1666;1
0;KZ75125KZT2069100106;2015-11-21;1604;1604;1604;18;18;KZT;null;null;1586;1586;1
0;KZ75125KZT2069100106;2015-11-22;1600;1600;1600;null;null;KZT;4;4;1604;1604;1
0;KZ75125KZT2069100106;2015-11-23;1513;1513;1513;null;null;KZT;87;87;1600;1600;1
0;KZ75125KZT2069100106;2015-11-24;1537;1537;1537;24;24;KZT;null;null;1513;1513;1
0;KZ75125KZT2069100106;2015-11-25;1623;1623;1623;86;86;KZT;null;null;1537;1537;1
0;KZ75125KZT2069100106;2015-11-26;1674;1674;1674;51;51;KZT;null;null;1623;1623;1
0;KZ75125KZT2069100106;2015-11-27;1588;1588;1588;null;null;KZT;86;86;1674;1674;1
0;KZ75125KZT2069100106;2015-11-28;1489;1489;1489;null;null;KZT;99;99;1588;1588;1
0;KZ75125KZT2069100106;2015-11-29;1445;1445;1445;null;null;KZT;44;44;1489;1489;1
0;KZ75125KZT2069100106;2015-11-30;1370;1370;1370;null;null;KZT;75;75;1445;1445;1
0;KZ75125KZT2069100106;2015-12-01;1302;1302;1302;null;null;KZT;68;68;1370;1370;1
0;KZ75125KZT2069100106;2015-12-02;1307;1307;1307;5;5;KZT;null;null;1302;1302;1
0;KZ75125KZT2069100106;2015-12-03;1225;1225;1225;null;null;KZT;82;82;1307;1307;1
0;KZ75125KZT2069100106;2015-12-04;1240;1240;1240;15;15;KZT;null;null;1225;1225;1
0;KZ75125KZT2069100106;2015-12-05;1190;1190;1190;null;null;KZT;50;50;1240;1240;1
0;KZ75125KZT2069100106;2015-12-06;1234;1234;1234;44;44;KZT;null;null;1190;1190;1
0;KZ75125KZT2069100106;2015-12-07;1204;1204;1204;null;null;KZT;30;30;1234;1234;1
0;KZ75125KZT2069100106;2015-12-08;1297;1297;1297;93;93;KZT;null;null;1204;1204;1
0;KZ75125KZT2069100106;2015-12-09;1394;1394;1394;97;97;KZT;null;null;1297;1297;1
0;KZ75125KZT2069100106;2015-12-10;1444;1444;1444;50;50;KZT;null;null;1394;1394;1
0;KZ75125KZT2069100106;2015-12-11;1444;1444;1444;null;null;KZT;0;0;1444;1444;1
0;KZ75125KZT2069100106;2015-12-12;1502;1502;1502;58;58;KZT;null;null;1444;1444;1
0;KZ75125KZT2069100106;2015-12-13;1537;1537;1537;35;35;KZT;null;null;1502;1502;1
0;KZ75125KZT2069100106;2015-12-14;1562;1562;1562;25;25;KZT;null;null;1537;1537;1
0;KZ75125KZT2069100106;2015-12-15;1504;1504;1504;null;null;KZT;58;58;1562;1562;1
0;KZ75125KZT2069100106;2015-12-16;1407;1407;1407;null;null;KZT;97;97;1504;1504;1
0;KZ75125KZT2069100106;2015-12-17;1349;1349;1349;null;null;KZT;58;58;1407;1407;1
0;KZ75125KZT2069100106;2015-12-18;1348;1348;1348;null;null;KZT;1;1;1349;1349;1
0;KZ75125KZT2069100106;2015-12-19;1292;1292;1292;null;null;KZT;56;56;1348;1348;1
0;KZ75125KZT2069100106;2015-12-20;1310;1310;1310;18;18;KZT;null;null;1292;1292;1
0;KZ75125KZT2069100106;2015-12-21;1395;1395;1395;85;85;KZT;null;null;1310;1310;1
0;KZ75125KZT2069100106;2015-12-22;1353;1353;1353;null;null;KZT;42;42;1395;1395;1
0;KZ75125KZT2069100106;2015-12-23;1450;1450;1450;97;97;KZT;null;null;1353;1353;1
0;KZ75125KZT2069100106;2015-12-24;1351;1351;1351;null;null;KZT;99;99;1450;1450;1
0;KZ75125KZT2069100106;2015-12-25;1356;1356;1356;5;5;KZT;null;null;1351;1351;1
0;KZ75125KZT2069100106;2015-12-26;1437;1437;1437;81;81;KZT;null;null;1356;1356;1
0;KZ75125KZT2069100106;2015-12-27;1458;1458;1458;21;21;KZT;null;null;1437;1437;1
0;KZ75125KZT2069100106;2015-12-28;1509;1509;1509;51;51;KZT;null;null;1458;1458;1
0;KZ75125KZT2069100106;2015-12-29;1556;1556;1556;47;47;KZT;null;null;1509;1509;1
0;KZ75125KZT2069100106;2015-12-30;1545;1545;1545;null;null;KZT;11;11;1556;1556;1
0;KZ75125KZT2069100106;2015-12-31;1609;1609;1609;64;64;KZT;null;null;1545;1545;1
0;KZ75125KZT2069100106;2016-01-01;1663;1663;1663;54;54;KZT;null;null;1609;1609;1
0;KZ75125KZT2069100106;2016-01-02;1698;1698;1698;35;35;KZT;null;null;1663;1663;1
0;KZ75125KZT2069100106;2016-01-03;1604;1604;1604;null;null;KZT;94;94;1698;1698;1
0;KZ75125KZT2069100106;2016-01-04;1600;1600;1600;null;null;KZT;4;4;1604;1604;1
0;KZ75125KZT2069100106;2016-01-05;1594;1594;1594;null;null;KZT;6;6;1600;1600;1
0;KZ75125KZT2069100106;2016-01-06;1525;1525;1525;null;null;KZT;69;69;1594;1594;1
0;KZ75125KZT2069100106;2016-01-07;1561;1561;1561;36;36;KZT;null;null;1525;1525;1
0;KZ75125KZT2069100106;2016-01-08;1642;1642;1642;81;81;KZT;null;null;1561;1561;1
0;KZ75125KZT2069100106;2016-01-09;1676;1676;1676;34;34;KZT;null;null;1642;1642;1
0;KZ75125KZT2069100106;2016-01-10;1608;1608;1608;null;null;KZT;68;68;1676;1676;1
0;KZ75125KZT2069100106;2016-01-11;1688;1688;1688;80;80;KZT;null;null;1608;1608;1
0;KZ75125KZT2069100106;2016-01-12;1623;1623;1623;null;null;KZT;65;65;1688;1688;1
0;KZ75125KZT2069100106;2016-01-13;1682;1682;1682;59;59;KZT;null;null;1623;1623;1
0;KZ75125KZT2069100106;2016-01-14;1587;1587;1587;null;null;KZT;95;95;1682;1682;1
0;KZ75125KZT2069100106;2016-01-15;1620;1620;1620;33;33;KZT;null;null;1587;1587;1
0;KZ75125KZT2069100106;2016-01-16;1707;1707;1707;87;87;KZT;null;null;1620;1620;1
0;KZ75125KZT2069100106;2016-01-17;1622;1622;1622;null;null;KZT;85;85;1707;1707;1
0;KZ75125KZT2069100106;2016-01-18;1598;1598;1598;null;null;KZT;24;24;1622;1622;1
0;KZ75125KZT2069100106;2016-01-19;1586;1586;1586;null;null;KZT;12;12;1598;1598;1
0;KZ75125KZT2069100106;2016-01-20;1685;1685;1685;99;99;KZT;null;null;1586;1586;1
0;KZ75125KZT2069100106;2016-01-21;1701;1701;1701;16;16;KZT;null;null;1685;1685;1
0;KZ75125KZT2069100106;2016-01-22;1653;1653;1653;null;null;KZT;48;48;1701;1701;1
0;KZ75125KZT2069100106;2016-01-23;1736;1736;1736;83;83;KZT;null;null;1653;1653;1
0;KZ75125KZT2069100106;2016-01-24;1681;1681;1681;null;null;KZT;55;55;1736;1736;1
0;KZ75125KZT2069100106;2016-01-25;1642;1642;1642;null;null;KZT;39;39;1681;1681;1
0;KZ75125KZT2069100106;2016-01-26;1555;1555;1555;null;null;KZT;87;87;1642;1642;1
0;KZ75125KZT2069100106;2016-01-27;1543;1543;1543;null;null;KZT;12;12;1555;1555;1
0;KZ75125KZT2069100106;2016-01-28;1587;1587;1587;44;44;KZT;null;null;1543;1543;1
0;KZ75125KZT2069100106;2016-01-29;1609;1609;1609;22;22;KZT;null;null;1587;1587;1
0;KZ75125KZT2069100106;2016-01-30;1541;1541;1541;null;null;KZT;68;68;1609;1609;1
0;KZ75125KZT2069100106;2016-01-31;1526;1526;1526;null;null;KZT;15;15;1541;1541;1
0;KZ75125KZT2069100106;2016-02-01;1533;1533;1533;7;7;KZT;null;null;1526;1526;1
0;KZ75125KZT2069100106;2016-02-02;1561;1561;1561;28;28;KZT;null;null;1533;1533;1
0;KZ75125KZT2069100106;2016-02-03;1462;1462;1462;null;null;KZT;99;99;1561;1561;1
0;KZ75125KZT2069100106;2016-02-04;1537;1537;1537;75;75;KZT;null;null;1462;1462;1
0;KZ75125KZT2069100106;2016-02-05;1442;1442;1442;null;null;KZT;95;95;1537;1537;1
0;KZ75125KZT2069100106;2016-02-06;1408;1408;1408;null;null;KZT;34;34;1442;1442;1
0;KZ75125KZT2069100106;2016-02-07;1444;1444;1444;36;36;KZT;null;null;1408;1408;1
0;KZ75125KZT2069100106;2016-02-08;1457;1457;1457;13;13;KZT;null;null;1444;1444;1
0;KZ75125KZT2069100106;2016-02-09;1448;1448;1448;null;null;KZT;9;9;1457;1457;1
0;KZ75125KZT2069100106;2016-02-10;1378;1378;1378;null;null;KZT;70;70;1448;1448;1
0;KZ75125KZT2069100106;2016-02-11;1391;1391;1391;13;13;KZT;null;null;1378;1378;1
0;KZ75125KZT2069100106;2016-02-12;1387;1387;1387;null;null;KZT;4;4;1391;1391;1
0;KZ75125KZT2069100106;2016-02-13;1302;1302;1302;null;null;KZT;85;85;1387;1387;1
0;KZ75125KZT2069100106;2016-02-14;1312;1312;1312;10;10;KZT;null;null;1302;1302;1
0;KZ75125KZT2069100106;2016-02-15;1334;1334;1334;22;22;KZT;null;null;1312;1312;1
0;KZ75125KZT2069100106;2016-02-16;1274;1274;1274;null;null;KZT;60;60;1334;1334;1
0;KZ75125KZT2069100106;2016-02-17;1340;1340;1340;66;66;KZT;null;null;1274;1274;1
0;KZ75125KZT2069100106;2016-02-18;1318;1318;1318;null;null;KZT;22;22;1340;1340;1
0;KZ75125KZT2069100106;2016-02-19;1330;1330;1330;12;12;KZT;null;null;1318;1318;1
0;KZ75125KZT2069100106;2016-02-20;1428;1428;1428;98;98;KZT;null;null;1330;1330;1
0;KZ75125KZT2069100106;2016-02-21;1477;1477;1477;49;49;KZT;null;null;1428;1428;1
0;KZ75125KZT2069100106;2016-02-22;1552;1552;1552;75;75;KZT;null;null;1477;1477;1
0;KZ75125KZT2069100106;2016-02-23;1612;1612;1612;60;60;KZT;null;null;1552;1552;1
0;KZ75125KZT2069100106;2016-02-24;1674;1674;1674;62;62;KZT;null;null;1612;1612;1
0;KZ75125KZT2069100106;2016-02-25;1689;1689;1689;15;15;KZT;null;null;1674;1674;1
0;KZ75125KZT2069100106;2016-02-26;1692;1692;1692;3;3;KZT;null;null;1689;1689;1
0;KZ75125KZT2069100106;2016-02-27;1646;1646;1646;null;null;KZT;46;46;1692;1692;1
0;KZ75125KZT2069100106;2016-02-28;1718;1718;1718;72;72;KZT;null;null;1646;1646;1
0;KZ75125KZT2069100106;2016-02-29;1816;1816;1816;98;98;KZT;null;null;1718;1718;1
0;KZ75125KZT2069100106;2016-03-01;1861;1861;1861;45;45;KZT;null;null;1816;1816;1
0;KZ75125KZT2069100106;2016-03-02;1773;1773;1773;null;null;KZT;88;88;1861;1861;1
0;KZ75125KZT2069100106;2016-03-03;1701;1701;1701;null;null;KZT;72;72;1773;1773;1
0;KZ75125KZT2069100106;2016-03-04;1792;1792;1792;91;91;KZT;null;null;1701;1701;1
0;KZ75125KZT2069100106;2016-03-05;1720;1720;1720;null;null;KZT;72;72;1792;1792;1
0;KZ75125KZT2069100106;2016-03-06;1788;1788;1788;68;68;KZT;null;null;1720;1720;1
0;KZ75125KZT2069100106;2016-03-07;1709;1709;1709;null;null;KZT;79;79;1788;1788;1
0;KZ75125KZT2069100106;2016-03-08;1701;1701;1701;null;null;KZT;8;8;1709;1709;1
0;KZ75125KZT2069100106;2016-03-09;1658;1658;1658;null;null;KZT;43;43;1701;1701;1
0;KZ75125KZT2069100106;2016-03-10;1632;1632;1632;null;null;KZT;26;26;1658;1658;1
0;KZ75125KZT2069100106;2016-03-11;1660;1660;1660;28;28;KZT;null;null;1632;1632;1
0;KZ75125KZT2069100106;2016-03-12;1759;1759;1759;99;99;KZT;null;null;1660;1660;1
0;KZ75125KZT2069100106;2016-03-13;1828;1828;1828;69;69;KZT;null;null;1759;1759;1
0;KZ75125KZT2069100106;2016-03-14;1804;1804;1804;null;null;KZT;24;24;1828;1828;1
0;KZ75125KZT2069100106;2016-03-15;1830;1830;1830;26;26;KZT;null;null;1804;1804;1
0;KZ75125KZT2069100106;2016-03-16;1811;1811;1811;null;null;KZT;19;19;1830;1830;1
0;KZ75125KZT2069100106;2016-03-17;1848;1848;1848;37;37;KZT;null;null;1811;1811;1
0;KZ75125KZT2069100106;2016-03-18;1844;1844;1844;null;null;KZT;4;4;1848;1848;1
0;KZ75125KZT2069100106;2016-03-19;1888;1888;1888;44;44;KZT;null;null;1844;1844;1
0;KZ75125KZT2069100106;2016-03-20;1950;1950;1950;62;62;KZT;null;null;1888;1888;1
0;KZ75125KZT2069100106;2016-03-21;1972;1972;1972;22;22;KZT;null;null;1950;1950;1
0;KZ75125KZT2069100106;2016-03-22;1927;1927;1927;null;null;KZT;45;45;1972;1972;1
0;KZ75125KZT2069100106;2016-03-23;1896;1896;1896;null;null;KZT;31;31;1927;1927;1
0;KZ75125KZT2069100106;2016-03-24;1882;1882;1882;null;null;KZT;14;14;1896;1896;1
0;KZ75125KZT2069100106;2016-03-25;1853;1853;1853;null;null;KZT;29;29;1882;1882;1
0;KZ75125KZT2069100106;2016-03-26;1756;1756;1756;null;null;KZT;97;97;1853;1853;1
0;KZ75125KZT2069100106;2016-03-27;1780;1780;1780;24;24;KZT;null;null;1756;1756;1
0;KZ75125KZT2069100106;2016-03-28;1856;1856;1856;76;76;KZT;null;null;1780;1780;1
0;KZ75125KZT2069100106;2016-03-29;1786;1786;1786;null;null;KZT;70;70;1856;1856;1
0;KZ75125KZT2069100106;2016-03-30;1839;1839;1839;53;53;KZT;null;null;1786;1786;1
0;KZ75125KZT2069100106;2016-03-31;1866;1866;1866;27;27;KZT;null;null;1839;1839;1
0;KZ75125KZT2069100106;2016-04-01;1888;1888;1888;22;22;KZT;null;null;1866;1866;1
0;KZ75125KZT2069100106;2016-04-02;1817;1817;1817;null;null;KZT;71;71;1888;1888;1
0;KZ75125KZT2069100106;2016-04-03;1856;1856;1856;39;39;KZT;null;null;1817;1817;1
0;KZ75125KZT2069100106;2016-04-04;1816;1816;1816;null;null;KZT;40;40;1856;1856;1
0;KZ75125KZT2069100106;2016-04-05;1829;1829;1829;13;13;KZT;null;null;1816;1816;1
0;KZ75125KZT2069100106;2016-04-06;1741;1741;1741;null;null;KZT;88;88;1829;1829;1
0;KZ75125KZT2069100106;2016-04-07;1791;1791;1791;50;50;KZT;null;null;1741;1741;1
0;KZ75125KZT2069100106;2016-04-08;1752;1752;1752;null;null;KZT;39;39;1791;1791;1
0;KZ75125KZT2069100106;2016-04-09;1668;1668;1668;null;null;KZT;84;84;1752;1752;1
0;KZ75125KZT2069100106;2016-04-10;1737;1737;1737;69;69;KZT;null;null;1668;1668;1
0;KZ75125KZT2069100106;2016-04-11;1708;1708;1708;null;null;KZT;29;29;1737;1737;1
0;KZ75125KZT2069100106;2016-04-12;1769;1769;1769;61;61;KZT;null;null;1708;1708;1
0;KZ75125KZT2069100106;2016-04-13;1759;1759;1759;null;null;KZT;10;10;1769;1769;1
0;KZ75125KZT2069100106;2016-04-14;1745;1745;1745;null;null;KZT;14;14;1759;1759;1
0;KZ75125KZT2069100106;2016-04-15;1691;1691;1691;null;null;KZT;54;54;1745;1745;1
0;KZ75125KZT2069100106;2016-04-16;1756;1756;1756;65;65;KZT;null;null;1691;1691;1
0;KZ75125KZT2069100106;2016-04-17;1664;1664;1664;null;null;KZT;92;92;1756;1756;1
0;KZ75125KZT2069100106;2016-04-18;1611;1611;1611;null;null;KZT;53;53;1664;1664;1
0;KZ75125KZT2069100106;2016-04-19;1650;1650;1650;39;39;KZT;null;null;1611;1611;1
0;KZ75125KZT2069100106;2016-04-20;1741;1741;1741;91;91;KZT;null;null;1650;1650;1
0;KZ75125KZT2069100106;2016-04-21;1695;1695;1695;null;null;KZT;46;46;1741;1741;1
0;KZ75125KZT2069100106;2016-04-22;1604;1604;1604;null;null;KZT;91;91;1695;1695;1
0;KZ75125KZT2069100106;2016-04-23;1700;1700;1700;96;96;KZT;null;null;1604;1604;1
0;KZ75125KZT2069100106;2016-04-24;1729;1729;1729;29;29;KZT;null;null;1700;1700;1
0;KZ75125KZT2069100106;2016-04-25;1810;1810;1810;81;81;KZT;null;null;1729;1729;1
0;KZ75125KZT2069100106;2016-04-26;1804;1804;1804;null;null;KZT;6;6;1810;1810;1
0;KZ75125KZT2069100106;2016-04-27;1736;1736;1736;null;null;KZT;68;68;1804;1804;1
0;KZ75125KZT2069100106;2016-04-28;1684;1684;1684;null;null;KZT;52;52;1736;1736;1
0;KZ75125KZT2069100106;2016-04-29;1694;1694;1694;10;10;KZT;null;null;1684;1684;1
0;KZ75125KZT2069100106;2016-04-30;1697;1697;1697;3;3;KZT;null;null;1694;1694;1
0;KZ75125KZT2069100106;2016-05-01;1684;1684;1684;null;null;KZT;13;13;1697;1697;1
0;KZ75125KZT2069100106;2016-05-02;1750;1750;1750;66;66;KZT;null;null;1684;1684;1
0;KZ75125KZT2069100106;2016-05-03;1843;1843;1843;93;93;KZT;null;null;1750;1750;1
0;KZ75125KZT2069100106;2016-05-04;1917;1917;1917;74;74;KZT;null;null;1843;1843;1
0;KZ75125KZT2069100106;2016-05-05;1867;1867;1867;null;null;KZT;50;50;1917;1917;1
0;KZ75125KZT2069100106;2016-05-06;1831;1831;1831;null;null;KZT;36;36;1867;1867;1
0;KZ75125KZT2069100106;2016-05-07;1760;1760;1760;null;null;KZT;71;71;1831;1831;1
0;KZ75125KZT2069100106;2016-05-08;1847;1847;1847;87;87;KZT;null;null;1760;1760;1
0;KZ75125KZT2069100106;2016-05-09;1881;1881;1881;34;34;KZT;null;null;1847;1847;1
0;KZ75125KZT2069100106;2016-05-10;1831;1831;1831;null;null;KZT;50;50;1881;1881;1
0;KZ75125KZT2069100106;2016-05-11;1872;1872;1872;41;41;KZT;null;null;1831;1831;1
0;KZ75125KZT2069100106;2016-05-12;1801;1801;1801;null;null;KZT;71;71;1872;1872;1
0;KZ75125KZT2069100106;2016-05-13;1725;1725;1725;null;null;KZT;76;76;1801;1801;1
0;KZ75125KZT2069100106;2016-05-14;1744;1744;1744;19;19;KZT;null;null;1725;1725;1
0;KZ75125KZT2069100106;2016-05-15;1702;1702;1702;null;null;KZT;42;42;1744;1744;1
0;KZ75125KZT2069100106;2016-05-16;1766;1766;1766;64;64;KZT;null;null;1702;1702;1
0;KZ75125KZT2069100106;2016-05-17;1688;1688;1688;null;null;KZT;78;78;1766;1766;1
0;KZ75125KZT2069100106;2016-05-18;1636;1636;1636;null;null;KZT;52;52;1688;1688;1
0;KZ75125KZT2069100106;2016-05-19;1704;1704;1704;68;68;KZT;null;null;1636;1636;1
0;KZ75125KZT2069100106;2016-05-20;1725;1725;1725;21;21;KZT;null;null;1704;1704;1
0;KZ75125KZT2069100106;2016-05-21;1711;1711;1711;null;null;KZT;14;14;1725;1725;1
0;KZ75125KZT2069100106;2016-05-22;1738;1738;1738;27;27;KZT;null;null;1711;1711;1
0;KZ75125KZT2069100106;2016-05-23;1640;1640;1640;null;null;KZT;98;98;1738;1738;1
0;KZ75125KZT2069100106;2016-05-24;1652;1652;1652;12;12;KZT;null;null;1640;1640;1
0;KZ75125KZT2069100106;2016-05-25;1612;1612;1612;null;null;KZT;40;40;1652;1652;1
0;KZ75125KZT2069100106;2016-05-26;1566;1566;1566;null;null;KZT;46;46;1612;1612;1
0;KZ75125KZT2069100106;2016-05-27;1574;1574;1574;8;8;KZT;null;null;1566;1566;1
0;KZ75125KZT2069100106;2016-05-28;1497;1497;1497;null;null;KZT;77;77;1574;1574;1
0;KZ75125KZT2069100106;2016-05-29;1529;1529;1529;32;32;KZT;null;null;1497;1497;1
0;KZ75125KZT2069100106;2016-05-30;1514;1514;1514;null;null;KZT;15;15;1529;1529;1
0;KZ75125KZT2069100106;2016-05-31;1586;1586;1586;72;72;KZT;null;null;1514;1514;1
0;KZ75125KZT2069100106;2016-06-01;1588;1588;1588;2;2;KZT;null;null;1586;1586;1
0;KZ75125KZT2069100106;2016-06-02;1666;1666;1666;78;78;KZT;null;null;1588;1588;1
0;KZ75125KZT2069100106;2016-06-03;1597;1597;1597;null;null;KZT;69;69;1666;1666;1
0;KZ75125KZT2069100106;2016-06-04;1605;1605;1605;8;8;KZT;null;null;1597;1597;1
0;KZ75125KZT2069100106;2016-06-05;1618;1618;1618;13;13;KZT;null;null;1605;1605;1
0;KZ75125KZT2069100106;2016-06-06;1602;1602;1602;null;null;KZT;16;16;1618;1618;1
0;KZ75125KZT2069100106;2016-06-07;1659;1659;1659;57;57;KZT;null;null;1602;1602;1
0;KZ75125KZT2069100106;2016-06-08;1627;1627;1627;null;null;KZT;32;32;1659;1659;1
0;KZ75125KZT2069100106;2016-06-09;1633;1633;1633;6;6;KZT;null;null;1627;1627;1
0;KZ75125KZT2069100106;2016-06-10;1678;1678;1678;45;45;KZT;null;null;1633;1633;1
0;KZ75125KZT2069100106;2016-06-11;1732;1732;1732;54;54;KZT;null;null;1678;1678;1
0;KZ75125KZT2069100106;2016-06-12;1827;1827;1827;95;95;KZT;null;null;1732;1732;1
0;KZ75125KZT2069100106;2016-06-13;1794;1794;1794;null;null;KZT;33;33;1827;1827;1
0;KZ75125KZT2069100106;2016-06-14;1776;1776;1776;null;null;KZT;18;18;1794;1794;1
0;KZ75125KZT2069100106;2016-06-15;1772;1772;1772;null;null;KZT;4;4;1776;1776;1
0;KZ75125KZT2069100106;2016-06-16;1766;1766;1766;null;null;KZT;6;6;1772;1772;1
0;KZ75125KZT2069100106;2016-06-17;1788;1788;1788;22;22;KZT;null;null;1766;1766;1
0;KZ75125KZT2069100106;2016-06-18;1780;1780;1780;null;null;KZT;8;8;1788;1788;1
0;KZ75125KZT2069100106;2016-06-19;1769;1769;1769;null;null;KZT;11;11;1780;1780;1
0;KZ75125KZT2069100106;2016-06-20;1714;1714;1714;null;null;KZT;55;55;1769;1769;1
0;KZ75125KZT2069100106;2016-06-21;1796;1796;1796;82;82;KZT;null;null;1714;1714;1
0;KZ75125KZT2069100106;2016-06-22;1729;1729;1729;null;null;KZT;67;67;1796;1796;1
0;KZ75125KZT2069100106;2016-06-23;1753;1753;1753;24;24;KZT;null;null;1729;1729;1
0;KZ75125KZT2069100106;2016-06-24;1750;1750;1750;null;null;KZT;3;3;1753;1753;1
0;KZ75125KZT2069100106;2016-06-25;1803;1803;1803;53;53;KZT;null;null;1750;1750;1
0;KZ75125KZT2069100106;2016-06-26;1779;1779;1779;null;null;KZT;24;24;1803;1803;1
0;KZ75125KZT2069100106;2016-06-27;1736;1736;1736;null;null;KZT;43;43;1779;1779;1
0;KZ75125KZT2069100106;2016-06-28;1655;1655;1655;null;null;KZT;81;81;1736;1736;1
0;KZ75125KZT2069100106;2016-06-29;1685;1685;1685;30;30;KZT;null;null;1655;1655;1
0;KZ75125KZT2069100106;2016-06-30;1715;1715;1715;30;30;KZT;null;null;1685;1685;1
0;KZ75125KZT2069100106;2016-07-01;1756;1756;1756;41;41;KZT;null;null;1715;1715;1
0;KZ75125KZT2069100106;2016-07-02;1753;1753;1753;null;null;KZT;3;3;1756;1756;1
0;KZ75125KZT2069100106;2016-07-03;1762;1762;1762;9;9;KZT;null;null;1753;1753;1
0;KZ75125KZT2069100106;2016-07-04;1712;1712;1712;null;null;KZT;50;50;1762;1762;1
0;KZ75125KZT2069100106;2016-07-05;1668;1668;1668;null;null;KZT;44;44;1712;1712;1
0;KZ75125KZT2069100106;2016-07-06;1593;1593;1593;null;null;KZT;75;75;1668;1668;1
0;KZ75125KZT2069100106;2016-07-07;1571;1571;1571;null;null;KZT;22;22;1593;1593;1
0;KZ75125KZT2069100106;2016-07-08;1542;1542;1542;null;null;KZT;29;29;1571;1571;1
0;KZ75125KZT2069100106;2016-07-09;1478;1478;1478;null;null;KZT;64;64;1542;1542;1
0;KZ75125KZT2069100106;2016-07-10;1481;1481;1481;3;3;KZT;null;null;1478;1478;1
0;KZ75125KZT2069100106;2016-07-11;1512;1512;1512;31;31;KZT;null;null;1481;1481;1
0;KZ75125KZT2069100106;2016-07-12;1466;1466;1466;null;null;KZT;46;46;1512;1512;1
0;KZ75125KZT2069100106;2016-07-13;1540;1540;1540;74;74;KZT;null;null;1466;1466;1
0;KZ75125KZT2069100106;2016-07-14;1597;1597;1597;57;57;KZT;null;null;1540;1540;1
0;KZ75125KZT2069100106;2016-07-15;1560;1560;1560;null;null;KZT;37;37;1597;1597;1
0;KZ75125KZT2069100106;2016-07-16;1552;1552;1552;null;null;KZT;8;8;1560;1560;1
0;KZ75125KZT2069100106;2016-07-17;1521;1521;1521;null;null;KZT;31;31;1552;1552;1
0;KZ75125KZT2069100106;2016-07-18;1535;1535;1535;14;14;KZT;null;null;1521;1521;1
0;KZ75125KZT2069100106;2016-07-19;1555;1555;1555;20;20;KZT;null;null;1535;1535;1
0;KZ75125KZT2069100106;2016-07-20;1560;1560;1560;5;5;KZT;null;null;1555;1555;1
0;KZ75125KZT2069100106;2016-07-21;1530;1530;1530;null;null;KZT;30;30;1560;1560;1
0;KZ75125KZT2069100106;2016-07-22;1618;1618;1618;88;88;KZT;null;null;1530;1530;1
0;KZ75125KZT2069100106;2016-07-23;1598;1598;1598;null;null;KZT;20;20;1618;1618;1
0;KZ75125KZT2069100106;2016-07-24;1547;1547;1547;null;null;KZT;51;51;1598;1598;1
0;KZ75125KZT2069100106;2016-07-25;1495;1495;1495;null;null;KZT;52;52;1547;1547;1
0;KZ75125KZT2069100106;2016-07-26;1446;1446;1446;null;null;KZT;49;49;1495;1495;1
0;KZ75125KZT2069100106;2016-07-27;1431;1431;1431;null;null;KZT;15;15;1446;1446;1
0;KZ75125KZT2069100106;2016-07-28;1448;1448;1448;17;17;KZT;null;null;1431;1431;1
0;KZ75125KZT2069100106;2016-07-29;1389;1389;1389;null;null;KZT;59;59;1448;1448;1
0;KZ75125KZT2069100106;2016-07-30;1450;1450;1450;61;61;KZT;null;null;1389;1389;1
0;KZ75125KZT2069100106;2016-07-31;1398;1398;1398;null;null;KZT;52;52;1450;1450;1
0;KZ75125KZT2069100106;2016-08-01;1461;1461;1461;63;63;KZT;null;null;1398;1398;1
0;KZ75125KZT2069100106;2016-08-02;1471;1471;1471;10;10;KZT;null;null;1461;1461;1
0;KZ75125KZT2069100106;2016-08-03;1420;1420;1420;null;null;KZT;51;51;1471;1471;1
0;KZ75125KZT2069100106;2016-08-04;1479;1479;1479;59;59;KZT;null;null;1420;1420;1
0;KZ75125KZT2069100106;2016-08-05;1389;1389;1389;null;null;KZT;90;90;1479;1479;1
0;KZ75125KZT2069100106;2016-08-06;1366;1366;1366;null;null;KZT;23;23;1389;1389;1
0;KZ75125KZT2069100106;2016-08-07;1310;1310;1310;null;null;KZT;56;56;1366;1366;1
0;KZ75125KZT2069100106;2016-08-08;1236;1236;1236;null;null;KZT;74;74;1310;1310;1
0;KZ75125KZT2069100106;2016-08-09;1291;1291;1291;55;55;KZT;null;null;1236;1236;1
0;KZ75125KZT2069100106;2016-08-10;1350;1350;1350;59;59;KZT;null;null;1291;1291;1
0;KZ75125KZT2069100106;2016-08-11;1423;1423;1423;73;73;KZT;null;null;1350;1350;1
0;KZ75125KZT2069100106;2016-08-12;1357;1357;1357;null;null;KZT;66;66;1423;1423;1
0;KZ75125KZT2069100106;2016-08-13;1291;1291;1291;null;null;KZT;66;66;1357;1357;1
0;KZ75125KZT2069100106;2016-08-14;1207;1207;1207;null;null;KZT;84;84;1291;1291;1
0;KZ75125KZT2069100106;2016-08-15;1124;1124;1124;null;null;KZT;83;83;1207;1207;1
0;KZ75125KZT2069100106;2016-08-16;1153;1153;1153;29;29;KZT;null;null;1124;1124;1
0;KZ75125KZT2069100106;2016-08-17;1137;1137;1137;null;null;KZT;16;16;1153;1153;1
0;KZ75125KZT2069100106;2016-08-18;1098;1098;1098;null;null;KZT;39;39;1137;1137;1
0;KZ75125KZT2069100106;2016-08-19;1040;1040;1040;null;null;KZT;58;58;1098;1098;1
0;KZ75125KZT2069100106;2016-08-20;1078;1078;1078;38;38;KZT;null;null;1040;1040;1
0;KZ75125KZT2069100106;2016-08-21;1174;1174;1174;96;96;KZT;null;null;1078;1078;1
0;KZ75125KZT2069100106;2016-08-22;1146;1146;1146;null;null;KZT;28;28;1174;1174;1
0;KZ75125KZT2069100106;2016-08-23;1085;1085;1085;null;null;KZT;61;61;1146;1146;1
0;KZ75125KZT2069100106;2016-08-24;1032;1032;1032;null;null;KZT;53;53;1085;1085;1
0;KZ75125KZT2069100106;2016-08-25;1053;1053;1053;21;21;KZT;null;null;1032;1032;1
0;KZ75125KZT2069100106;2016-08-26;1119;1119;1119;66;66;KZT;null;null;1053;1053;1
0;KZ75125KZT2069100106;2016-08-27;1159;1159;1159;40;40;KZT;null;null;1119;1119;1
0;KZ75125KZT2069100106;2016-08-28;1075;1075;1075;null;null;KZT;84;84;1159;1159;1
0;KZ75125KZT2069100106;2016-08-29;1064;1064;1064;null;null;KZT;11;11;1075;1075;1
0;KZ75125KZT2069100106;2016-08-30;1157;1157;1157;93;93;KZT;null;null;1064;1064;1
0;KZ75125KZT2069100106;2016-08-31;1219;1219;1219;62;62;KZT;null;null;1157;1157;1
0;KZ75125KZT2069100106;2016-09-01;1201;1201;1201;null;null;KZT;18;18;1219;1219;1
0;KZ75125KZT2069100106;2016-09-02;1193;1193;1193;null;null;KZT;8;8;1201;1201;1
0;KZ75125KZT2069100106;2016-09-03;1238;1238;1238;45;45;KZT;null;null;1193;1193;1
0;KZ75125KZT2069100106;2016-09-04;1177;1177;1177;null;null;KZT;61;61;1238;1238;1
0;KZ75125KZT2069100106;2016-09-05;1207;1207;1207;30;30;KZT;null;null;1177;1177;1
0;KZ75125KZT2069100106;2016-09-06;1212;1212;1212;5;5;KZT;null;null;1207;1207;1
0;KZ75125KZT2069100106;2016-09-07;1304;1304;1304;92;92;KZT;null;null;1212;1212;1
0;KZ75125KZT2069100106;2016-09-08;1354;1354;1354;50;50;KZT;null;null;1304;1304;1
0;KZ75125KZT2069100106;2016-09-09;1370;1370;1370;16;16;KZT;null;null;1354;1354;1
0;KZ75125KZT2069100106;2016-09-10;1344;1344;1344;null;null;KZT;26;26;1370;1370;1
0;KZ75125KZT2069100106;2016-09-11;1442;1442;1442;98;98;KZT;null;null;1344;1344;1
0;KZ75125KZT2069100106;2016-09-12;1484;1484;1484;42;42;KZT;null;null;1442;1442;1
0;KZ75125KZT2069100106;2016-09-13;1443;1443;1443;null;null;KZT;41;41;1484;1484;1
0;KZ75125KZT2069100106;2016-09-14;1416;1416;1416;null;null;KZT;27;27;1443;1443;1
0;KZ75125KZT2069100106;2016-09-15;1327;1327;1327;null;null;KZT;89;89;1416;1416;1
0;KZ75125KZT2069100106;2016-09-16;1393;1393;1393;66;66;KZT;null;null;1327;1327;1
0;KZ75125KZT2069100106;2016-09-17;1447;1447;1447;54;54;KZT;null;null;1393;1393;1
0;KZ75125KZT2069100106;2016-09-18;1362;1362;1362;null;null;KZT;85;85;1447;1447;1
0;KZ75125KZT2069100106;2016-09-19;1402;1402;1402;40;40;KZT;null;null;1362;1362;1
0;KZ75125KZT2069100106;2016-09-20;1432;1432;1432;30;30;KZT;null;null;1402;1402;1
0;KZ75125KZT2069100106;2016-09-21;1524;1524;1524;92;92;KZT;null;null;1432;1432;1
0;KZ75125KZT2069100106;2016-09-22;1574;1574;1574;50;50;KZT;null;null;1524;1524;1
0;KZ75125KZT2069100106;2016-09-23;1636;1636;1636;62;62;KZT;null;null;1574;1574;1
0;KZ75125KZT2069100106;2016-09-24;1709;1709;1709;73;73;KZT;null;null;1636;1636;1
0;KZ75125KZT2069100106;2016-09-25;1713;1713;1713;4;4;KZT;null;null;1709;1709;1
0;KZ75125KZT2069100106;2016-09-26;1779;1779;1779;66;66;KZT;null;null;1713;1713;1
0;KZ75125KZT2069100106;2016-09-27;1802;1802;1802;23;23;KZT;null;null;1779;1779;1
0;KZ75125KZT2069100106;2016-09-28;1704;1704;1704;null;null;KZT;98;98;1802;1802;1
0;KZ75125KZT2069100106;2016-09-29;1605;1605;1605;null;null;KZT;99;99;1704;1704;1
0;KZ75125KZT2069100106;2016-09-30;1655;1655;1655;50;50;KZT;null;null;1605;1605;1
0;KZ75125KZT2069100106;2016-10-01;1594;1594;1594;null;null;KZT;61;61;1655;1655;1
0;KZ75125KZT2069100106;2016-10-02;1641;1641;1641;47;47;KZT;null;null;1594;1594;1
0;KZ75125KZT2069100106;2016-10-03;1713;1713;1713;72;72;KZT;null;null;1641;1641;1
0;KZ75125KZT2069100106;2016-10-04;1777;1777;1777;64;64;KZT;null;null;1713;1713;1
0;KZ75125KZT2069100106;2016-10-05;1868;1868;1868;91;91;KZT;null;null;1777;1777;1
0;KZ75125KZT2069100106;2016-10-06;1934;1934;1934;66;66;KZT;null;null;1868;1868;1
0;KZ75125KZT2069100106;2016-10-07;1927;1927;1927;null;null;KZT;7;7;1934;1934;1
0;KZ75125KZT2069100106;2016-10-08;1847;1847;1847;null;null;KZT;80;80;1927;1927;1
0;KZ75125KZT2069100106;2016-10-09;1922;1922;1922;75;75;KZT;null;null;1847;1847;1
0;KZ75125KZT2069100106;2016-10-10;1825;1825;1825;null;null;KZT;97;97;1922;1922;1
0;KZ75125KZT2069100106;2016-10-11;1769;1769;1769;null;null;KZT;56;56;1825;1825;1
0;KZ75125KZT2069100106;2016-10-12;1748;1748;1748;null;null;KZT;21;21;1769;1769;1
0;KZ75125KZT2069100106;2016-10-13;1772;1772;1772;24;24;KZT;null;null;1748;1748;1
0;KZ75125KZT2069100106;2016-10-14;1697;1697;1697;null;null;KZT;75;75;1772;1772;1
0;KZ75125KZT2069100106;2016-10-15;1626;1626;1626;null;null;KZT;71;71;1697;1697;1
0;KZ75125KZT2069100106;2016-10-16;1655;1655;1655;29;29;KZT;null;null;1626;1626;1
0;KZ75125KZT2069100106;2016-10-17;1650;1650;1650;null;null;KZT;5;5;1655;1655;1
0;KZ75125KZT2069100106;2016-10-18;1608;1608;1608;null;null;KZT;42;42;1650;1650;1
0;KZ75125KZT2069100106;2016-10-19;1598;1598;1598;null;null;KZT;10;10;1608;1608;1
0;KZ75125KZT2069100106;2016-10-20;1654;1654;1654;56;56;KZT;null;null;1598;1598;1
0;KZ75125KZT2069100106;2016-10-21;1630;1630;1630;null;null;KZT;24;24;1654;1654;1
0;KZ75125KZT2069100106;2016-10-22;1685;1685;1685;55;55;KZT;null;null;1630;1630;1
0;KZ75125KZT2069100106;2016-10-23;1591;1591;1591;null;null;KZT;94;94;1685;1685;1
0;KZ75125KZT2069100106;2016-10-24;1522;1522;1522;null;null;KZT;69;69;1591;1591;1
0;KZ75125KZT2069100106;2016-10-25;1554;1554;1554;32;32;KZT;null;null;1522;1522;1
0;KZ75125KZT2069100106;2016-10-26;1489;1489;1489;null;null;KZT;65;65;1554;1554;1
0;KZ75125KZT2069100106;2016-10-27;1496;1496;1496;7;7;KZT;null;null;1489;1489;1
0;KZ75125KZT2069100106;2016-10-28;1470;1470;1470;null;null;KZT;26;26;1496;1496;1
0;KZ75125KZT2069100106;2016-10-29;1523;1523;1523;53;53;KZT;null;null;1470;1470;1
0;KZ75125KZT2069100106;2016-10-30;1493;1493;1493;null;null;KZT;30;30;1523;1523;1
0;KZ75125KZT2069100106;2016-10-31;1462;1462;1462;null;null;KZT;31;31;1493;1493;1
0;KZ75125KZT2069100106;2016-11-01;1374;1374;1374;null;null;KZT;88;88;1462;1462;1
0;KZ75125KZT2069100106;2016-11-02;1403;1403;1403;29;29;KZT;null;null;1374;1374;1
0;KZ75125KZT2069100106;2016-11-03;1418;1418;1418;15;15;KZT;null;null;1403;1403;1
0;KZ75125KZT2069100106;2016-11-04;1431;1431;1431;13;13;KZT;null;null;1418;1418;1
0;KZ75125KZT2069100106;2016-11-05;1467;1467;1467;36;36;KZT;null;null;1431;1431;1
0;KZ75125KZT2069100106;2016-11-06;1532;1532;1532;65;65;KZT;null;null;1467;1467;1
0;KZ75125KZT2069100106;2016-11-07;1569;1569;1569;37;37;KZT;null;null;1532;1532;1
0;KZ75125KZT2069100106;2016-11-08;1570;1570;1570;1;1;KZT;null;null;1569;1569;1
0;KZ75125KZT2069100106;2016-11-09;1484;1484;1484;null;null;KZT;86;86;1570;1570;1
0;KZ75125KZT2069100106;2016-11-10;1510;1510;1510;26;26;KZT;null;null;1484;1484;1
0;KZ75125KZT2069100106;2016-11-11;1570;1570;1570;60;60;KZT;null;null;1510;1510;1
0;KZ75125KZT2069100106;2016-11-12;1669;1669;1669;99;99;KZT;null;null;1570;1570;1
0;KZ75125KZT2069100106;2016-11-13;1693;1693;1693;24;24;KZT;null;null;1669;1669;1
0;KZ75125KZT2069100106;2016-11-14;1744;1744;1744;51;51;KZT;null;null;1693;1693;1
0;KZ75125KZT2069100106;2016-11-15;1795;1795;1795;51;51;KZT;null;null;1744;1744;1
0;KZ75125KZT2069100106;2016-11-16;1795;1795;1795;null;null;KZT;0;0;1795;1795;1
0;KZ75125KZT2069100106;2016-11-17;1838;1838;1838;43;43;KZT;null;null;1795;1795;1
0;KZ75125KZT2069100106;2016-11-18;1767;1767;1767;null;null;KZT;71;71;1838;1838;1
0;KZ75125KZT2069100106;2016-11-19;1762;1762;1762;null;null;KZT;5;5;1767;1767;1
0;KZ75125KZT2069100106;2016-11-20;1746;1746;1746;null;null;KZT;16;16;1762;1762;1
0;KZ75125KZT2069100106;2016-11-21;1781;1781;1781;35;35;KZT;null;null;1746;1746;1
0;KZ75125KZT2069100106;2016-11-22;1719;1719;1719;null;null;KZT;62;62;1781;1781;1
0;KZ75125KZT2069100106;2016-11-23;1658;1658;1658;null;null;KZT;61;61;1719;1719;1
0;KZ75125KZT2069100106;2016-11-24;1681;1681;1681;23;23;KZT;null;null;1658;1658;1
0;KZ75125KZT2069100106;2016-11-25;1627;1627;1627;null;null;KZT;54;54;1681;1681;1
0;KZ75125KZT2069100106;2016-11-26;1603;1603;1603;null;null;KZT;24;24;1627;1627;1
0;KZ75125KZT2069100106;2016-11-27;1580;1580;1580;null;null;KZT;23;23;1603;1603;1
0;KZ75125KZT2069100106;2016-11-28;1529;1529;1529;null;null;KZT;51;51;1580;1580;1
0;KZ75125KZT2069100106;2016-11-29;1443;1443;1443;null;null;KZT;86;86;1529;1529;1
0;KZ75125KZT2069100106;2016-11-30;1490;1490;1490;47;47;KZT;null;null;1443;1443;1
0;KZ75125KZT2069100106;2016-12-01;1464;1464;1464;null;null;KZT;26;26;1490;1490;1
0;KZ75125KZT2069100106;2016-12-02;1473;1473;1473;9;9;KZT;null;null;1464;1464;1
0;KZ75125KZT2069100106;2016-12-03;1430;1430;1430;null;null;KZT;43;43;1473;1473;1
0;KZ75125KZT2069100106;2016-12-04;1331;1331;1331;null;null;KZT;99;99;1430;1430;1
0;KZ75125KZT2069100106;2016-12-05;1395;1395;1395;64;64;KZT;null;null;1331;1331;1
0;KZ75125KZT2069100106;2016-12-06;1306;1306;1306;null;null;KZT;89;89;1395;1395;1
0;KZ75125KZT2069100106;2016-12-07;1236;1236;1236;null;null;KZT;70;70;1306;1306;1
0;KZ75125KZT2069100106;2016-12-08;1319;1319;1319;83;83;KZT;null;null;1236;1236;1
0;KZ75125KZT2069100106;2016-12-09;1229;1229;1229;null;null;KZT;90;90;1319;1319;1
0;KZ75125KZT2069100106;2016-12-10;1170;1170;1170;null;null;KZT;59;59;1229;1229;1
0;KZ75125KZT2069100106;2016-12-11;1192;1192;1192;22;22;KZT;null;null;1170;1170;1
0;KZ75125KZT2069100106;2016-12-12;1286;1286;1286;94;94;KZT;null;null;1192;1192;1
0;KZ75125KZT2069100106;2016-12-13;1366;1366;1366;80;80;KZT;null;null;1286;1286;1
0;KZ75125KZT2069100106;2016-12-14;1379;1379;1379;13;13;KZT;null;null;1366;1366;1
0;KZ75125KZT2069100106;2016-12-15;1367;1367;1367;null;null;KZT;12;12;1379;1379;1
0;KZ75125KZT2069100106;2016-12-16;1393;1393;1393;26;26;KZT;null;null;1367;1367;1
0;KZ75125KZT2069100106;2016-12-17;1480;1480;1480;87;87;KZT;null;null;1393;1393;1
0;KZ75125KZT2069100106;2016-12-18;1555;1555;1555;75;75;KZT;null;null;1480;1480;1
0;KZ75125KZT2069100106;2016-12-19;1549;1549;1549;null;null;KZT;6;6;1555;1555;1
0;KZ75125KZT2069100106;2016-12-20;1518;1518;1518;null;null;KZT;31;31;1549;1549;1
0;KZ75125KZT2069100106;2016-12-21;1604;1604;1604;86;86;KZT;null;null;1518;1518;1
0;KZ75125KZT2069100106;2016-12-22;1581;1581;1581;null;null;KZT;23;23;1604;1604;1
0;KZ75125KZT2069100106;2016-12-23;1505;1505;1505;null;null;KZT;76;76;1581;1581;1
0;KZ75125KZT2069100106;2016-12-24;1563;1563;1563;58;58;KZT;null;null;1505;1505;1
0;KZ75125KZT2069100106;2016-12-25;1592;1592;1592;29;29;KZT;null;null;1563;1563;1
0;KZ75125KZT2069100106;2016-12-26;1586;1586;1586;null;null;KZT;6;6;1592;1592;1
0;KZ75125KZT2069100106;2016-12-27;1558;1558;1558;null;null;KZT;28;28;1586;1586;1
0;KZ75125KZT2069100106;2016-12-28;1489;1489;1489;null;null;KZT;69;69;1558;1558;1
0;KZ75125KZT2069100106;2016-12-29;1577;1577;1577;88;88;KZT;null;null;1489;1489;1
0;KZ75125KZT2069100106;2016-12-30;1483;1483;1483;null;null;KZT;94;94;1577;1577;1
0;KZ75125KZT2069100106;2016-12-31;1570;1570;1570;87;87;KZT;null;null;1483;1483;1
0;KZ75125KZT2069100106;2017-01-01;1639;1639;1639;69;69;KZT;null;null;1570;1570;1
0;KZ75125KZT2069100106;2017-01-02;1720;1720;1720;81;81;KZT;null;null;1639;1639;1
0;KZ75125KZT2069100106;2017-01-03;1817;1817;1817;97;97;KZT;null;null;1720;1720;1
0;KZ75125KZT2069100106;2017-01-04;1851;1851;1851;34;34;KZT;null;null;1817;1817;1
0;KZ75125KZT2069100106;2017-01-05;1912;1912;1912;61;61;KZT;null;null;1851;1851;1
0;KZ75125KZT2069100106;2017-01-06;1976;1976;1976;64;64;KZT;null;null;1912;1912;1
0;KZ75125KZT2069100106;2017-01-07;2071;2071;2071;95;95;KZT;null;null;1976;1976;1
0;KZ75125KZT2069100106;2017-01-08;2121;2121;2121;50;50;KZT;null;null;2071;2071;1
0;KZ75125KZT2069100106;2017-01-09;2063;2063;2063;null;null;KZT;58;58;2121;2121;1
0;KZ75125KZT2069100106;2017-01-10;1969;1969;1969;null;null;KZT;94;94;2063;2063;1
0;KZ75125KZT2069100106;2017-01-11;1988;1988;1988;19;19;KZT;null;null;1969;1969;1
0;KZ75125KZT2069100106;2017-01-12;1896;1896;1896;null;null;KZT;92;92;1988;1988;1
0;KZ75125KZT2069100106;2017-01-13;1924;1924;1924;28;28;KZT;null;null;1896;1896;1
0;KZ75125KZT2069100106;2017-01-14;1971;1971;1971;47;47;KZT;null;null;1924;1924;1
0;KZ75125KZT2069100106;2017-01-15;1987;1987;1987;16;16;KZT;null;null;1971;1971;1
0;KZ75125KZT2069100106;2017-01-16;1932;1932;1932;null;null;KZT;55;55;1987;1987;1
0;KZ75125KZT2069100106;2017-01-17;2003;2003;2003;71;71;KZT;null;null;1932;1932;1
0;KZ75125KZT2069100106;2017-01-18;1904;1904;1904;null;null;KZT;99;99;2003;2003;1
0;KZ75125KZT2069100106;2017-01-19;1956;1956;1956;52;52;KZT;null;null;1904;1904;1
0;KZ75125KZT2069100106;2017-01-20;1963;1963;1963;7;7;KZT;null;null;1956;1956;1
0;KZ75125KZT2069100106;2017-01-21;1957;1957;1957;null;null;KZT;6;6;1963;1963;1
0;KZ75125KZT2069100106;2017-01-22;2004;2004;2004;47;47;KZT;null;null;1957;1957;1
0;KZ75125KZT2069100106;2017-01-23;1939;1939;1939;null;null;KZT;65;65;2004;2004;1
0;KZ75125KZT2069100106;2017-01-24;1920;1920;1920;null;null;KZT;19;19;1939;1939;1
0;KZ75125KZT2069100106;2017-01-25;1950;1950;1950;30;30;KZT;null;null;1920;1920;1
0;KZ75125KZT2069100106;2017-01-26;1986;1986;1986;36;36;KZT;null;null;1950;1950;1
0;KZ75125KZT2069100106;2017-01-27;1960;1960;1960;null;null;KZT;26;26;1986;1986;1
0;KZ75125KZT2069100106;2017-01-28;1888;1888;1888;null;null;KZT;72;72;1960;1960;1
0;KZ75125KZT2069100106;2017-01-29;1850;1850;1850;null;null;KZT;38;38;1888;1888;1
0;KZ75125KZT2069100106;2017-01-30;1901;1901;1901;51;51;KZT;null;null;1850;1850;1
0;KZ75125KZT2069100106;2017-01-31;1950;1950;1950;49;49;KZT;null;null;1901;1901;1
0;KZ75125KZT2069100106;2017-02-01;1885;1885;1885;null;null;KZT;65;65;1950;1950;1
0;KZ75125KZT2069100106;2017-02-02;1809;1809;1809;null;null;KZT;76;76;1885;1885;1
0;KZ75125KZT2069100106;2017-02-03;1899;1899;1899;90;90;KZT;null;null;1809;1809;1
0;KZ75125KZT2069100106;2017-02-04;1982;1982;1982;83;83;KZT;null;null;1899;1899;1
0;KZ75125KZT2069100106;2017-02-05;2073;2073;2073;91;91;KZT;null;null;1982;1982;1
0;KZ75125KZT2069100106;2017-02-06;2123;2123;2123;50;50;KZT;null;null;2073;2073;1
0;KZ75125KZT2069100106;2017-02-07;2108;2108;2108;null;null;KZT;15;15;2123;2123;1
0;KZ75125KZT2069100106;2017-02-08;2199;2199;2199;91;91;KZT;null;null;2108;2108;1
0;KZ75125KZT2069100106;2017-02-09;2256;2256;2256;57;57;KZT;null;null;2199;2199;1
0;KZ75125KZT2069100106;2017-02-10;2300;2300;2300;44;44;KZT;null;null;2256;2256;1
0;KZ75125KZT2069100106;2017-02-11;2366;2366;2366;66;66;KZT;null;null;2300;2300;1
0;KZ75125KZT2069100106;2017-02-12;2283;2283;2283;null;null;KZT;83;83;2366;2366;1
0;KZ75125KZT2069100106;2017-02-13;2231;2231;2231;null;null;KZT;52;52;2283;2283;1
0;KZ75125KZT2069100106;2017-02-14;2225;2225;2225;null;null;KZT;6;6;2231;2231;1
0;KZ75125KZT2069100106;2017-02-15;2191;2191;2191;null;null;KZT;34;34;2225;2225;1
0;KZ75125KZT2069100106;2017-02-16;2167;2167;2167;null;null;KZT;24;24;2191;2191;1
0;KZ75125KZT2069100106;2017-02-17;2074;2074;2074;null;null;KZT;93;93;2167;2167;1
0;KZ75125KZT2069100106;2017-02-18;2151;2151;2151;77;77;KZT;null;null;2074;2074;1
0;KZ75125KZT2069100106;2017-02-19;2229;2229;2229;78;78;KZT;null;null;2151;2151;1
0;KZ75125KZT2069100106;2017-02-20;2167;2167;2167;null;null;KZT;62;62;2229;2229;1
0;KZ75125KZT2069100106;2017-02-21;2085;2085;2085;null;null;KZT;82;82;2167;2167;1
0;KZ75125KZT2069100106;2017-02-22;2157;2157;2157;72;72;KZT;null;null;2085;2085;1
0;KZ75125KZT2069100106;2017-02-23;2199;2199;2199;42;42;KZT;null;null;2157;2157;1
0;KZ75125KZT2069100106;2017-02-24;2140;2140;2140;null;null;KZT;59;59;2199;2199;1
0;KZ75125KZT2069100106;2017-02-25;2179;2179;2179;39;39;KZT;null;null;2140;2140;1
0;KZ75125KZT2069100106;2017-02-26;2143;2143;2143;null;null;KZT;36;36;2179;2179;1
0;KZ75125KZT2069100106;2017-02-27;2150;2150;2150;7;7;KZT;null;null;2143;2143;1
0;KZ75125KZT2069100106;2017-02-28;2158;2158;2158;8;8;KZT;null;null;2150;2150;1
0;KZ75125KZT2069100106;2017-03-01;2146;2146;2146;null;null;KZT;12;12;2158;2158;1
0;KZ75125KZT2069100106;2017-03-02;2244;2244;2244;98;98;KZT;null;null;2146;2146;1
0;KZ75125KZT2069100106;2017-03-03;2294;2294;2294;50;50;KZT;null;null;2244;2244;1
0;KZ75125KZT2069100106;2017-03-04;2380;2380;2380;86;86;KZT;null;null;2294;2294;1
0;KZ75125KZT2069100106;2017-03-05;2357;2357;2357;null;null;KZT;23;23;2380;2380;1
0;KZ75125KZT2069100106;2017-03-06;2329;2329;2329;null;null;KZT;28;28;2357;2357;1
0;KZ75125KZT2069100106;2017-03-07;2402;2402;2402;73;73;KZT;null;null;2329;2329;1
0;KZ75125KZT2069100106;2017-03-08;2422;2422;2422;20;20;KZT;null;null;2402;2402;1
0;KZ75125KZT2069100106;2017-03-09;2473;2473;2473;51;51;KZT;null;null;2422;2422;1
0;KZ75125KZT2069100106;2017-03-10;2401;2401;2401;null;null;KZT;72;72;2473;2473;1
0;KZ75125KZT2069100106;2017-03-11;2465;2465;2465;64;64;KZT;null;null;2401;2401;1
0;KZ75125KZT2069100106;2017-03-12;2492;2492;2492;27;27;KZT;null;null;2465;2465;1
0;KZ75125KZT2069100106;2017-03-13;2561;2561;2561;69;69;KZT;null;null;2492;2492;1
0;KZ75125KZT2069100106;2017-03-14;2544;2544;2544;null;null;KZT;17;17;2561;2561;1
0;KZ75125KZT2069100106;2017-03-15;2499;2499;2499;null;null;KZT;45;45;2544;2544;1
0;KZ75125KZT2069100106;2017-03-16;2472;2472;2472;null;null;KZT;27;27;2499;2499;1
0;KZ75125KZT2069100106;2017-03-17;2458;2458;2458;null;null;KZT;14;14;2472;2472;1
0;KZ75125KZT2069100106;2017-03-18;2485;2485;2485;27;27;KZT;null;null;2458;2458;1
0;KZ75125KZT2069100106;2017-03-19;2478;2478;2478;null;null;KZT;7;7;2485;2485;1
0;KZ75125KZT2069100106;2017-03-20;2544;2544;2544;66;66;KZT;null;null;2478;2478;1
0;KZ75125KZT2069100106;2017-03-21;2531;2531;2531;null;null;KZT;13;13;2544;2544;1
0;KZ75125KZT2069100106;2017-03-22;2572;2572;2572;41;41;KZT;null;null;2531;2531;1
0;KZ75125KZT2069100106;2017-03-23;2473;2473;2473;null;null;KZT;99;99;2572;2572;1
0;KZ75125KZT2069100106;2017-03-24;2475;2475;2475;2;2;KZT;null;null;2473;2473;1
0;KZ75125KZT2069100106;2017-03-25;2549;2549;2549;74;74;KZT;null;null;2475;2475;1
0;KZ75125KZT2069100106;2017-03-26;2640;2640;2640;91;91;KZT;null;null;2549;2549;1
0;KZ75125KZT2069100106;2017-03-27;2731;2731;2731;91;91;KZT;null;null;2640;2640;1
0;KZ75125KZT2069100106;2017-03-28;2664;2664;2664;null;null;KZT;67;67;2731;2731;1
0;KZ75125KZT2069100106;2017-03-29;2614;2614;2614;null;null;KZT;50;50;2664;2664;1
0;KZ75125KZT2069100106;2017-03-30;2701;2701;2701;87;87;KZT;null;null;2614;2614;1
0;KZ75125KZT2069100106;2017-03-31;2662;2662;2662;null;null;KZT;39;39;2701;2701;1
0;KZ75125KZT2069100106;2017-04-01;2612;2612;2612;null;null;KZT;50;50;2662;2662;1
0;KZ75125KZT2069100106;2017-04-02;2674;2674;2674;62;62;KZT;null;null;2612;2612;1
0;KZ75125KZT2069100106;2017-04-03;2591;2591;2591;null;null;KZT;83;83;2674;2674;1
0;KZ75125KZT2069100106;2017-04-04;2628;2628;2628;37;37;KZT;null;null;2591;2591;1
0;KZ75125KZT2069100106;2017-04-05;2595;2595;2595;null;null;KZT;33;33;2628;2628;1
0;KZ75125KZT2069100106;2017-04-06;2524;2524;2524;null;null;KZT;71;71;2595;2595;1
0;KZ75125KZT2069100106;2017-04-07;2521;2521;2521;null;null;KZT;3;3;2524;2524;1
0;KZ75125KZT2069100106;2017-04-08;2588;2588;2588;67;67;KZT;null;null;2521;2521;1
0;KZ75125KZT2069100106;2017-04-09;2636;2636;2636;48;48;KZT;null;null;2588;2588;1
0;KZ75125KZT2069100106;2017-04-10;2590;2590;2590;null;null;KZT;46;46;2636;2636;1
0;KZ75125KZT2069100106;2017-04-11;2612;2612;2612;22;22;KZT;null;null;2590;2590;1
0;KZ75125KZT2069100106;2017-04-12;2650;2650;2650;38;38;KZT;null;null;2612;2612;1
0;KZ75125KZT2069100106;2017-04-13;2745;2745;2745;95;95;KZT;null;null;2650;2650;1
0;KZ75125KZT2069100106;2017-04-14;2783;2783;2783;38;38;KZT;null;null;2745;2745;1
0;KZ75125KZT2069100106;2017-04-15;2747;2747;2747;null;null;KZT;36;36;2783;2783;1
0;KZ75125KZT2069100106;2017-04-16;2758;2758;2758;11;11;KZT;null;null;2747;2747;1
0;KZ75125KZT2069100106;2017-04-17;2796;2796;2796;38;38;KZT;null;null;2758;2758;1
0;KZ75125KZT2069100106;2017-04-18;2723;2723;2723;null;null;KZT;73;73;2796;2796;1
0;KZ75125KZT2069100106;2017-04-19;2676;2676;2676;null;null;KZT;47;47;2723;2723;1
0;KZ75125KZT2069100106;2017-04-20;2604;2604;2604;null;null;KZT;72;72;2676;2676;1
0;KZ75125KZT2069100106;2017-04-21;2603;2603;2603;null;null;KZT;1;1;2604;2604;1
0;KZ75125KZT2069100106;2017-04-22;2638;2638;2638;35;35;KZT;null;null;2603;2603;1
0;KZ75125KZT2069100106;2017-04-23;2703;2703;2703;65;65;KZT;null;null;2638;2638;1
0;KZ75125KZT2069100106;2017-04-24;2654;2654;2654;null;null;KZT;49;49;2703;2703;1
0;KZ75125KZT2069100106;2017-04-25;2644;2644;2644;null;null;KZT;10;10;2654;2654;1
0;KZ75125KZT2069100106;2017-04-26;2645;2645;2645;1;1;KZT;null;null;2644;2644;1
0;KZ75125KZT2069100106;2017-04-27;2671;2671;2671;26;26;KZT;null;null;2645;2645;1
0;KZ75125KZT2069100106;2017-04-28;2686;2686;2686;15;15;KZT;null;null;2671;2671;1
0;KZ75125KZT2069100106;2017-04-29;2777;2777;2777;91;91;KZT;null;null;2686;2686;1
0;KZ75125KZT2069100106;2017-04-30;2841;2841;2841;64;64;KZT;null;null;2777;2777;1
0;KZ75125KZT2069100106;2017-05-01;2751;2751;2751;null;null;KZT;90;90;2841;2841;1
0;KZ75125KZT2069100106;2017-05-02;2716;2716;2716;null;null;KZT;35;35;2751;2751;1
0;KZ75125KZT2069100106;2017-05-03;2736;2736;2736;20;20;KZT;null;null;2716;2716;1
0;KZ75125KZT2069100106;2017-05-04;2651;2651;2651;null;null;KZT;85;85;2736;2736;1
0;KZ75125KZT2069100106;2017-05-05;2627;2627;2627;null;null;KZT;24;24;2651;2651;1
0;KZ75125KZT2069100106;2017-05-06;2570;2570;2570;null;null;KZT;57;57;2627;2627;1
0;KZ75125KZT2069100106;2017-05-07;2600;2600;2600;30;30;KZT;null;null;2570;2570;1
0;KZ75125KZT2069100106;2017-05-08;2644;2644;2644;44;44;KZT;null;null;2600;2600;1
0;KZ75125KZT2069100106;2017-05-09;2568;2568;2568;null;null;KZT;76;76;2644;2644;1
0;KZ75125KZT2069100106;2017-05-10;2589;2589;2589;21;21;KZT;null;null;2568;2568;1
0;KZ75125KZT2069100106;2017-05-11;2515;2515;2515;null;null;KZT;74;74;2589;2589;1
0;KZ75125KZT2069100106;2017-05-12;2448;2448;2448;null;null;KZT;67;67;2515;2515;1
0;KZ75125KZT2069100106;2017-05-13;2383;2383;2383;null;null;KZT;65;65;2448;2448;1
0;KZ75125KZT2069100106;2017-05-14;2396;2396;2396;13;13;KZT;null;null;2383;2383;1
0;KZ75125KZT2069100106;2017-05-15;2469;2469;2469;73;73;KZT;null;null;2396;2396;1
0;KZ75125KZT2069100106;2017-05-16;2426;2426;2426;null;null;KZT;43;43;2469;2469;1
0;KZ75125KZT2069100106;2017-05-17;2517;2517;2517;91;91;KZT;null;null;2426;2426;1
0;KZ75125KZT2069100106;2017-05-18;2485;2485;2485;null;null;KZT;32;32;2517;2517;1
0;KZ75125KZT2069100106;2017-05-19;2454;2454;2454;null;null;KZT;31;31;2485;2485;1
0;KZ75125KZT2069100106;2017-05-20;2437;2437;2437;null;null;KZT;17;17;2454;2454;1
0;KZ75125KZT2069100106;2017-05-21;2374;2374;2374;null;null;KZT;63;63;2437;2437;1
0;KZ75125KZT2069100106;2017-05-22;2322;2322;2322;null;null;KZT;52;52;2374;2374;1
0;KZ75125KZT2069100106;2017-05-23;2416;2416;2416;94;94;KZT;null;null;2322;2322;1
0;KZ75125KZT2069100106;2017-05-24;2333;2333;2333;null;null;KZT;83;83;2416;2416;1
0;KZ75125KZT2069100106;2017-05-25;2321;2321;2321;null;null;KZT;12;12;2333;2333;1
0;KZ75125KZT2069100106;2017-05-26;2311;2311;2311;null;null;KZT;10;10;2321;2321;1
0;KZ75125KZT2069100106;2017-05-27;2280;2280;2280;null;null;KZT;31;31;2311;2311;1
0;KZ75125KZT2069100106;2017-05-28;2186;2186;2186;null;null;KZT;94;94;2280;2280;1
0;KZ75125KZT2069100106;2017-05-29;2249;2249;2249;63;63;KZT;null;null;2186;2186;1
0;KZ75125KZT2069100106;2017-05-30;2285;2285;2285;36;36;KZT;null;null;2249;2249;1
0;KZ75125KZT2069100106;2017-05-31;2363;2363;2363;78;78;KZT;null;null;2285;2285;1
0;KZ75125KZT2069100106;2017-06-01;2350;2350;2350;null;null;KZT;13;13;2363;2363;1
0;KZ75125KZT2069100106;2017-06-02;2360;2360;2360;10;10;KZT;null;null;2350;2350;1
0;KZ75125KZT2069100106;2017-06-03;2428;2428;2428;68;68;KZT;null;null;2360;2360;1
0;KZ75125KZT2069100106;2017-06-04;2469;2469;2469;41;41;KZT;null;null;2428;2428;1
0;KZ75125KZT2069100106;2017-06-05;2399;2399;2399;null;null;KZT;70;70;2469;2469;1
0;KZ75125KZT2069100106;2017-06-06;2302;2302;2302;null;null;KZT;97;97;2399;2399;1
0;KZ75125KZT2069100106;2017-06-07;2240;2240;2240;null;null;KZT;62;62;2302;2302;1
0;KZ75125KZT2069100106;2017-06-08;2250;2250;2250;10;10;KZT;null;null;2240;2240;1
0;KZ75125KZT2069100106;2017-06-09;2178;2178;2178;null;null;KZT;72;72;2250;2250;1
0;KZ75125KZT2069100106;2017-06-10;2161;2161;2161;null;null;KZT;17;17;2178;2178;1
0;KZ75125KZT2069100106;2017-06-11;2148;2148;2148;null;null;KZT;13;13;2161;2161;1
0;KZ75125KZT2069100106;2017-06-12;2159;2159;2159;11;11;KZT;null;null;2148;2148;1
0;KZ75125USD2069100107;2015-05-11;158;158;79;58;29;USD;null;null;100;50;0.5
0;KZ75125USD2069100107;2015-05-12;140;140;70;null;null;USD;18;9;158;79;0.5
0;KZ75125USD2069100107;2015-05-13;131;131;65.5;null;null;USD;9;4.5;140;70;0.5
0;KZ75125USD2069100107;2015-05-14;212;212;106;81;40.5;USD;null;null;131;65.5;0.5
0;KZ75125USD2069100107;2015-05-15;143;143;71.5;null;null;USD;69;34.5;212;106;0.5
0;KZ75125USD2069100107;2015-05-16;237;237;118.5;94;47;USD;null;null;143;71.5;0.5
0;KZ75125USD2069100107;2015-05-17;326;326;163;89;44.5;USD;null;null;237;118.5;0.5
0;KZ75125USD2069100107;2015-05-18;291;291;145.5;null;null;USD;35;17.5;326;163;0.5
0;KZ75125USD2069100107;2015-05-19;261;261;130.5;null;null;USD;30;15;291;145.5;0.5
0;KZ75125USD2069100107;2015-05-20;165;165;82.5;null;null;USD;96;48;261;130.5;0.5
0;KZ75125USD2069100107;2015-05-21;160;160;80;null;null;USD;5;2.5;165;82.5;0.5
0;KZ75125USD2069100107;2015-05-22;170;170;85;10;5;USD;null;null;160;80;0.5
0;KZ75125USD2069100107;2015-05-23;199;199;99.5;29;14.5;USD;null;null;170;85;0.5
0;KZ75125USD2069100107;2015-05-24;281;281;140.5;82;41;USD;null;null;199;99.5;0.5
0;KZ75125USD2069100107;2015-05-25;351;351;175.5;70;35;USD;null;null;281;140.5;0.5
0;KZ75125USD2069100107;2015-05-26;397;397;198.5;46;23;USD;null;null;351;175.5;0.5
0;KZ75125USD2069100107;2015-05-27;432;432;216;35;17.5;USD;null;null;397;198.5;0.5
0;KZ75125USD2069100107;2015-05-28;406;406;203;null;null;USD;26;13;432;216;0.5
0;KZ75125USD2069100107;2015-05-29;433;433;216.5;27;13.5;USD;null;null;406;203;0.5
0;KZ75125USD2069100107;2015-05-30;358;358;179;null;null;USD;75;37.5;433;216.5;0.5
0;KZ75125USD2069100107;2015-05-31;309;309;154.5;null;null;USD;49;24.5;358;179;0.5
0;KZ75125USD2069100107;2015-06-01;220;220;110;null;null;USD;89;44.5;309;154.5;0.5
0;KZ75125USD2069100107;2015-06-02;306;306;153;86;43;USD;null;null;220;110;0.5
0;KZ75125USD2069100107;2015-06-03;400;400;200;94;47;USD;null;null;306;153;0.5
0;KZ75125USD2069100107;2015-06-04;341;341;170.5;null;null;USD;59;29.5;400;200;0.5
0;KZ75125USD2069100107;2015-06-05;274;274;137;null;null;USD;67;33.5;341;170.5;0.5
0;KZ75125USD2069100107;2015-06-06;219;219;109.5;null;null;USD;55;27.5;274;137;0.5
0;KZ75125USD2069100107;2015-06-07;302;302;151;83;41.5;USD;null;null;219;109.5;0.5
0;KZ75125USD2069100107;2015-06-08;276;276;138;null;null;USD;26;13;302;151;0.5
0;KZ75125USD2069100107;2015-06-09;203;203;101.5;null;null;USD;73;36.5;276;138;0.5
0;KZ75125USD2069100107;2015-06-10;165;165;82.5;null;null;USD;38;19;203;101.5;0.5
0;KZ75125USD2069100107;2015-06-11;264;264;132;99;49.5;USD;null;null;165;82.5;0.5
0;KZ75125USD2069100107;2015-06-12;275;275;137.5;11;5.5;USD;null;null;264;132;0.5
0;KZ75125USD2069100107;2015-06-13;369;369;184.5;94;47;USD;null;null;275;137.5;0.5
0;KZ75125USD2069100107;2015-06-14;409;409;204.5;40;20;USD;null;null;369;184.5;0.5
0;KZ75125USD2069100107;2015-06-15;405;405;202.5;null;null;USD;4;2;409;204.5;0.5
0;KZ75125USD2069100107;2015-06-16;491;491;245.5;86;43;USD;null;null;405;202.5;0.5
0;KZ75125USD2069100107;2015-06-17;396;396;198;null;null;USD;95;47.5;491;245.5;0.5
0;KZ75125USD2069100107;2015-06-18;486;486;243;90;45;USD;null;null;396;198;0.5
0;KZ75125USD2069100107;2015-06-19;457;457;228.5;null;null;USD;29;14.5;486;243;0.5
0;KZ75125USD2069100107;2015-06-20;511;511;255.5;54;27;USD;null;null;457;228.5;0.5
0;KZ75125USD2069100107;2015-06-21;503;503;251.5;null;null;USD;8;4;511;255.5;0.5
0;KZ75125USD2069100107;2015-06-22;517;517;258.5;14;7;USD;null;null;503;251.5;0.5
0;KZ75125USD2069100107;2015-06-23;436;436;218;null;null;USD;81;40.5;517;258.5;0.5
0;KZ75125USD2069100107;2015-06-24;532;532;266;96;48;USD;null;null;436;218;0.5
0;KZ75125USD2069100107;2015-06-25;533;533;266.5;1;0.5;USD;null;null;532;266;0.5
0;KZ75125USD2069100107;2015-06-26;442;442;221;null;null;USD;91;45.5;533;266.5;0.5
0;KZ75125USD2069100107;2015-06-27;365;365;182.5;null;null;USD;77;38.5;442;221;0.5
0;KZ75125USD2069100107;2015-06-28;457;457;228.5;92;46;USD;null;null;365;182.5;0.5
0;KZ75125USD2069100107;2015-06-29;391;391;195.5;null;null;USD;66;33;457;228.5;0.5
0;KZ75125USD2069100107;2015-06-30;404;404;202;13;6.5;USD;null;null;391;195.5;0.5
0;KZ75125USD2069100107;2015-07-01;376;376;188;null;null;USD;28;14;404;202;0.5
0;KZ75125USD2069100107;2015-07-02;444;444;222;68;34;USD;null;null;376;188;0.5
0;KZ75125USD2069100107;2015-07-03;406;406;203;null;null;USD;38;19;444;222;0.5
0;KZ75125USD2069100107;2015-07-04;428;428;214;22;11;USD;null;null;406;203;0.5
0;KZ75125USD2069100107;2015-07-05;476;476;238;48;24;USD;null;null;428;214;0.5
0;KZ75125USD2069100107;2015-07-06;572;572;286;96;48;USD;null;null;476;238;0.5
0;KZ75125USD2069100107;2015-07-07;658;658;329;86;43;USD;null;null;572;286;0.5
0;KZ75125USD2069100107;2015-07-08;658;658;329;null;null;USD;0;0;658;329;0.5
0;KZ75125USD2069100107;2015-07-09;629;629;314.5;null;null;USD;29;14.5;658;329;0.5
0;KZ75125USD2069100107;2015-07-10;709;709;354.5;80;40;USD;null;null;629;314.5;0.5
0;KZ75125USD2069100107;2015-07-11;610;610;305;null;null;USD;99;49.5;709;354.5;0.5
0;KZ75125USD2069100107;2015-07-12;593;593;296.5;null;null;USD;17;8.5;610;305;0.5
0;KZ75125USD2069100107;2015-07-13;690;690;345;97;48.5;USD;null;null;593;296.5;0.5
0;KZ75125USD2069100107;2015-07-14;714;714;357;24;12;USD;null;null;690;345;0.5
0;KZ75125USD2069100107;2015-07-15;680;680;340;null;null;USD;34;17;714;357;0.5
0;KZ75125USD2069100107;2015-07-16;607;607;303.5;null;null;USD;73;36.5;680;340;0.5
0;KZ75125USD2069100107;2015-07-17;525;525;262.5;null;null;USD;82;41;607;303.5;0.5
0;KZ75125USD2069100107;2015-07-18;469;469;234.5;null;null;USD;56;28;525;262.5;0.5
0;KZ75125USD2069100107;2015-07-19;554;554;277;85;42.5;USD;null;null;469;234.5;0.5
0;KZ75125USD2069100107;2015-07-20;642;642;321;88;44;USD;null;null;554;277;0.5
0;KZ75125USD2069100107;2015-07-21;563;563;281.5;null;null;USD;79;39.5;642;321;0.5
0;KZ75125USD2069100107;2015-07-22;514;514;257;null;null;USD;49;24.5;563;281.5;0.5
0;KZ75125USD2069100107;2015-07-23;579;579;289.5;65;32.5;USD;null;null;514;257;0.5
0;KZ75125USD2069100107;2015-07-24;617;617;308.5;38;19;USD;null;null;579;289.5;0.5
0;KZ75125USD2069100107;2015-07-25;545;545;272.5;null;null;USD;72;36;617;308.5;0.5
0;KZ75125USD2069100107;2015-07-26;524;524;262;null;null;USD;21;10.5;545;272.5;0.5
0;KZ75125USD2069100107;2015-07-27;483;483;241.5;null;null;USD;41;20.5;524;262;0.5
0;KZ75125USD2069100107;2015-07-28;582;582;291;99;49.5;USD;null;null;483;241.5;0.5
0;KZ75125USD2069100107;2015-07-29;678;678;339;96;48;USD;null;null;582;291;0.5
0;KZ75125USD2069100107;2015-07-30;762;762;381;84;42;USD;null;null;678;339;0.5
0;KZ75125USD2069100107;2015-07-31;765;765;382.5;3;1.5;USD;null;null;762;381;0.5
0;KZ75125USD2069100107;2015-08-01;681;681;340.5;null;null;USD;84;42;765;382.5;0.5
0;KZ75125USD2069100107;2015-08-02;735;735;367.5;54;27;USD;null;null;681;340.5;0.5
0;KZ75125USD2069100107;2015-08-03;753;753;376.5;18;9;USD;null;null;735;367.5;0.5
0;KZ75125USD2069100107;2015-08-04;662;662;331;null;null;USD;91;45.5;753;376.5;0.5
0;KZ75125USD2069100107;2015-08-05;619;619;309.5;null;null;USD;43;21.5;662;331;0.5
0;KZ75125USD2069100107;2015-08-06;543;543;271.5;null;null;USD;76;38;619;309.5;0.5
0;KZ75125USD2069100107;2015-08-07;529;529;264.5;null;null;USD;14;7;543;271.5;0.5
0;KZ75125USD2069100107;2015-08-08;540;540;270;11;5.5;USD;null;null;529;264.5;0.5
0;KZ75125USD2069100107;2015-08-09;609;609;304.5;69;34.5;USD;null;null;540;270;0.5
0;KZ75125USD2069100107;2015-08-10;698;698;349;89;44.5;USD;null;null;609;304.5;0.5
0;KZ75125USD2069100107;2015-08-11;698;698;349;null;null;USD;0;0;698;349;0.5
0;KZ75125USD2069100107;2015-08-12;651;651;325.5;null;null;USD;47;23.5;698;349;0.5
0;KZ75125USD2069100107;2015-08-13;722;722;361;71;35.5;USD;null;null;651;325.5;0.5
0;KZ75125USD2069100107;2015-08-14;684;684;342;null;null;USD;38;19;722;361;0.5
0;KZ75125USD2069100107;2015-08-15;747;747;373.5;63;31.5;USD;null;null;684;342;0.5
0;KZ75125USD2069100107;2015-08-16;796;796;398;49;24.5;USD;null;null;747;373.5;0.5
0;KZ75125USD2069100107;2015-08-17;778;778;389;null;null;USD;18;9;796;398;0.5
0;KZ75125USD2069100107;2015-08-18;857;857;428.5;79;39.5;USD;null;null;778;389;0.5
0;KZ75125USD2069100107;2015-08-19;880;880;440;23;11.5;USD;null;null;857;428.5;0.5
0;KZ75125USD2069100107;2015-08-20;796;796;398;null;null;USD;84;42;880;440;0.5
0;KZ75125USD2069100107;2015-08-21;803;803;401.5;7;3.5;USD;null;null;796;398;0.5
0;KZ75125USD2069100107;2015-08-22;830;830;415;27;13.5;USD;null;null;803;401.5;0.5
0;KZ75125USD2069100107;2015-08-23;794;794;397;null;null;USD;36;18;830;415;0.5
0;KZ75125USD2069100107;2015-08-24;869;869;434.5;75;37.5;USD;null;null;794;397;0.5
0;KZ75125USD2069100107;2015-08-25;796;796;398;null;null;USD;73;36.5;869;434.5;0.5
0;KZ75125USD2069100107;2015-08-26;758;758;379;null;null;USD;38;19;796;398;0.5
0;KZ75125USD2069100107;2015-08-27;723;723;361.5;null;null;USD;35;17.5;758;379;0.5
0;KZ75125USD2069100107;2015-08-28;703;703;351.5;null;null;USD;20;10;723;361.5;0.5
0;KZ75125USD2069100107;2015-08-29;691;691;345.5;null;null;USD;12;6;703;351.5;0.5
0;KZ75125USD2069100107;2015-08-30;618;618;309;null;null;USD;73;36.5;691;345.5;0.5
0;KZ75125USD2069100107;2015-08-31;658;658;329;40;20;USD;null;null;618;309;0.5
0;KZ75125USD2069100107;2015-09-01;701;701;350.5;43;21.5;USD;null;null;658;329;0.5
0;KZ75125USD2069100107;2015-09-02;660;660;330;null;null;USD;41;20.5;701;350.5;0.5
0;KZ75125USD2069100107;2015-09-03;608;608;304;null;null;USD;52;26;660;330;0.5
0;KZ75125USD2069100107;2015-09-04;592;592;296;null;null;USD;16;8;608;304;0.5
0;KZ75125USD2069100107;2015-09-05;685;685;342.5;93;46.5;USD;null;null;592;296;0.5
0;KZ75125USD2069100107;2015-09-06;655;655;327.5;null;null;USD;30;15;685;342.5;0.5
0;KZ75125USD2069100107;2015-09-07;569;569;284.5;null;null;USD;86;43;655;327.5;0.5
0;KZ75125USD2069100107;2015-09-08;573;573;286.5;4;2;USD;null;null;569;284.5;0.5
0;KZ75125USD2069100107;2015-09-09;637;637;318.5;64;32;USD;null;null;573;286.5;0.5
0;KZ75125USD2069100107;2015-09-10;541;541;270.5;null;null;USD;96;48;637;318.5;0.5
0;KZ75125USD2069100107;2015-09-11;495;495;247.5;null;null;USD;46;23;541;270.5;0.5
0;KZ75125USD2069100107;2015-09-12;430;430;215;null;null;USD;65;32.5;495;247.5;0.5
0;KZ75125USD2069100107;2015-09-13;435;435;217.5;5;2.5;USD;null;null;430;215;0.5
0;KZ75125USD2069100107;2015-09-14;458;458;229;23;11.5;USD;null;null;435;217.5;0.5
0;KZ75125USD2069100107;2015-09-15;534;534;267;76;38;USD;null;null;458;229;0.5
0;KZ75125USD2069100107;2015-09-16;590;590;295;56;28;USD;null;null;534;267;0.5
0;KZ75125USD2069100107;2015-09-17;597;597;298.5;7;3.5;USD;null;null;590;295;0.5
0;KZ75125USD2069100107;2015-09-18;627;627;313.5;30;15;USD;null;null;597;298.5;0.5
0;KZ75125USD2069100107;2015-09-19;642;642;321;15;7.5;USD;null;null;627;313.5;0.5
0;KZ75125USD2069100107;2015-09-20;561;561;280.5;null;null;USD;81;40.5;642;321;0.5
0;KZ75125USD2069100107;2015-09-21;472;472;236;null;null;USD;89;44.5;561;280.5;0.5
0;KZ75125USD2069100107;2015-09-22;504;504;252;32;16;USD;null;null;472;236;0.5
0;KZ75125USD2069100107;2015-09-23;438;438;219;null;null;USD;66;33;504;252;0.5
0;KZ75125USD2069100107;2015-09-24;524;524;262;86;43;USD;null;null;438;219;0.5
0;KZ75125USD2069100107;2015-09-25;594;594;297;70;35;USD;null;null;524;262;0.5
0;KZ75125USD2069100107;2015-09-26;544;544;272;null;null;USD;50;25;594;297;0.5
0;KZ75125USD2069100107;2015-09-27;631;631;315.5;87;43.5;USD;null;null;544;272;0.5
0;KZ75125USD2069100107;2015-09-28;721;721;360.5;90;45;USD;null;null;631;315.5;0.5
0;KZ75125USD2069100107;2015-09-29;709;709;354.5;null;null;USD;12;6;721;360.5;0.5
0;KZ75125USD2069100107;2015-09-30;690;690;345;null;null;USD;19;9.5;709;354.5;0.5
0;KZ75125USD2069100107;2015-10-01;625;625;312.5;null;null;USD;65;32.5;690;345;0.5
0;KZ75125USD2069100107;2015-10-02;591;591;295.5;null;null;USD;34;17;625;312.5;0.5
0;KZ75125USD2069100107;2015-10-03;682;682;341;91;45.5;USD;null;null;591;295.5;0.5
0;KZ75125USD2069100107;2015-10-04;594;594;297;null;null;USD;88;44;682;341;0.5
0;KZ75125USD2069100107;2015-10-05;640;640;320;46;23;USD;null;null;594;297;0.5
0;KZ75125USD2069100107;2015-10-06;684;684;342;44;22;USD;null;null;640;320;0.5
0;KZ75125USD2069100107;2015-10-07;590;590;295;null;null;USD;94;47;684;342;0.5
0;KZ75125USD2069100107;2015-10-08;521;521;260.5;null;null;USD;69;34.5;590;295;0.5
0;KZ75125USD2069100107;2015-10-09;577;577;288.5;56;28;USD;null;null;521;260.5;0.5
0;KZ75125USD2069100107;2015-10-10;561;561;280.5;null;null;USD;16;8;577;288.5;0.5
0;KZ75125USD2069100107;2015-10-11;610;610;305;49;24.5;USD;null;null;561;280.5;0.5
0;KZ75125USD2069100107;2015-10-12;563;563;281.5;null;null;USD;47;23.5;610;305;0.5
0;KZ75125USD2069100107;2015-10-13;585;585;292.5;22;11;USD;null;null;563;281.5;0.5
0;KZ75125USD2069100107;2015-10-14;583;583;291.5;null;null;USD;2;1;585;292.5;0.5
0;KZ75125USD2069100107;2015-10-15;653;653;326.5;70;35;USD;null;null;583;291.5;0.5
0;KZ75125USD2069100107;2015-10-16;706;706;353;53;26.5;USD;null;null;653;326.5;0.5
0;KZ75125USD2069100107;2015-10-17;796;796;398;90;45;USD;null;null;706;353;0.5
0;KZ75125USD2069100107;2015-10-18;784;784;392;null;null;USD;12;6;796;398;0.5
0;KZ75125USD2069100107;2015-10-19;792;792;396;8;4;USD;null;null;784;392;0.5
0;KZ75125USD2069100107;2015-10-20;758;758;379;null;null;USD;34;17;792;396;0.5
0;KZ75125USD2069100107;2015-10-21;728;728;364;null;null;USD;30;15;758;379;0.5
0;KZ75125USD2069100107;2015-10-22;733;733;366.5;5;2.5;USD;null;null;728;364;0.5
0;KZ75125USD2069100107;2015-10-23;743;743;371.5;10;5;USD;null;null;733;366.5;0.5
0;KZ75125USD2069100107;2015-10-24;664;664;332;null;null;USD;79;39.5;743;371.5;0.5
0;KZ75125USD2069100107;2015-10-25;566;566;283;null;null;USD;98;49;664;332;0.5
0;KZ75125USD2069100107;2015-10-26;518;518;259;null;null;USD;48;24;566;283;0.5
0;KZ75125USD2069100107;2015-10-27;571;571;285.5;53;26.5;USD;null;null;518;259;0.5
0;KZ75125USD2069100107;2015-10-28;601;601;300.5;30;15;USD;null;null;571;285.5;0.5
0;KZ75125USD2069100107;2015-10-29;685;685;342.5;84;42;USD;null;null;601;300.5;0.5
0;KZ75125USD2069100107;2015-10-30;605;605;302.5;null;null;USD;80;40;685;342.5;0.5
0;KZ75125USD2069100107;2015-10-31;556;556;278;null;null;USD;49;24.5;605;302.5;0.5
0;KZ75125USD2069100107;2015-11-01;480;480;240;null;null;USD;76;38;556;278;0.5
0;KZ75125USD2069100107;2015-11-02;444;444;222;null;null;USD;36;18;480;240;0.5
0;KZ75125USD2069100107;2015-11-03;493;493;246.5;49;24.5;USD;null;null;444;222;0.5
0;KZ75125USD2069100107;2015-11-04;475;475;237.5;null;null;USD;18;9;493;246.5;0.5
0;KZ75125USD2069100107;2015-11-05;470;470;235;null;null;USD;5;2.5;475;237.5;0.5
0;KZ75125USD2069100107;2015-11-06;380;380;190;null;null;USD;90;45;470;235;0.5
0;KZ75125USD2069100107;2015-11-07;394;394;197;14;7;USD;null;null;380;190;0.5
0;KZ75125USD2069100107;2015-11-08;482;482;241;88;44;USD;null;null;394;197;0.5
0;KZ75125USD2069100107;2015-11-09;405;405;202.5;null;null;USD;77;38.5;482;241;0.5
0;KZ75125USD2069100107;2015-11-10;358;358;179;null;null;USD;47;23.5;405;202.5;0.5
0;KZ75125USD2069100107;2015-11-11;410;410;205;52;26;USD;null;null;358;179;0.5
0;KZ75125USD2069100107;2015-11-12;410;410;205;null;null;USD;0;0;410;205;0.5
0;KZ75125USD2069100107;2015-11-13;341;341;170.5;null;null;USD;69;34.5;410;205;0.5
0;KZ75125USD2069100107;2015-11-14;347;347;173.5;6;3;USD;null;null;341;170.5;0.5
0;KZ75125USD2069100107;2015-11-15;258;258;129;null;null;USD;89;44.5;347;173.5;0.5
0;KZ75125USD2069100107;2015-11-16;175;175;87.5;null;null;USD;83;41.5;258;129;0.5
0;KZ75125USD2069100107;2015-11-17;263;263;131.5;88;44;USD;null;null;175;87.5;0.5
0;KZ75125USD2069100107;2015-11-18;259;259;129.5;null;null;USD;4;2;263;131.5;0.5
0;KZ75125USD2069100107;2015-11-19;278;278;139;19;9.5;USD;null;null;259;129.5;0.5
0;KZ75125USD2069100107;2015-11-20;351;351;175.5;73;36.5;USD;null;null;278;139;0.5
0;KZ75125USD2069100107;2015-11-21;320;320;160;null;null;USD;31;15.5;351;175.5;0.5
0;KZ75125USD2069100107;2015-11-22;282;282;141;null;null;USD;38;19;320;160;0.5
0;KZ75125USD2069100107;2015-11-23;292;292;146;10;5;USD;null;null;282;141;0.5
0;KZ75125USD2069100107;2015-11-24;293;293;146.5;1;0.5;USD;null;null;292;146;0.5
0;KZ75125USD2069100107;2015-11-25;245;245;122.5;null;null;USD;48;24;293;146.5;0.5
0;KZ75125USD2069100107;2015-11-26;306;306;153;61;30.5;USD;null;null;245;122.5;0.5
0;KZ75125USD2069100107;2015-11-27;325;325;162.5;19;9.5;USD;null;null;306;153;0.5
0;KZ75125USD2069100107;2015-11-28;421;421;210.5;96;48;USD;null;null;325;162.5;0.5
0;KZ75125USD2069100107;2015-11-29;447;447;223.5;26;13;USD;null;null;421;210.5;0.5
0;KZ75125USD2069100107;2015-11-30;526;526;263;79;39.5;USD;null;null;447;223.5;0.5
0;KZ75125USD2069100107;2015-12-01;496;496;248;null;null;USD;30;15;526;263;0.5
0;KZ75125USD2069100107;2015-12-02;561;561;280.5;65;32.5;USD;null;null;496;248;0.5
0;KZ75125USD2069100107;2015-12-03;474;474;237;null;null;USD;87;43.5;561;280.5;0.5
0;KZ75125USD2069100107;2015-12-04;462;462;231;null;null;USD;12;6;474;237;0.5
0;KZ75125USD2069100107;2015-12-05;392;392;196;null;null;USD;70;35;462;231;0.5
0;KZ75125USD2069100107;2015-12-06;414;414;207;22;11;USD;null;null;392;196;0.5
0;KZ75125USD2069100107;2015-12-07;436;436;218;22;11;USD;null;null;414;207;0.5
0;KZ75125USD2069100107;2015-12-08;481;481;240.5;45;22.5;USD;null;null;436;218;0.5
0;KZ75125USD2069100107;2015-12-09;417;417;208.5;null;null;USD;64;32;481;240.5;0.5
0;KZ75125USD2069100107;2015-12-10;509;509;254.5;92;46;USD;null;null;417;208.5;0.5
0;KZ75125USD2069100107;2015-12-11;433;433;216.5;null;null;USD;76;38;509;254.5;0.5
0;KZ75125USD2069100107;2015-12-12;367;367;183.5;null;null;USD;66;33;433;216.5;0.5
0;KZ75125USD2069100107;2015-12-13;333;333;166.5;null;null;USD;34;17;367;183.5;0.5
0;KZ75125USD2069100107;2015-12-14;347;347;173.5;14;7;USD;null;null;333;166.5;0.5
0;KZ75125USD2069100107;2015-12-15;370;370;185;23;11.5;USD;null;null;347;173.5;0.5
0;KZ75125USD2069100107;2015-12-16;385;385;192.5;15;7.5;USD;null;null;370;185;0.5
0;KZ75125USD2069100107;2015-12-17;345;345;172.5;null;null;USD;40;20;385;192.5;0.5
0;KZ75125USD2069100107;2015-12-18;330;330;165;null;null;USD;15;7.5;345;172.5;0.5
0;KZ75125USD2069100107;2015-12-19;242;242;121;null;null;USD;88;44;330;165;0.5
0;KZ75125USD2069100107;2015-12-20;302;302;151;60;30;USD;null;null;242;121;0.5
0;KZ75125USD2069100107;2015-12-21;389;389;194.5;87;43.5;USD;null;null;302;151;0.5
0;KZ75125USD2069100107;2015-12-22;465;465;232.5;76;38;USD;null;null;389;194.5;0.5
0;KZ75125USD2069100107;2015-12-23;456;456;228;null;null;USD;9;4.5;465;232.5;0.5
0;KZ75125USD2069100107;2015-12-24;555;555;277.5;99;49.5;USD;null;null;456;228;0.5
0;KZ75125USD2069100107;2015-12-25;580;580;290;25;12.5;USD;null;null;555;277.5;0.5
0;KZ75125USD2069100107;2015-12-26;579;579;289.5;null;null;USD;1;0.5;580;290;0.5
0;KZ75125USD2069100107;2015-12-27;517;517;258.5;null;null;USD;62;31;579;289.5;0.5
0;KZ75125USD2069100107;2015-12-28;421;421;210.5;null;null;USD;96;48;517;258.5;0.5
0;KZ75125USD2069100107;2015-12-29;451;451;225.5;30;15;USD;null;null;421;210.5;0.5
0;KZ75125USD2069100107;2015-12-30;352;352;176;null;null;USD;99;49.5;451;225.5;0.5
0;KZ75125USD2069100107;2015-12-31;420;420;210;68;34;USD;null;null;352;176;0.5
0;KZ75125USD2069100107;2016-01-01;435;435;217.5;15;7.5;USD;null;null;420;210;0.5
0;KZ75125USD2069100107;2016-01-02;430;430;215;null;null;USD;5;2.5;435;217.5;0.5
0;KZ75125USD2069100107;2016-01-03;437;437;218.5;7;3.5;USD;null;null;430;215;0.5
0;KZ75125USD2069100107;2016-01-04;402;402;201;null;null;USD;35;17.5;437;218.5;0.5
0;KZ75125USD2069100107;2016-01-05;368;368;184;null;null;USD;34;17;402;201;0.5
0;KZ75125USD2069100107;2016-01-06;362;362;181;null;null;USD;6;3;368;184;0.5
0;KZ75125USD2069100107;2016-01-07;278;278;139;null;null;USD;84;42;362;181;0.5
0;KZ75125USD2069100107;2016-01-08;287;287;143.5;9;4.5;USD;null;null;278;139;0.5
0;KZ75125USD2069100107;2016-01-09;241;241;120.5;null;null;USD;46;23;287;143.5;0.5
0;KZ75125USD2069100107;2016-01-10;256;256;128;15;7.5;USD;null;null;241;120.5;0.5
0;KZ75125USD2069100107;2016-01-11;336;336;168;80;40;USD;null;null;256;128;0.5
0;KZ75125USD2069100107;2016-01-12;277;277;138.5;null;null;USD;59;29.5;336;168;0.5
0;KZ75125USD2069100107;2016-01-13;363;363;181.5;86;43;USD;null;null;277;138.5;0.5
0;KZ75125USD2069100107;2016-01-14;434;434;217;71;35.5;USD;null;null;363;181.5;0.5
0;KZ75125USD2069100107;2016-01-15;382;382;191;null;null;USD;52;26;434;217;0.5
0;KZ75125USD2069100107;2016-01-16;338;338;169;null;null;USD;44;22;382;191;0.5
0;KZ75125USD2069100107;2016-01-17;295;295;147.5;null;null;USD;43;21.5;338;169;0.5
0;KZ75125USD2069100107;2016-01-18;289;289;144.5;null;null;USD;6;3;295;147.5;0.5
0;KZ75125USD2069100107;2016-01-19;242;242;121;null;null;USD;47;23.5;289;144.5;0.5
0;KZ75125USD2069100107;2016-01-20;196;196;98;null;null;USD;46;23;242;121;0.5
0;KZ75125USD2069100107;2016-01-21;208;208;104;12;6;USD;null;null;196;98;0.5
0;KZ75125USD2069100107;2016-01-22;135;135;67.5;null;null;USD;73;36.5;208;104;0.5
0;KZ75125USD2069100107;2016-01-23;124;124;62;null;null;USD;11;5.5;135;67.5;0.5
0;KZ75125USD2069100107;2016-01-24;193;193;96.5;69;34.5;USD;null;null;124;62;0.5
0;KZ75125USD2069100107;2016-01-25;138;138;69;null;null;USD;55;27.5;193;96.5;0.5
0;KZ75125USD2069100107;2016-01-26;108;108;54;null;null;USD;30;15;138;69;0.5
0;KZ75125USD2069100107;2016-01-27;85;85;42.5;null;null;USD;23;11.5;108;54;0.5
0;KZ75125USD2069100107;2016-01-28;157;157;78.5;72;36;USD;null;null;85;42.5;0.5
0;KZ75125USD2069100107;2016-01-29;182;182;91;25;12.5;USD;null;null;157;78.5;0.5
0;KZ75125USD2069100107;2016-01-30;278;278;139;96;48;USD;null;null;182;91;0.5
0;KZ75125USD2069100107;2016-01-31;281;281;140.5;3;1.5;USD;null;null;278;139;0.5
0;KZ75125USD2069100107;2016-02-01;230;230;115;null;null;USD;51;25.5;281;140.5;0.5
0;KZ75125USD2069100107;2016-02-02;210;210;105;null;null;USD;20;10;230;115;0.5
0;KZ75125USD2069100107;2016-02-03;114;114;57;null;null;USD;96;48;210;105;0.5
0;KZ75125USD2069100107;2016-02-04;130;130;65;16;8;USD;null;null;114;57;0.5
0;KZ75125USD2069100107;2016-02-05;65;65;32.5;null;null;USD;65;32.5;130;65;0.5
0;KZ75125USD2069100107;2016-02-06;16;16;8;null;null;USD;49;24.5;65;32.5;0.5
0;KZ75125USD2069100107;2016-02-07;-39;-39;-19.5;null;null;USD;55;27.5;16;8;0.5
0;KZ75125USD2069100107;2016-02-08;-109;-109;-54.5;null;null;USD;70;35;-39;-19.5;0.5
0;KZ75125USD2069100107;2016-02-09;-95;-95;-47.5;14;7;USD;null;null;-109;-54.5;0.5
0;KZ75125USD2069100107;2016-02-10;-86;-86;-43;9;4.5;USD;null;null;-95;-47.5;0.5
0;KZ75125USD2069100107;2016-02-11;-70;-70;-35;16;8;USD;null;null;-86;-43;0.5
0;KZ75125USD2069100107;2016-02-12;-89;-89;-44.5;null;null;USD;19;9.5;-70;-35;0.5
0;KZ75125USD2069100107;2016-02-13;-103;-103;-51.5;null;null;USD;14;7;-89;-44.5;0.5
0;KZ75125USD2069100107;2016-02-14;-186;-186;-93;null;null;USD;83;41.5;-103;-51.5;0.5
0;KZ75125USD2069100107;2016-02-15;-250;-250;-125;null;null;USD;64;32;-186;-93;0.5
0;KZ75125USD2069100107;2016-02-16;-314;-314;-157;null;null;USD;64;32;-250;-125;0.5
0;KZ75125USD2069100107;2016-02-17;-218;-218;-109;96;48;USD;null;null;-314;-157;0.5
0;KZ75125USD2069100107;2016-02-18;-226;-226;-113;null;null;USD;8;4;-218;-109;0.5
0;KZ75125USD2069100107;2016-02-19;-146;-146;-73;80;40;USD;null;null;-226;-113;0.5
0;KZ75125USD2069100107;2016-02-20;-189;-189;-94.5;null;null;USD;43;21.5;-146;-73;0.5
0;KZ75125USD2069100107;2016-02-21;-252;-252;-126;null;null;USD;63;31.5;-189;-94.5;0.5
0;KZ75125USD2069100107;2016-02-22;-183;-183;-91.5;69;34.5;USD;null;null;-252;-126;0.5
0;KZ75125USD2069100107;2016-02-23;-226;-226;-113;null;null;USD;43;21.5;-183;-91.5;0.5
0;KZ75125USD2069100107;2016-02-24;-243;-243;-121.5;null;null;USD;17;8.5;-226;-113;0.5
0;KZ75125USD2069100107;2016-02-25;-333;-333;-166.5;null;null;USD;90;45;-243;-121.5;0.5
0;KZ75125USD2069100107;2016-02-26;-409;-409;-204.5;null;null;USD;76;38;-333;-166.5;0.5
0;KZ75125USD2069100107;2016-02-27;-499;-499;-249.5;null;null;USD;90;45;-409;-204.5;0.5
0;KZ75125USD2069100107;2016-02-28;-555;-555;-277.5;null;null;USD;56;28;-499;-249.5;0.5
0;KZ75125USD2069100107;2016-02-29;-510;-510;-255;45;22.5;USD;null;null;-555;-277.5;0.5
0;KZ75125USD2069100107;2016-03-01;-586;-586;-293;null;null;USD;76;38;-510;-255;0.5
0;KZ75125USD2069100107;2016-03-02;-533;-533;-266.5;53;26.5;USD;null;null;-586;-293;0.5
0;KZ75125USD2069100107;2016-03-03;-494;-494;-247;39;19.5;USD;null;null;-533;-266.5;0.5
0;KZ75125USD2069100107;2016-03-04;-537;-537;-268.5;null;null;USD;43;21.5;-494;-247;0.5
0;KZ75125USD2069100107;2016-03-05;-556;-556;-278;null;null;USD;19;9.5;-537;-268.5;0.5
0;KZ75125USD2069100107;2016-03-06;-609;-609;-304.5;null;null;USD;53;26.5;-556;-278;0.5
0;KZ75125USD2069100107;2016-03-07;-570;-570;-285;39;19.5;USD;null;null;-609;-304.5;0.5
0;KZ75125USD2069100107;2016-03-08;-484;-484;-242;86;43;USD;null;null;-570;-285;0.5
0;KZ75125USD2069100107;2016-03-09;-437;-437;-218.5;47;23.5;USD;null;null;-484;-242;0.5
0;KZ75125USD2069100107;2016-03-10;-433;-433;-216.5;4;2;USD;null;null;-437;-218.5;0.5
0;KZ75125USD2069100107;2016-03-11;-510;-510;-255;null;null;USD;77;38.5;-433;-216.5;0.5
0;KZ75125USD2069100107;2016-03-12;-468;-468;-234;42;21;USD;null;null;-510;-255;0.5
0;KZ75125USD2069100107;2016-03-13;-462;-462;-231;6;3;USD;null;null;-468;-234;0.5
0;KZ75125USD2069100107;2016-03-14;-364;-364;-182;98;49;USD;null;null;-462;-231;0.5
0;KZ75125USD2069100107;2016-03-15;-372;-372;-186;null;null;USD;8;4;-364;-182;0.5
0;KZ75125USD2069100107;2016-03-16;-460;-460;-230;null;null;USD;88;44;-372;-186;0.5
0;KZ75125USD2069100107;2016-03-17;-387;-387;-193.5;73;36.5;USD;null;null;-460;-230;0.5
0;KZ75125USD2069100107;2016-03-18;-377;-377;-188.5;10;5;USD;null;null;-387;-193.5;0.5
0;KZ75125USD2069100107;2016-03-19;-385;-385;-192.5;null;null;USD;8;4;-377;-188.5;0.5
0;KZ75125USD2069100107;2016-03-20;-360;-360;-180;25;12.5;USD;null;null;-385;-192.5;0.5
0;KZ75125USD2069100107;2016-03-21;-326;-326;-163;34;17;USD;null;null;-360;-180;0.5
0;KZ75125USD2069100107;2016-03-22;-319;-319;-159.5;7;3.5;USD;null;null;-326;-163;0.5
0;KZ75125USD2069100107;2016-03-23;-263;-263;-131.5;56;28;USD;null;null;-319;-159.5;0.5
0;KZ75125USD2069100107;2016-03-24;-294;-294;-147;null;null;USD;31;15.5;-263;-131.5;0.5
0;KZ75125USD2069100107;2016-03-25;-271;-271;-135.5;23;11.5;USD;null;null;-294;-147;0.5
0;KZ75125USD2069100107;2016-03-26;-254;-254;-127;17;8.5;USD;null;null;-271;-135.5;0.5
0;KZ75125USD2069100107;2016-03-27;-281;-281;-140.5;null;null;USD;27;13.5;-254;-127;0.5
0;KZ75125USD2069100107;2016-03-28;-377;-377;-188.5;null;null;USD;96;48;-281;-140.5;0.5
0;KZ75125USD2069100107;2016-03-29;-386;-386;-193;null;null;USD;9;4.5;-377;-188.5;0.5
0;KZ75125USD2069100107;2016-03-30;-366;-366;-183;20;10;USD;null;null;-386;-193;0.5
0;KZ75125USD2069100107;2016-03-31;-390;-390;-195;null;null;USD;24;12;-366;-183;0.5
0;KZ75125USD2069100107;2016-04-01;-398;-398;-199;null;null;USD;8;4;-390;-195;0.5
0;KZ75125USD2069100107;2016-04-02;-358;-358;-179;40;20;USD;null;null;-398;-199;0.5
0;KZ75125USD2069100107;2016-04-03;-306;-306;-153;52;26;USD;null;null;-358;-179;0.5
0;KZ75125USD2069100107;2016-04-04;-251;-251;-125.5;55;27.5;USD;null;null;-306;-153;0.5
0;KZ75125USD2069100107;2016-04-05;-285;-285;-142.5;null;null;USD;34;17;-251;-125.5;0.5
0;KZ75125USD2069100107;2016-04-06;-310;-310;-155;null;null;USD;25;12.5;-285;-142.5;0.5
0;KZ75125USD2069100107;2016-04-07;-371;-371;-185.5;null;null;USD;61;30.5;-310;-155;0.5
0;KZ75125USD2069100107;2016-04-08;-446;-446;-223;null;null;USD;75;37.5;-371;-185.5;0.5
0;KZ75125USD2069100107;2016-04-09;-537;-537;-268.5;null;null;USD;91;45.5;-446;-223;0.5
0;KZ75125USD2069100107;2016-04-10;-520;-520;-260;17;8.5;USD;null;null;-537;-268.5;0.5
0;KZ75125USD2069100107;2016-04-11;-543;-543;-271.5;null;null;USD;23;11.5;-520;-260;0.5
0;KZ75125USD2069100107;2016-04-12;-526;-526;-263;17;8.5;USD;null;null;-543;-271.5;0.5
0;KZ75125USD2069100107;2016-04-13;-532;-532;-266;null;null;USD;6;3;-526;-263;0.5
0;KZ75125USD2069100107;2016-04-14;-590;-590;-295;null;null;USD;58;29;-532;-266;0.5
0;KZ75125USD2069100107;2016-04-15;-683;-683;-341.5;null;null;USD;93;46.5;-590;-295;0.5
0;KZ75125USD2069100107;2016-04-16;-747;-747;-373.5;null;null;USD;64;32;-683;-341.5;0.5
0;KZ75125USD2069100107;2016-04-17;-661;-661;-330.5;86;43;USD;null;null;-747;-373.5;0.5
0;KZ75125USD2069100107;2016-04-18;-744;-744;-372;null;null;USD;83;41.5;-661;-330.5;0.5
0;KZ75125USD2069100107;2016-04-19;-787;-787;-393.5;null;null;USD;43;21.5;-744;-372;0.5
0;KZ75125USD2069100107;2016-04-20;-755;-755;-377.5;32;16;USD;null;null;-787;-393.5;0.5
0;KZ75125USD2069100107;2016-04-21;-810;-810;-405;null;null;USD;55;27.5;-755;-377.5;0.5
0;KZ75125USD2069100107;2016-04-22;-909;-909;-454.5;null;null;USD;99;49.5;-810;-405;0.5
0;KZ75125USD2069100107;2016-04-23;-875;-875;-437.5;34;17;USD;null;null;-909;-454.5;0.5
0;KZ75125USD2069100107;2016-04-24;-926;-926;-463;null;null;USD;51;25.5;-875;-437.5;0.5
0;KZ75125USD2069100107;2016-04-25;-841;-841;-420.5;85;42.5;USD;null;null;-926;-463;0.5
0;KZ75125USD2069100107;2016-04-26;-869;-869;-434.5;null;null;USD;28;14;-841;-420.5;0.5
0;KZ75125USD2069100107;2016-04-27;-916;-916;-458;null;null;USD;47;23.5;-869;-434.5;0.5
0;KZ75125USD2069100107;2016-04-28;-898;-898;-449;18;9;USD;null;null;-916;-458;0.5
0;KZ75125USD2069100107;2016-04-29;-890;-890;-445;8;4;USD;null;null;-898;-449;0.5
0;KZ75125USD2069100107;2016-04-30;-944;-944;-472;null;null;USD;54;27;-890;-445;0.5
0;KZ75125USD2069100107;2016-05-01;-942;-942;-471;2;1;USD;null;null;-944;-472;0.5
0;KZ75125USD2069100107;2016-05-02;-850;-850;-425;92;46;USD;null;null;-942;-471;0.5
0;KZ75125USD2069100107;2016-05-03;-751;-751;-375.5;99;49.5;USD;null;null;-850;-425;0.5
0;KZ75125USD2069100107;2016-05-04;-692;-692;-346;59;29.5;USD;null;null;-751;-375.5;0.5
0;KZ75125USD2069100107;2016-05-05;-686;-686;-343;6;3;USD;null;null;-692;-346;0.5
0;KZ75125USD2069100107;2016-05-06;-623;-623;-311.5;63;31.5;USD;null;null;-686;-343;0.5
0;KZ75125USD2069100107;2016-05-07;-653;-653;-326.5;null;null;USD;30;15;-623;-311.5;0.5
0;KZ75125USD2069100107;2016-05-08;-714;-714;-357;null;null;USD;61;30.5;-653;-326.5;0.5
0;KZ75125USD2069100107;2016-05-09;-779;-779;-389.5;null;null;USD;65;32.5;-714;-357;0.5
0;KZ75125USD2069100107;2016-05-10;-719;-719;-359.5;60;30;USD;null;null;-779;-389.5;0.5
0;KZ75125USD2069100107;2016-05-11;-738;-738;-369;null;null;USD;19;9.5;-719;-359.5;0.5
0;KZ75125USD2069100107;2016-05-12;-799;-799;-399.5;null;null;USD;61;30.5;-738;-369;0.5
0;KZ75125USD2069100107;2016-05-13;-847;-847;-423.5;null;null;USD;48;24;-799;-399.5;0.5
0;KZ75125USD2069100107;2016-05-14;-925;-925;-462.5;null;null;USD;78;39;-847;-423.5;0.5
0;KZ75125USD2069100107;2016-05-15;-865;-865;-432.5;60;30;USD;null;null;-925;-462.5;0.5
0;KZ75125USD2069100107;2016-05-16;-811;-811;-405.5;54;27;USD;null;null;-865;-432.5;0.5
0;KZ75125USD2069100107;2016-05-17;-899;-899;-449.5;null;null;USD;88;44;-811;-405.5;0.5
0;KZ75125USD2069100107;2016-05-18;-837;-837;-418.5;62;31;USD;null;null;-899;-449.5;0.5
0;KZ75125USD2069100107;2016-05-19;-904;-904;-452;null;null;USD;67;33.5;-837;-418.5;0.5
0;KZ75125USD2069100107;2016-05-20;-966;-966;-483;null;null;USD;62;31;-904;-452;0.5
0;KZ75125USD2069100107;2016-05-21;-951;-951;-475.5;15;7.5;USD;null;null;-966;-483;0.5
0;KZ75125USD2069100107;2016-05-22;-978;-978;-489;null;null;USD;27;13.5;-951;-475.5;0.5
0;KZ75125USD2069100107;2016-05-23;-1041;-1041;-520.5;null;null;USD;63;31.5;-978;-489;0.5
0;KZ75125USD2069100107;2016-05-24;-1130;-1130;-565;null;null;USD;89;44.5;-1041;-520.5;0.5
0;KZ75125USD2069100107;2016-05-25;-1033;-1033;-516.5;97;48.5;USD;null;null;-1130;-565;0.5
0;KZ75125USD2069100107;2016-05-26;-1098;-1098;-549;null;null;USD;65;32.5;-1033;-516.5;0.5
0;KZ75125USD2069100107;2016-05-27;-1055;-1055;-527.5;43;21.5;USD;null;null;-1098;-549;0.5
0;KZ75125USD2069100107;2016-05-28;-957;-957;-478.5;98;49;USD;null;null;-1055;-527.5;0.5
0;KZ75125USD2069100107;2016-05-29;-917;-917;-458.5;40;20;USD;null;null;-957;-478.5;0.5
0;KZ75125USD2069100107;2016-05-30;-948;-948;-474;null;null;USD;31;15.5;-917;-458.5;0.5
0;KZ75125USD2069100107;2016-05-31;-881;-881;-440.5;67;33.5;USD;null;null;-948;-474;0.5
0;KZ75125USD2069100107;2016-06-01;-888;-888;-444;null;null;USD;7;3.5;-881;-440.5;0.5
0;KZ75125USD2069100107;2016-06-02;-942;-942;-471;null;null;USD;54;27;-888;-444;0.5
0;KZ75125USD2069100107;2016-06-03;-952;-952;-476;null;null;USD;10;5;-942;-471;0.5
0;KZ75125USD2069100107;2016-06-04;-888;-888;-444;64;32;USD;null;null;-952;-476;0.5
0;KZ75125USD2069100107;2016-06-05;-840;-840;-420;48;24;USD;null;null;-888;-444;0.5
0;KZ75125USD2069100107;2016-06-06;-751;-751;-375.5;89;44.5;USD;null;null;-840;-420;0.5
0;KZ75125USD2069100107;2016-06-07;-692;-692;-346;59;29.5;USD;null;null;-751;-375.5;0.5
0;KZ75125USD2069100107;2016-06-08;-621;-621;-310.5;71;35.5;USD;null;null;-692;-346;0.5
0;KZ75125USD2069100107;2016-06-09;-621;-621;-310.5;null;null;USD;0;0;-621;-310.5;0.5
0;KZ75125USD2069100107;2016-06-10;-658;-658;-329;null;null;USD;37;18.5;-621;-310.5;0.5
0;KZ75125USD2069100107;2016-06-11;-590;-590;-295;68;34;USD;null;null;-658;-329;0.5
0;KZ75125USD2069100107;2016-06-12;-494;-494;-247;96;48;USD;null;null;-590;-295;0.5
0;KZ75125USD2069100107;2016-06-13;-582;-582;-291;null;null;USD;88;44;-494;-247;0.5
0;KZ75125USD2069100107;2016-06-14;-513;-513;-256.5;69;34.5;USD;null;null;-582;-291;0.5
0;KZ75125USD2069100107;2016-06-15;-612;-612;-306;null;null;USD;99;49.5;-513;-256.5;0.5
0;KZ75125USD2069100107;2016-06-16;-628;-628;-314;null;null;USD;16;8;-612;-306;0.5
0;KZ75125USD2069100107;2016-06-17;-709;-709;-354.5;null;null;USD;81;40.5;-628;-314;0.5
0;KZ75125USD2069100107;2016-06-18;-708;-708;-354;1;0.5;USD;null;null;-709;-354.5;0.5
0;KZ75125USD2069100107;2016-06-19;-802;-802;-401;null;null;USD;94;47;-708;-354;0.5
0;KZ75125USD2069100107;2016-06-20;-704;-704;-352;98;49;USD;null;null;-802;-401;0.5
0;KZ75125USD2069100107;2016-06-21;-675;-675;-337.5;29;14.5;USD;null;null;-704;-352;0.5
0;KZ75125USD2069100107;2016-06-22;-645;-645;-322.5;30;15;USD;null;null;-675;-337.5;0.5
0;KZ75125USD2069100107;2016-06-23;-596;-596;-298;49;24.5;USD;null;null;-645;-322.5;0.5
0;KZ75125USD2069100107;2016-06-24;-513;-513;-256.5;83;41.5;USD;null;null;-596;-298;0.5
0;KZ75125USD2069100107;2016-06-25;-572;-572;-286;null;null;USD;59;29.5;-513;-256.5;0.5
0;KZ75125USD2069100107;2016-06-26;-513;-513;-256.5;59;29.5;USD;null;null;-572;-286;0.5
0;KZ75125USD2069100107;2016-06-27;-571;-571;-285.5;null;null;USD;58;29;-513;-256.5;0.5
0;KZ75125USD2069100107;2016-06-28;-607;-607;-303.5;null;null;USD;36;18;-571;-285.5;0.5
0;KZ75125USD2069100107;2016-06-29;-699;-699;-349.5;null;null;USD;92;46;-607;-303.5;0.5
0;KZ75125USD2069100107;2016-06-30;-617;-617;-308.5;82;41;USD;null;null;-699;-349.5;0.5
0;KZ75125USD2069100107;2016-07-01;-655;-655;-327.5;null;null;USD;38;19;-617;-308.5;0.5
0;KZ75125USD2069100107;2016-07-02;-665;-665;-332.5;null;null;USD;10;5;-655;-327.5;0.5
0;KZ75125USD2069100107;2016-07-03;-710;-710;-355;null;null;USD;45;22.5;-665;-332.5;0.5
0;KZ75125USD2069100107;2016-07-04;-666;-666;-333;44;22;USD;null;null;-710;-355;0.5
0;KZ75125USD2069100107;2016-07-05;-655;-655;-327.5;11;5.5;USD;null;null;-666;-333;0.5
0;KZ75125USD2069100107;2016-07-06;-657;-657;-328.5;null;null;USD;2;1;-655;-327.5;0.5
0;KZ75125USD2069100107;2016-07-07;-605;-605;-302.5;52;26;USD;null;null;-657;-328.5;0.5
0;KZ75125USD2069100107;2016-07-08;-524;-524;-262;81;40.5;USD;null;null;-605;-302.5;0.5
0;KZ75125USD2069100107;2016-07-09;-449;-449;-224.5;75;37.5;USD;null;null;-524;-262;0.5
0;KZ75125USD2069100107;2016-07-10;-529;-529;-264.5;null;null;USD;80;40;-449;-224.5;0.5
0;KZ75125USD2069100107;2016-07-11;-521;-521;-260.5;8;4;USD;null;null;-529;-264.5;0.5
0;KZ75125USD2069100107;2016-07-12;-523;-523;-261.5;null;null;USD;2;1;-521;-260.5;0.5
0;KZ75125USD2069100107;2016-07-13;-578;-578;-289;null;null;USD;55;27.5;-523;-261.5;0.5
0;KZ75125USD2069100107;2016-07-14;-550;-550;-275;28;14;USD;null;null;-578;-289;0.5
0;KZ75125USD2069100107;2016-07-15;-537;-537;-268.5;13;6.5;USD;null;null;-550;-275;0.5
0;KZ75125USD2069100107;2016-07-16;-613;-613;-306.5;null;null;USD;76;38;-537;-268.5;0.5
0;KZ75125USD2069100107;2016-07-17;-612;-612;-306;1;0.5;USD;null;null;-613;-306.5;0.5
0;KZ75125USD2069100107;2016-07-18;-670;-670;-335;null;null;USD;58;29;-612;-306;0.5
0;KZ75125USD2069100107;2016-07-19;-696;-696;-348;null;null;USD;26;13;-670;-335;0.5
0;KZ75125USD2069100107;2016-07-20;-776;-776;-388;null;null;USD;80;40;-696;-348;0.5
0;KZ75125USD2069100107;2016-07-21;-793;-793;-396.5;null;null;USD;17;8.5;-776;-388;0.5
0;KZ75125USD2069100107;2016-07-22;-700;-700;-350;93;46.5;USD;null;null;-793;-396.5;0.5
0;KZ75125USD2069100107;2016-07-23;-697;-697;-348.5;3;1.5;USD;null;null;-700;-350;0.5
0;KZ75125USD2069100107;2016-07-24;-781;-781;-390.5;null;null;USD;84;42;-697;-348.5;0.5
0;KZ75125USD2069100107;2016-07-25;-762;-762;-381;19;9.5;USD;null;null;-781;-390.5;0.5
0;KZ75125USD2069100107;2016-07-26;-741;-741;-370.5;21;10.5;USD;null;null;-762;-381;0.5
0;KZ75125USD2069100107;2016-07-27;-817;-817;-408.5;null;null;USD;76;38;-741;-370.5;0.5
0;KZ75125USD2069100107;2016-07-28;-804;-804;-402;13;6.5;USD;null;null;-817;-408.5;0.5
0;KZ75125USD2069100107;2016-07-29;-821;-821;-410.5;null;null;USD;17;8.5;-804;-402;0.5
0;KZ75125USD2069100107;2016-07-30;-797;-797;-398.5;24;12;USD;null;null;-821;-410.5;0.5
0;KZ75125USD2069100107;2016-07-31;-889;-889;-444.5;null;null;USD;92;46;-797;-398.5;0.5
0;KZ75125USD2069100107;2016-08-01;-956;-956;-478;null;null;USD;67;33.5;-889;-444.5;0.5
0;KZ75125USD2069100107;2016-08-02;-982;-982;-491;null;null;USD;26;13;-956;-478;0.5
0;KZ75125USD2069100107;2016-08-03;-1016;-1016;-508;null;null;USD;34;17;-982;-491;0.5
0;KZ75125USD2069100107;2016-08-04;-1075;-1075;-537.5;null;null;USD;59;29.5;-1016;-508;0.5
0;KZ75125USD2069100107;2016-08-05;-1109;-1109;-554.5;null;null;USD;34;17;-1075;-537.5;0.5
0;KZ75125USD2069100107;2016-08-06;-1119;-1119;-559.5;null;null;USD;10;5;-1109;-554.5;0.5
0;KZ75125USD2069100107;2016-08-07;-1140;-1140;-570;null;null;USD;21;10.5;-1119;-559.5;0.5
0;KZ75125USD2069100107;2016-08-08;-1195;-1195;-597.5;null;null;USD;55;27.5;-1140;-570;0.5
0;KZ75125USD2069100107;2016-08-09;-1233;-1233;-616.5;null;null;USD;38;19;-1195;-597.5;0.5
0;KZ75125USD2069100107;2016-08-10;-1138;-1138;-569;95;47.5;USD;null;null;-1233;-616.5;0.5
0;KZ75125USD2069100107;2016-08-11;-1146;-1146;-573;null;null;USD;8;4;-1138;-569;0.5
0;KZ75125USD2069100107;2016-08-12;-1179;-1179;-589.5;null;null;USD;33;16.5;-1146;-573;0.5
0;KZ75125USD2069100107;2016-08-13;-1190;-1190;-595;null;null;USD;11;5.5;-1179;-589.5;0.5
0;KZ75125USD2069100107;2016-08-14;-1141;-1141;-570.5;49;24.5;USD;null;null;-1190;-595;0.5
0;KZ75125USD2069100107;2016-08-15;-1193;-1193;-596.5;null;null;USD;52;26;-1141;-570.5;0.5
0;KZ75125USD2069100107;2016-08-16;-1279;-1279;-639.5;null;null;USD;86;43;-1193;-596.5;0.5
0;KZ75125USD2069100107;2016-08-17;-1253;-1253;-626.5;26;13;USD;null;null;-1279;-639.5;0.5
0;KZ75125USD2069100107;2016-08-18;-1324;-1324;-662;null;null;USD;71;35.5;-1253;-626.5;0.5
0;KZ75125USD2069100107;2016-08-19;-1414;-1414;-707;null;null;USD;90;45;-1324;-662;0.5
0;KZ75125USD2069100107;2016-08-20;-1491;-1491;-745.5;null;null;USD;77;38.5;-1414;-707;0.5
0;KZ75125USD2069100107;2016-08-21;-1534;-1534;-767;null;null;USD;43;21.5;-1491;-745.5;0.5
0;KZ75125USD2069100107;2016-08-22;-1580;-1580;-790;null;null;USD;46;23;-1534;-767;0.5
0;KZ75125USD2069100107;2016-08-23;-1608;-1608;-804;null;null;USD;28;14;-1580;-790;0.5
0;KZ75125USD2069100107;2016-08-24;-1643;-1643;-821.5;null;null;USD;35;17.5;-1608;-804;0.5
0;KZ75125USD2069100107;2016-08-25;-1664;-1664;-832;null;null;USD;21;10.5;-1643;-821.5;0.5
0;KZ75125USD2069100107;2016-08-26;-1679;-1679;-839.5;null;null;USD;15;7.5;-1664;-832;0.5
0;KZ75125USD2069100107;2016-08-27;-1723;-1723;-861.5;null;null;USD;44;22;-1679;-839.5;0.5
0;KZ75125USD2069100107;2016-08-28;-1723;-1723;-861.5;null;null;USD;0;0;-1723;-861.5;0.5
0;KZ75125USD2069100107;2016-08-29;-1688;-1688;-844;35;17.5;USD;null;null;-1723;-861.5;0.5
0;KZ75125USD2069100107;2016-08-30;-1612;-1612;-806;76;38;USD;null;null;-1688;-844;0.5
0;KZ75125USD2069100107;2016-08-31;-1607;-1607;-803.5;5;2.5;USD;null;null;-1612;-806;0.5
0;KZ75125USD2069100107;2016-09-01;-1669;-1669;-834.5;null;null;USD;62;31;-1607;-803.5;0.5
0;KZ75125USD2069100107;2016-09-02;-1586;-1586;-793;83;41.5;USD;null;null;-1669;-834.5;0.5
0;KZ75125USD2069100107;2016-09-03;-1573;-1573;-786.5;13;6.5;USD;null;null;-1586;-793;0.5
0;KZ75125USD2069100107;2016-09-04;-1621;-1621;-810.5;null;null;USD;48;24;-1573;-786.5;0.5
0;KZ75125USD2069100107;2016-09-05;-1568;-1568;-784;53;26.5;USD;null;null;-1621;-810.5;0.5
0;KZ75125USD2069100107;2016-09-06;-1511;-1511;-755.5;57;28.5;USD;null;null;-1568;-784;0.5
0;KZ75125USD2069100107;2016-09-07;-1598;-1598;-799;null;null;USD;87;43.5;-1511;-755.5;0.5
0;KZ75125USD2069100107;2016-09-08;-1534;-1534;-767;64;32;USD;null;null;-1598;-799;0.5
0;KZ75125USD2069100107;2016-09-09;-1619;-1619;-809.5;null;null;USD;85;42.5;-1534;-767;0.5
0;KZ75125USD2069100107;2016-09-10;-1657;-1657;-828.5;null;null;USD;38;19;-1619;-809.5;0.5
0;KZ75125USD2069100107;2016-09-11;-1645;-1645;-822.5;12;6;USD;null;null;-1657;-828.5;0.5
0;KZ75125USD2069100107;2016-09-12;-1708;-1708;-854;null;null;USD;63;31.5;-1645;-822.5;0.5
0;KZ75125USD2069100107;2016-09-13;-1805;-1805;-902.5;null;null;USD;97;48.5;-1708;-854;0.5
0;KZ75125USD2069100107;2016-09-14;-1864;-1864;-932;null;null;USD;59;29.5;-1805;-902.5;0.5
0;KZ75125USD2069100107;2016-09-15;-1911;-1911;-955.5;null;null;USD;47;23.5;-1864;-932;0.5
0;KZ75125USD2069100107;2016-09-16;-1822;-1822;-911;89;44.5;USD;null;null;-1911;-955.5;0.5
0;KZ75125USD2069100107;2016-09-17;-1899;-1899;-949.5;null;null;USD;77;38.5;-1822;-911;0.5
0;KZ75125USD2069100107;2016-09-18;-1988;-1988;-994;null;null;USD;89;44.5;-1899;-949.5;0.5
0;KZ75125USD2069100107;2016-09-19;-2028;-2028;-1014;null;null;USD;40;20;-1988;-994;0.5
0;KZ75125USD2069100107;2016-09-20;-1974;-1974;-987;54;27;USD;null;null;-2028;-1014;0.5
0;KZ75125USD2069100107;2016-09-21;-2012;-2012;-1006;null;null;USD;38;19;-1974;-987;0.5
0;KZ75125USD2069100107;2016-09-22;-1923;-1923;-961.5;89;44.5;USD;null;null;-2012;-1006;0.5
0;KZ75125USD2069100107;2016-09-23;-1902;-1902;-951;21;10.5;USD;null;null;-1923;-961.5;0.5
0;KZ75125USD2069100107;2016-09-24;-1848;-1848;-924;54;27;USD;null;null;-1902;-951;0.5
0;KZ75125USD2069100107;2016-09-25;-1922;-1922;-961;null;null;USD;74;37;-1848;-924;0.5
0;KZ75125USD2069100107;2016-09-26;-1827;-1827;-913.5;95;47.5;USD;null;null;-1922;-961;0.5
0;KZ75125USD2069100107;2016-09-27;-1745;-1745;-872.5;82;41;USD;null;null;-1827;-913.5;0.5
0;KZ75125USD2069100107;2016-09-28;-1820;-1820;-910;null;null;USD;75;37.5;-1745;-872.5;0.5
0;KZ75125USD2069100107;2016-09-29;-1904;-1904;-952;null;null;USD;84;42;-1820;-910;0.5
0;KZ75125USD2069100107;2016-09-30;-1916;-1916;-958;null;null;USD;12;6;-1904;-952;0.5
0;KZ75125USD2069100107;2016-10-01;-1900;-1900;-950;16;8;USD;null;null;-1916;-958;0.5
0;KZ75125USD2069100107;2016-10-02;-1822;-1822;-911;78;39;USD;null;null;-1900;-950;0.5
0;KZ75125USD2069100107;2016-10-03;-1866;-1866;-933;null;null;USD;44;22;-1822;-911;0.5
0;KZ75125USD2069100107;2016-10-04;-1964;-1964;-982;null;null;USD;98;49;-1866;-933;0.5
0;KZ75125USD2069100107;2016-10-05;-1990;-1990;-995;null;null;USD;26;13;-1964;-982;0.5
0;KZ75125USD2069100107;2016-10-06;-2003;-2003;-1001.5;null;null;USD;13;6.5;-1990;-995;0.5
0;KZ75125USD2069100107;2016-10-07;-2046;-2046;-1023;null;null;USD;43;21.5;-2003;-1001.5;0.5
0;KZ75125USD2069100107;2016-10-08;-2026;-2026;-1013;20;10;USD;null;null;-2046;-1023;0.5
0;KZ75125USD2069100107;2016-10-09;-1964;-1964;-982;62;31;USD;null;null;-2026;-1013;0.5
0;KZ75125USD2069100107;2016-10-10;-2021;-2021;-1010.5;null;null;USD;57;28.5;-1964;-982;0.5
0;KZ75125USD2069100107;2016-10-11;-2006;-2006;-1003;15;7.5;USD;null;null;-2021;-1010.5;0.5
0;KZ75125USD2069100107;2016-10-12;-1954;-1954;-977;52;26;USD;null;null;-2006;-1003;0.5
0;KZ75125USD2069100107;2016-10-13;-1911;-1911;-955.5;43;21.5;USD;null;null;-1954;-977;0.5
0;KZ75125USD2069100107;2016-10-14;-1952;-1952;-976;null;null;USD;41;20.5;-1911;-955.5;0.5
0;KZ75125USD2069100107;2016-10-15;-1956;-1956;-978;null;null;USD;4;2;-1952;-976;0.5
0;KZ75125USD2069100107;2016-10-16;-1922;-1922;-961;34;17;USD;null;null;-1956;-978;0.5
0;KZ75125USD2069100107;2016-10-17;-1998;-1998;-999;null;null;USD;76;38;-1922;-961;0.5
0;KZ75125USD2069100107;2016-10-18;-1924;-1924;-962;74;37;USD;null;null;-1998;-999;0.5
0;KZ75125USD2069100107;2016-10-19;-2023;-2023;-1011.5;null;null;USD;99;49.5;-1924;-962;0.5
0;KZ75125USD2069100107;2016-10-20;-1930;-1930;-965;93;46.5;USD;null;null;-2023;-1011.5;0.5
0;KZ75125USD2069100107;2016-10-21;-2006;-2006;-1003;null;null;USD;76;38;-1930;-965;0.5
0;KZ75125USD2069100107;2016-10-22;-2023;-2023;-1011.5;null;null;USD;17;8.5;-2006;-1003;0.5
0;KZ75125USD2069100107;2016-10-23;-1949;-1949;-974.5;74;37;USD;null;null;-2023;-1011.5;0.5
0;KZ75125USD2069100107;2016-10-24;-1979;-1979;-989.5;null;null;USD;30;15;-1949;-974.5;0.5
0;KZ75125USD2069100107;2016-10-25;-1989;-1989;-994.5;null;null;USD;10;5;-1979;-989.5;0.5
0;KZ75125USD2069100107;2016-10-26;-2068;-2068;-1034;null;null;USD;79;39.5;-1989;-994.5;0.5
0;KZ75125USD2069100107;2016-10-27;-1989;-1989;-994.5;79;39.5;USD;null;null;-2068;-1034;0.5
0;KZ75125USD2069100107;2016-10-28;-2064;-2064;-1032;null;null;USD;75;37.5;-1989;-994.5;0.5
0;KZ75125USD2069100107;2016-10-29;-2044;-2044;-1022;20;10;USD;null;null;-2064;-1032;0.5
0;KZ75125USD2069100107;2016-10-30;-2137;-2137;-1068.5;null;null;USD;93;46.5;-2044;-1022;0.5
0;KZ75125USD2069100107;2016-10-31;-2058;-2058;-1029;79;39.5;USD;null;null;-2137;-1068.5;0.5
0;KZ75125USD2069100107;2016-11-01;-2089;-2089;-1044.5;null;null;USD;31;15.5;-2058;-1029;0.5
0;KZ75125USD2069100107;2016-11-02;-2106;-2106;-1053;null;null;USD;17;8.5;-2089;-1044.5;0.5
0;KZ75125USD2069100107;2016-11-03;-2051;-2051;-1025.5;55;27.5;USD;null;null;-2106;-1053;0.5
0;KZ75125USD2069100107;2016-11-04;-1983;-1983;-991.5;68;34;USD;null;null;-2051;-1025.5;0.5
0;KZ75125USD2069100107;2016-11-05;-2076;-2076;-1038;null;null;USD;93;46.5;-1983;-991.5;0.5
0;KZ75125USD2069100107;2016-11-06;-2150;-2150;-1075;null;null;USD;74;37;-2076;-1038;0.5
0;KZ75125USD2069100107;2016-11-07;-2178;-2178;-1089;null;null;USD;28;14;-2150;-1075;0.5
0;KZ75125USD2069100107;2016-11-08;-2091;-2091;-1045.5;87;43.5;USD;null;null;-2178;-1089;0.5
0;KZ75125USD2069100107;2016-11-09;-2071;-2071;-1035.5;20;10;USD;null;null;-2091;-1045.5;0.5
0;KZ75125USD2069100107;2016-11-10;-2082;-2082;-1041;null;null;USD;11;5.5;-2071;-1035.5;0.5
0;KZ75125USD2069100107;2016-11-11;-2047;-2047;-1023.5;35;17.5;USD;null;null;-2082;-1041;0.5
0;KZ75125USD2069100107;2016-11-12;-2086;-2086;-1043;null;null;USD;39;19.5;-2047;-1023.5;0.5
0;KZ75125USD2069100107;2016-11-13;-2185;-2185;-1092.5;null;null;USD;99;49.5;-2086;-1043;0.5
0;KZ75125USD2069100107;2016-11-14;-2202;-2202;-1101;null;null;USD;17;8.5;-2185;-1092.5;0.5
0;KZ75125USD2069100107;2016-11-15;-2149;-2149;-1074.5;53;26.5;USD;null;null;-2202;-1101;0.5
0;KZ75125USD2069100107;2016-11-16;-2192;-2192;-1096;null;null;USD;43;21.5;-2149;-1074.5;0.5
0;KZ75125USD2069100107;2016-11-17;-2179;-2179;-1089.5;13;6.5;USD;null;null;-2192;-1096;0.5
0;KZ75125USD2069100107;2016-11-18;-2110;-2110;-1055;69;34.5;USD;null;null;-2179;-1089.5;0.5
0;KZ75125USD2069100107;2016-11-19;-2036;-2036;-1018;74;37;USD;null;null;-2110;-1055;0.5
0;KZ75125USD2069100107;2016-11-20;-2016;-2016;-1008;20;10;USD;null;null;-2036;-1018;0.5
0;KZ75125USD2069100107;2016-11-21;-1934;-1934;-967;82;41;USD;null;null;-2016;-1008;0.5
0;KZ75125USD2069100107;2016-11-22;-1912;-1912;-956;22;11;USD;null;null;-1934;-967;0.5
0;KZ75125USD2069100107;2016-11-23;-1869;-1869;-934.5;43;21.5;USD;null;null;-1912;-956;0.5
0;KZ75125USD2069100107;2016-11-24;-1899;-1899;-949.5;null;null;USD;30;15;-1869;-934.5;0.5
0;KZ75125USD2069100107;2016-11-25;-1933;-1933;-966.5;null;null;USD;34;17;-1899;-949.5;0.5
0;KZ75125USD2069100107;2016-11-26;-1970;-1970;-985;null;null;USD;37;18.5;-1933;-966.5;0.5
0;KZ75125USD2069100107;2016-11-27;-1941;-1941;-970.5;29;14.5;USD;null;null;-1970;-985;0.5
0;KZ75125USD2069100107;2016-11-28;-2022;-2022;-1011;null;null;USD;81;40.5;-1941;-970.5;0.5
0;KZ75125USD2069100107;2016-11-29;-2037;-2037;-1018.5;null;null;USD;15;7.5;-2022;-1011;0.5
0;KZ75125USD2069100107;2016-11-30;-1976;-1976;-988;61;30.5;USD;null;null;-2037;-1018.5;0.5
0;KZ75125USD2069100107;2016-12-01;-1988;-1988;-994;null;null;USD;12;6;-1976;-988;0.5
0;KZ75125USD2069100107;2016-12-02;-1931;-1931;-965.5;57;28.5;USD;null;null;-1988;-994;0.5
0;KZ75125USD2069100107;2016-12-03;-1912;-1912;-956;19;9.5;USD;null;null;-1931;-965.5;0.5
0;KZ75125USD2069100107;2016-12-04;-1903;-1903;-951.5;9;4.5;USD;null;null;-1912;-956;0.5
0;KZ75125USD2069100107;2016-12-05;-1829;-1829;-914.5;74;37;USD;null;null;-1903;-951.5;0.5
0;KZ75125USD2069100107;2016-12-06;-1816;-1816;-908;13;6.5;USD;null;null;-1829;-914.5;0.5
0;KZ75125USD2069100107;2016-12-07;-1907;-1907;-953.5;null;null;USD;91;45.5;-1816;-908;0.5
0;KZ75125USD2069100107;2016-12-08;-1838;-1838;-919;69;34.5;USD;null;null;-1907;-953.5;0.5
0;KZ75125USD2069100107;2016-12-09;-1749;-1749;-874.5;89;44.5;USD;null;null;-1838;-919;0.5
0;KZ75125USD2069100107;2016-12-10;-1827;-1827;-913.5;null;null;USD;78;39;-1749;-874.5;0.5
0;KZ75125USD2069100107;2016-12-11;-1775;-1775;-887.5;52;26;USD;null;null;-1827;-913.5;0.5
0;KZ75125USD2069100107;2016-12-12;-1836;-1836;-918;null;null;USD;61;30.5;-1775;-887.5;0.5
0;KZ75125USD2069100107;2016-12-13;-1775;-1775;-887.5;61;30.5;USD;null;null;-1836;-918;0.5
0;KZ75125USD2069100107;2016-12-14;-1809;-1809;-904.5;null;null;USD;34;17;-1775;-887.5;0.5
0;KZ75125USD2069100107;2016-12-15;-1752;-1752;-876;57;28.5;USD;null;null;-1809;-904.5;0.5
0;KZ75125USD2069100107;2016-12-16;-1832;-1832;-916;null;null;USD;80;40;-1752;-876;0.5
0;KZ75125USD2069100107;2016-12-17;-1734;-1734;-867;98;49;USD;null;null;-1832;-916;0.5
0;KZ75125USD2069100107;2016-12-18;-1687;-1687;-843.5;47;23.5;USD;null;null;-1734;-867;0.5
0;KZ75125USD2069100107;2016-12-19;-1684;-1684;-842;3;1.5;USD;null;null;-1687;-843.5;0.5
0;KZ75125USD2069100107;2016-12-20;-1751;-1751;-875.5;null;null;USD;67;33.5;-1684;-842;0.5
0;KZ75125USD2069100107;2016-12-21;-1717;-1717;-858.5;34;17;USD;null;null;-1751;-875.5;0.5
0;KZ75125USD2069100107;2016-12-22;-1747;-1747;-873.5;null;null;USD;30;15;-1717;-858.5;0.5
0;KZ75125USD2069100107;2016-12-23;-1711;-1711;-855.5;36;18;USD;null;null;-1747;-873.5;0.5
0;KZ75125USD2069100107;2016-12-24;-1805;-1805;-902.5;null;null;USD;94;47;-1711;-855.5;0.5
0;KZ75125USD2069100107;2016-12-25;-1730;-1730;-865;75;37.5;USD;null;null;-1805;-902.5;0.5
0;KZ75125USD2069100107;2016-12-26;-1666;-1666;-833;64;32;USD;null;null;-1730;-865;0.5
0;KZ75125USD2069100107;2016-12-27;-1612;-1612;-806;54;27;USD;null;null;-1666;-833;0.5
0;KZ75125USD2069100107;2016-12-28;-1710;-1710;-855;null;null;USD;98;49;-1612;-806;0.5
0;KZ75125USD2069100107;2016-12-29;-1705;-1705;-852.5;5;2.5;USD;null;null;-1710;-855;0.5
0;KZ75125USD2069100107;2016-12-30;-1701;-1701;-850.5;4;2;USD;null;null;-1705;-852.5;0.5
0;KZ75125USD2069100107;2016-12-31;-1728;-1728;-864;null;null;USD;27;13.5;-1701;-850.5;0.5
0;KZ75125USD2069100107;2017-01-01;-1669;-1669;-834.5;59;29.5;USD;null;null;-1728;-864;0.5
0;KZ75125USD2069100107;2017-01-02;-1699;-1699;-849.5;null;null;USD;30;15;-1669;-834.5;0.5
0;KZ75125USD2069100107;2017-01-03;-1768;-1768;-884;null;null;USD;69;34.5;-1699;-849.5;0.5
0;KZ75125USD2069100107;2017-01-04;-1697;-1697;-848.5;71;35.5;USD;null;null;-1768;-884;0.5
0;KZ75125USD2069100107;2017-01-05;-1791;-1791;-895.5;null;null;USD;94;47;-1697;-848.5;0.5
0;KZ75125USD2069100107;2017-01-06;-1841;-1841;-920.5;null;null;USD;50;25;-1791;-895.5;0.5
0;KZ75125USD2069100107;2017-01-07;-1750;-1750;-875;91;45.5;USD;null;null;-1841;-920.5;0.5
0;KZ75125USD2069100107;2017-01-08;-1758;-1758;-879;null;null;USD;8;4;-1750;-875;0.5
0;KZ75125USD2069100107;2017-01-09;-1825;-1825;-912.5;null;null;USD;67;33.5;-1758;-879;0.5
0;KZ75125USD2069100107;2017-01-10;-1741;-1741;-870.5;84;42;USD;null;null;-1825;-912.5;0.5
0;KZ75125USD2069100107;2017-01-11;-1659;-1659;-829.5;82;41;USD;null;null;-1741;-870.5;0.5
0;KZ75125USD2069100107;2017-01-12;-1702;-1702;-851;null;null;USD;43;21.5;-1659;-829.5;0.5
0;KZ75125USD2069100107;2017-01-13;-1762;-1762;-881;null;null;USD;60;30;-1702;-851;0.5
0;KZ75125USD2069100107;2017-01-14;-1729;-1729;-864.5;33;16.5;USD;null;null;-1762;-881;0.5
0;KZ75125USD2069100107;2017-01-15;-1687;-1687;-843.5;42;21;USD;null;null;-1729;-864.5;0.5
0;KZ75125USD2069100107;2017-01-16;-1681;-1681;-840.5;6;3;USD;null;null;-1687;-843.5;0.5
0;KZ75125USD2069100107;2017-01-17;-1688;-1688;-844;null;null;USD;7;3.5;-1681;-840.5;0.5
0;KZ75125USD2069100107;2017-01-18;-1703;-1703;-851.5;null;null;USD;15;7.5;-1688;-844;0.5
0;KZ75125USD2069100107;2017-01-19;-1739;-1739;-869.5;null;null;USD;36;18;-1703;-851.5;0.5
0;KZ75125USD2069100107;2017-01-20;-1745;-1745;-872.5;null;null;USD;6;3;-1739;-869.5;0.5
0;KZ75125USD2069100107;2017-01-21;-1816;-1816;-908;null;null;USD;71;35.5;-1745;-872.5;0.5
0;KZ75125USD2069100107;2017-01-22;-1880;-1880;-940;null;null;USD;64;32;-1816;-908;0.5
0;KZ75125USD2069100107;2017-01-23;-1874;-1874;-937;6;3;USD;null;null;-1880;-940;0.5
0;KZ75125USD2069100107;2017-01-24;-1802;-1802;-901;72;36;USD;null;null;-1874;-937;0.5
0;KZ75125USD2069100107;2017-01-25;-1813;-1813;-906.5;null;null;USD;11;5.5;-1802;-901;0.5
0;KZ75125USD2069100107;2017-01-26;-1807;-1807;-903.5;6;3;USD;null;null;-1813;-906.5;0.5
0;KZ75125USD2069100107;2017-01-27;-1874;-1874;-937;null;null;USD;67;33.5;-1807;-903.5;0.5
0;KZ75125USD2069100107;2017-01-28;-1917;-1917;-958.5;null;null;USD;43;21.5;-1874;-937;0.5
0;KZ75125USD2069100107;2017-01-29;-1888;-1888;-944;29;14.5;USD;null;null;-1917;-958.5;0.5
0;KZ75125USD2069100107;2017-01-30;-1920;-1920;-960;null;null;USD;32;16;-1888;-944;0.5
0;KZ75125USD2069100107;2017-01-31;-1930;-1930;-965;null;null;USD;10;5;-1920;-960;0.5
0;KZ75125USD2069100107;2017-02-01;-1993;-1993;-996.5;null;null;USD;63;31.5;-1930;-965;0.5
0;KZ75125USD2069100107;2017-02-02;-2051;-2051;-1025.5;null;null;USD;58;29;-1993;-996.5;0.5
0;KZ75125USD2069100107;2017-02-03;-2021;-2021;-1010.5;30;15;USD;null;null;-2051;-1025.5;0.5
0;KZ75125USD2069100107;2017-02-04;-1935;-1935;-967.5;86;43;USD;null;null;-2021;-1010.5;0.5
0;KZ75125USD2069100107;2017-02-05;-1980;-1980;-990;null;null;USD;45;22.5;-1935;-967.5;0.5
0;KZ75125USD2069100107;2017-02-06;-1965;-1965;-982.5;15;7.5;USD;null;null;-1980;-990;0.5
0;KZ75125USD2069100107;2017-02-07;-2004;-2004;-1002;null;null;USD;39;19.5;-1965;-982.5;0.5
0;KZ75125USD2069100107;2017-02-08;-2055;-2055;-1027.5;null;null;USD;51;25.5;-2004;-1002;0.5
0;KZ75125USD2069100107;2017-02-09;-2109;-2109;-1054.5;null;null;USD;54;27;-2055;-1027.5;0.5
0;KZ75125USD2069100107;2017-02-10;-2095;-2095;-1047.5;14;7;USD;null;null;-2109;-1054.5;0.5
0;KZ75125USD2069100107;2017-02-11;-2112;-2112;-1056;null;null;USD;17;8.5;-2095;-1047.5;0.5
0;KZ75125USD2069100107;2017-02-12;-2201;-2201;-1100.5;null;null;USD;89;44.5;-2112;-1056;0.5
0;KZ75125USD2069100107;2017-02-13;-2118;-2118;-1059;83;41.5;USD;null;null;-2201;-1100.5;0.5
0;KZ75125USD2069100107;2017-02-14;-2193;-2193;-1096.5;null;null;USD;75;37.5;-2118;-1059;0.5
0;KZ75125USD2069100107;2017-02-15;-2272;-2272;-1136;null;null;USD;79;39.5;-2193;-1096.5;0.5
0;KZ75125USD2069100107;2017-02-16;-2324;-2324;-1162;null;null;USD;52;26;-2272;-1136;0.5
0;KZ75125USD2069100107;2017-02-17;-2259;-2259;-1129.5;65;32.5;USD;null;null;-2324;-1162;0.5
0;KZ75125USD2069100107;2017-02-18;-2256;-2256;-1128;3;1.5;USD;null;null;-2259;-1129.5;0.5
0;KZ75125USD2069100107;2017-02-19;-2248;-2248;-1124;8;4;USD;null;null;-2256;-1128;0.5
0;KZ75125USD2069100107;2017-02-20;-2294;-2294;-1147;null;null;USD;46;23;-2248;-1124;0.5
0;KZ75125USD2069100107;2017-02-21;-2328;-2328;-1164;null;null;USD;34;17;-2294;-1147;0.5
0;KZ75125USD2069100107;2017-02-22;-2291;-2291;-1145.5;37;18.5;USD;null;null;-2328;-1164;0.5
0;KZ75125USD2069100107;2017-02-23;-2375;-2375;-1187.5;null;null;USD;84;42;-2291;-1145.5;0.5
0;KZ75125USD2069100107;2017-02-24;-2303;-2303;-1151.5;72;36;USD;null;null;-2375;-1187.5;0.5
0;KZ75125USD2069100107;2017-02-25;-2277;-2277;-1138.5;26;13;USD;null;null;-2303;-1151.5;0.5
0;KZ75125USD2069100107;2017-02-26;-2249;-2249;-1124.5;28;14;USD;null;null;-2277;-1138.5;0.5
0;KZ75125USD2069100107;2017-02-27;-2344;-2344;-1172;null;null;USD;95;47.5;-2249;-1124.5;0.5
0;KZ75125USD2069100107;2017-02-28;-2362;-2362;-1181;null;null;USD;18;9;-2344;-1172;0.5
0;KZ75125USD2069100107;2017-03-01;-2430;-2430;-1215;null;null;USD;68;34;-2362;-1181;0.5
0;KZ75125USD2069100107;2017-03-02;-2346;-2346;-1173;84;42;USD;null;null;-2430;-1215;0.5
0;KZ75125USD2069100107;2017-03-03;-2436;-2436;-1218;null;null;USD;90;45;-2346;-1173;0.5
0;KZ75125USD2069100107;2017-03-04;-2355;-2355;-1177.5;81;40.5;USD;null;null;-2436;-1218;0.5
0;KZ75125USD2069100107;2017-03-05;-2262;-2262;-1131;93;46.5;USD;null;null;-2355;-1177.5;0.5
0;KZ75125USD2069100107;2017-03-06;-2213;-2213;-1106.5;49;24.5;USD;null;null;-2262;-1131;0.5
0;KZ75125USD2069100107;2017-03-07;-2170;-2170;-1085;43;21.5;USD;null;null;-2213;-1106.5;0.5
0;KZ75125USD2069100107;2017-03-08;-2089;-2089;-1044.5;81;40.5;USD;null;null;-2170;-1085;0.5
0;KZ75125USD2069100107;2017-03-09;-2045;-2045;-1022.5;44;22;USD;null;null;-2089;-1044.5;0.5
0;KZ75125USD2069100107;2017-03-10;-2004;-2004;-1002;41;20.5;USD;null;null;-2045;-1022.5;0.5
0;KZ75125USD2069100107;2017-03-11;-1907;-1907;-953.5;97;48.5;USD;null;null;-2004;-1002;0.5
0;KZ75125USD2069100107;2017-03-12;-1900;-1900;-950;7;3.5;USD;null;null;-1907;-953.5;0.5
0;KZ75125USD2069100107;2017-03-13;-1945;-1945;-972.5;null;null;USD;45;22.5;-1900;-950;0.5
0;KZ75125USD2069100107;2017-03-14;-1859;-1859;-929.5;86;43;USD;null;null;-1945;-972.5;0.5
0;KZ75125USD2069100107;2017-03-15;-1791;-1791;-895.5;68;34;USD;null;null;-1859;-929.5;0.5
0;KZ75125USD2069100107;2017-03-16;-1722;-1722;-861;69;34.5;USD;null;null;-1791;-895.5;0.5
0;KZ75125USD2069100107;2017-03-17;-1713;-1713;-856.5;9;4.5;USD;null;null;-1722;-861;0.5
0;KZ75125USD2069100107;2017-03-18;-1801;-1801;-900.5;null;null;USD;88;44;-1713;-856.5;0.5
0;KZ75125USD2069100107;2017-03-19;-1850;-1850;-925;null;null;USD;49;24.5;-1801;-900.5;0.5
0;KZ75125USD2069100107;2017-03-20;-1875;-1875;-937.5;null;null;USD;25;12.5;-1850;-925;0.5
0;KZ75125USD2069100107;2017-03-21;-1953;-1953;-976.5;null;null;USD;78;39;-1875;-937.5;0.5
0;KZ75125USD2069100107;2017-03-22;-1875;-1875;-937.5;78;39;USD;null;null;-1953;-976.5;0.5
0;KZ75125USD2069100107;2017-03-23;-1968;-1968;-984;null;null;USD;93;46.5;-1875;-937.5;0.5
0;KZ75125USD2069100107;2017-03-24;-1967;-1967;-983.5;1;0.5;USD;null;null;-1968;-984;0.5
0;KZ75125USD2069100107;2017-03-25;-1902;-1902;-951;65;32.5;USD;null;null;-1967;-983.5;0.5
0;KZ75125USD2069100107;2017-03-26;-1954;-1954;-977;null;null;USD;52;26;-1902;-951;0.5
0;KZ75125USD2069100107;2017-03-27;-1916;-1916;-958;38;19;USD;null;null;-1954;-977;0.5
0;KZ75125USD2069100107;2017-03-28;-1971;-1971;-985.5;null;null;USD;55;27.5;-1916;-958;0.5
0;KZ75125USD2069100107;2017-03-29;-1912;-1912;-956;59;29.5;USD;null;null;-1971;-985.5;0.5
0;KZ75125USD2069100107;2017-03-30;-1963;-1963;-981.5;null;null;USD;51;25.5;-1912;-956;0.5
0;KZ75125USD2069100107;2017-03-31;-1887;-1887;-943.5;76;38;USD;null;null;-1963;-981.5;0.5
0;KZ75125USD2069100107;2017-04-01;-1886;-1886;-943;1;0.5;USD;null;null;-1887;-943.5;0.5
0;KZ75125USD2069100107;2017-04-02;-1874;-1874;-937;12;6;USD;null;null;-1886;-943;0.5
0;KZ75125USD2069100107;2017-04-03;-1852;-1852;-926;22;11;USD;null;null;-1874;-937;0.5
0;KZ75125USD2069100107;2017-04-04;-1919;-1919;-959.5;null;null;USD;67;33.5;-1852;-926;0.5
0;KZ75125USD2069100107;2017-04-05;-1949;-1949;-974.5;null;null;USD;30;15;-1919;-959.5;0.5
0;KZ75125USD2069100107;2017-04-06;-2043;-2043;-1021.5;null;null;USD;94;47;-1949;-974.5;0.5
0;KZ75125USD2069100107;2017-04-07;-2124;-2124;-1062;null;null;USD;81;40.5;-2043;-1021.5;0.5
0;KZ75125USD2069100107;2017-04-08;-2193;-2193;-1096.5;null;null;USD;69;34.5;-2124;-1062;0.5
0;KZ75125USD2069100107;2017-04-09;-2261;-2261;-1130.5;null;null;USD;68;34;-2193;-1096.5;0.5
0;KZ75125USD2069100107;2017-04-10;-2292;-2292;-1146;null;null;USD;31;15.5;-2261;-1130.5;0.5
0;KZ75125USD2069100107;2017-04-11;-2385;-2385;-1192.5;null;null;USD;93;46.5;-2292;-1146;0.5
0;KZ75125USD2069100107;2017-04-12;-2432;-2432;-1216;null;null;USD;47;23.5;-2385;-1192.5;0.5
0;KZ75125USD2069100107;2017-04-13;-2477;-2477;-1238.5;null;null;USD;45;22.5;-2432;-1216;0.5
0;KZ75125USD2069100107;2017-04-14;-2554;-2554;-1277;null;null;USD;77;38.5;-2477;-1238.5;0.5
0;KZ75125USD2069100107;2017-04-15;-2614;-2614;-1307;null;null;USD;60;30;-2554;-1277;0.5
0;KZ75125USD2069100107;2017-04-16;-2707;-2707;-1353.5;null;null;USD;93;46.5;-2614;-1307;0.5
0;KZ75125USD2069100107;2017-04-17;-2688;-2688;-1344;19;9.5;USD;null;null;-2707;-1353.5;0.5
0;KZ75125USD2069100107;2017-04-18;-2786;-2786;-1393;null;null;USD;98;49;-2688;-1344;0.5
0;KZ75125USD2069100107;2017-04-19;-2752;-2752;-1376;34;17;USD;null;null;-2786;-1393;0.5
0;KZ75125USD2069100107;2017-04-20;-2784;-2784;-1392;null;null;USD;32;16;-2752;-1376;0.5
0;KZ75125USD2069100107;2017-04-21;-2785;-2785;-1392.5;null;null;USD;1;0.5;-2784;-1392;0.5
0;KZ75125USD2069100107;2017-04-22;-2745;-2745;-1372.5;40;20;USD;null;null;-2785;-1392.5;0.5
0;KZ75125USD2069100107;2017-04-23;-2771;-2771;-1385.5;null;null;USD;26;13;-2745;-1372.5;0.5
0;KZ75125USD2069100107;2017-04-24;-2830;-2830;-1415;null;null;USD;59;29.5;-2771;-1385.5;0.5
0;KZ75125USD2069100107;2017-04-25;-2783;-2783;-1391.5;47;23.5;USD;null;null;-2830;-1415;0.5
0;KZ75125USD2069100107;2017-04-26;-2744;-2744;-1372;39;19.5;USD;null;null;-2783;-1391.5;0.5
0;KZ75125USD2069100107;2017-04-27;-2700;-2700;-1350;44;22;USD;null;null;-2744;-1372;0.5
0;KZ75125USD2069100107;2017-04-28;-2787;-2787;-1393.5;null;null;USD;87;43.5;-2700;-1350;0.5
0;KZ75125USD2069100107;2017-04-29;-2741;-2741;-1370.5;46;23;USD;null;null;-2787;-1393.5;0.5
0;KZ75125USD2069100107;2017-04-30;-2821;-2821;-1410.5;null;null;USD;80;40;-2741;-1370.5;0.5
0;KZ75125USD2069100107;2017-05-01;-2913;-2913;-1456.5;null;null;USD;92;46;-2821;-1410.5;0.5
0;KZ75125USD2069100107;2017-05-02;-2897;-2897;-1448.5;16;8;USD;null;null;-2913;-1456.5;0.5
0;KZ75125USD2069100107;2017-05-03;-2950;-2950;-1475;null;null;USD;53;26.5;-2897;-1448.5;0.5
0;KZ75125USD2069100107;2017-05-04;-3047;-3047;-1523.5;null;null;USD;97;48.5;-2950;-1475;0.5
0;KZ75125USD2069100107;2017-05-05;-3072;-3072;-1536;null;null;USD;25;12.5;-3047;-1523.5;0.5
0;KZ75125USD2069100107;2017-05-06;-3148;-3148;-1574;null;null;USD;76;38;-3072;-1536;0.5
0;KZ75125USD2069100107;2017-05-07;-3157;-3157;-1578.5;null;null;USD;9;4.5;-3148;-1574;0.5
0;KZ75125USD2069100107;2017-05-08;-3157;-3157;-1578.5;null;null;USD;0;0;-3157;-1578.5;0.5
0;KZ75125USD2069100107;2017-05-09;-3238;-3238;-1619;null;null;USD;81;40.5;-3157;-1578.5;0.5
0;KZ75125USD2069100107;2017-05-10;-3159;-3159;-1579.5;79;39.5;USD;null;null;-3238;-1619;0.5
0;KZ75125USD2069100107;2017-05-11;-3088;-3088;-1544;71;35.5;USD;null;null;-3159;-1579.5;0.5
0;KZ75125USD2069100107;2017-05-12;-3131;-3131;-1565.5;null;null;USD;43;21.5;-3088;-1544;0.5
0;KZ75125USD2069100107;2017-05-13;-3061;-3061;-1530.5;70;35;USD;null;null;-3131;-1565.5;0.5
0;KZ75125USD2069100107;2017-05-14;-2999;-2999;-1499.5;62;31;USD;null;null;-3061;-1530.5;0.5
0;KZ75125USD2069100107;2017-05-15;-2937;-2937;-1468.5;62;31;USD;null;null;-2999;-1499.5;0.5
0;KZ75125USD2069100107;2017-05-16;-2872;-2872;-1436;65;32.5;USD;null;null;-2937;-1468.5;0.5
0;KZ75125USD2069100107;2017-05-17;-2889;-2889;-1444.5;null;null;USD;17;8.5;-2872;-1436;0.5
0;KZ75125USD2069100107;2017-05-18;-2870;-2870;-1435;19;9.5;USD;null;null;-2889;-1444.5;0.5
0;KZ75125USD2069100107;2017-05-19;-2950;-2950;-1475;null;null;USD;80;40;-2870;-1435;0.5
0;KZ75125USD2069100107;2017-05-20;-3020;-3020;-1510;null;null;USD;70;35;-2950;-1475;0.5
0;KZ75125USD2069100107;2017-05-21;-3001;-3001;-1500.5;19;9.5;USD;null;null;-3020;-1510;0.5
0;KZ75125USD2069100107;2017-05-22;-2967;-2967;-1483.5;34;17;USD;null;null;-3001;-1500.5;0.5
0;KZ75125USD2069100107;2017-05-23;-2995;-2995;-1497.5;null;null;USD;28;14;-2967;-1483.5;0.5
0;KZ75125USD2069100107;2017-05-24;-3092;-3092;-1546;null;null;USD;97;48.5;-2995;-1497.5;0.5
0;KZ75125USD2069100107;2017-05-25;-3051;-3051;-1525.5;41;20.5;USD;null;null;-3092;-1546;0.5
0;KZ75125USD2069100107;2017-05-26;-3011;-3011;-1505.5;40;20;USD;null;null;-3051;-1525.5;0.5
0;KZ75125USD2069100107;2017-05-27;-2944;-2944;-1472;67;33.5;USD;null;null;-3011;-1505.5;0.5
0;KZ75125USD2069100107;2017-05-28;-3041;-3041;-1520.5;null;null;USD;97;48.5;-2944;-1472;0.5
0;KZ75125USD2069100107;2017-05-29;-2984;-2984;-1492;57;28.5;USD;null;null;-3041;-1520.5;0.5
0;KZ75125USD2069100107;2017-05-30;-3030;-3030;-1515;null;null;USD;46;23;-2984;-1492;0.5
0;KZ75125USD2069100107;2017-05-31;-3127;-3127;-1563.5;null;null;USD;97;48.5;-3030;-1515;0.5
0;KZ75125USD2069100107;2017-06-01;-3080;-3080;-1540;47;23.5;USD;null;null;-3127;-1563.5;0.5
0;KZ75125USD2069100107;2017-06-02;-3055;-3055;-1527.5;25;12.5;USD;null;null;-3080;-1540;0.5
0;KZ75125USD2069100107;2017-06-03;-3050;-3050;-1525;5;2.5;USD;null;null;-3055;-1527.5;0.5
0;KZ75125USD2069100107;2017-06-04;-3074;-3074;-1537;null;null;USD;24;12;-3050;-1525;0.5
0;KZ75125USD2069100107;2017-06-05;-3164;-3164;-1582;null;null;USD;90;45;-3074;-1537;0.5
0;KZ75125USD2069100107;2017-06-06;-3117;-3117;-1558.5;47;23.5;USD;null;null;-3164;-1582;0.5
0;KZ75125USD2069100107;2017-06-07;-3031;-3031;-1515.5;86;43;USD;null;null;-3117;-1558.5;0.5
0;KZ75125USD2069100107;2017-06-08;-3083;-3083;-1541.5;null;null;USD;52;26;-3031;-1515.5;0.5
0;KZ75125USD2069100107;2017-06-09;-3147;-3147;-1573.5;null;null;USD;64;32;-3083;-1541.5;0.5
0;KZ75125USD2069100107;2017-06-10;-3211;-3211;-1605.5;null;null;USD;64;32;-3147;-1573.5;0.5
0;KZ75125USD2069100107;2017-06-11;-3207;-3207;-1603.5;4;2;USD;null;null;-3211;-1605.5;0.5
0;KZ75125USD2069100107;2017-06-12;-3258;-3258;-1629;null;null;USD;51;25.5;-3207;-1603.5;0.5
0;KZ75125KZT2069100108;2015-05-11;144;144;144;44;44;KZT;null;null;100;100;1
0;KZ75125KZT2069100108;2015-05-12;45;45;45;null;null;KZT;99;99;144;144;1
0;KZ75125KZT2069100108;2015-05-13;-48;-48;-48;null;null;KZT;93;93;45;45;1
0;KZ75125KZT2069100108;2015-05-14;-63;-63;-63;null;null;KZT;15;15;-48;-48;1
0;KZ75125KZT2069100108;2015-05-15;-121;-121;-121;null;null;KZT;58;58;-63;-63;1
0;KZ75125KZT2069100108;2015-05-16;-34;-34;-34;87;87;KZT;null;null;-121;-121;1
0;KZ75125KZT2069100108;2015-05-17;-22;-22;-22;12;12;KZT;null;null;-34;-34;1
0;KZ75125KZT2069100108;2015-05-18;-22;-22;-22;null;null;KZT;0;0;-22;-22;1
0;KZ75125KZT2069100108;2015-05-19;-85;-85;-85;null;null;KZT;63;63;-22;-22;1
0;KZ75125KZT2069100108;2015-05-20;-165;-165;-165;null;null;KZT;80;80;-85;-85;1
0;KZ75125KZT2069100108;2015-05-21;-74;-74;-74;91;91;KZT;null;null;-165;-165;1
0;KZ75125KZT2069100108;2015-05-22;-7;-7;-7;67;67;KZT;null;null;-74;-74;1
0;KZ75125KZT2069100108;2015-05-23;-103;-103;-103;null;null;KZT;96;96;-7;-7;1
0;KZ75125KZT2069100108;2015-05-24;-68;-68;-68;35;35;KZT;null;null;-103;-103;1
0;KZ75125KZT2069100108;2015-05-25;-85;-85;-85;null;null;KZT;17;17;-68;-68;1
0;KZ75125KZT2069100108;2015-05-26;-88;-88;-88;null;null;KZT;3;3;-85;-85;1
0;KZ75125KZT2069100108;2015-05-27;-14;-14;-14;74;74;KZT;null;null;-88;-88;1
0;KZ75125KZT2069100108;2015-05-28;-70;-70;-70;null;null;KZT;56;56;-14;-14;1
0;KZ75125KZT2069100108;2015-05-29;-159;-159;-159;null;null;KZT;89;89;-70;-70;1
0;KZ75125KZT2069100108;2015-05-30;-113;-113;-113;46;46;KZT;null;null;-159;-159;1
0;KZ75125KZT2069100108;2015-05-31;-176;-176;-176;null;null;KZT;63;63;-113;-113;1
0;KZ75125KZT2069100108;2015-06-01;-222;-222;-222;null;null;KZT;46;46;-176;-176;1
0;KZ75125KZT2069100108;2015-06-02;-260;-260;-260;null;null;KZT;38;38;-222;-222;1
0;KZ75125KZT2069100108;2015-06-03;-319;-319;-319;null;null;KZT;59;59;-260;-260;1
0;KZ75125KZT2069100108;2015-06-04;-382;-382;-382;null;null;KZT;63;63;-319;-319;1
0;KZ75125KZT2069100108;2015-06-05;-402;-402;-402;null;null;KZT;20;20;-382;-382;1
0;KZ75125KZT2069100108;2015-06-06;-476;-476;-476;null;null;KZT;74;74;-402;-402;1
0;KZ75125KZT2069100108;2015-06-07;-493;-493;-493;null;null;KZT;17;17;-476;-476;1
0;KZ75125KZT2069100108;2015-06-08;-462;-462;-462;31;31;KZT;null;null;-493;-493;1
0;KZ75125KZT2069100108;2015-06-09;-554;-554;-554;null;null;KZT;92;92;-462;-462;1
0;KZ75125KZT2069100108;2015-06-10;-497;-497;-497;57;57;KZT;null;null;-554;-554;1
0;KZ75125KZT2069100108;2015-06-11;-417;-417;-417;80;80;KZT;null;null;-497;-497;1
0;KZ75125KZT2069100108;2015-06-12;-491;-491;-491;null;null;KZT;74;74;-417;-417;1
0;KZ75125KZT2069100108;2015-06-13;-409;-409;-409;82;82;KZT;null;null;-491;-491;1
0;KZ75125KZT2069100108;2015-06-14;-465;-465;-465;null;null;KZT;56;56;-409;-409;1
0;KZ75125KZT2069100108;2015-06-15;-488;-488;-488;null;null;KZT;23;23;-465;-465;1
0;KZ75125KZT2069100108;2015-06-16;-554;-554;-554;null;null;KZT;66;66;-488;-488;1
0;KZ75125KZT2069100108;2015-06-17;-462;-462;-462;92;92;KZT;null;null;-554;-554;1
0;KZ75125KZT2069100108;2015-06-18;-520;-520;-520;null;null;KZT;58;58;-462;-462;1
0;KZ75125KZT2069100108;2015-06-19;-547;-547;-547;null;null;KZT;27;27;-520;-520;1
0;KZ75125KZT2069100108;2015-06-20;-597;-597;-597;null;null;KZT;50;50;-547;-547;1
0;KZ75125KZT2069100108;2015-06-21;-513;-513;-513;84;84;KZT;null;null;-597;-597;1
0;KZ75125KZT2069100108;2015-06-22;-452;-452;-452;61;61;KZT;null;null;-513;-513;1
0;KZ75125KZT2069100108;2015-06-23;-376;-376;-376;76;76;KZT;null;null;-452;-452;1
0;KZ75125KZT2069100108;2015-06-24;-474;-474;-474;null;null;KZT;98;98;-376;-376;1
0;KZ75125KZT2069100108;2015-06-25;-498;-498;-498;null;null;KZT;24;24;-474;-474;1
0;KZ75125KZT2069100108;2015-06-26;-465;-465;-465;33;33;KZT;null;null;-498;-498;1
0;KZ75125KZT2069100108;2015-06-27;-558;-558;-558;null;null;KZT;93;93;-465;-465;1
0;KZ75125KZT2069100108;2015-06-28;-608;-608;-608;null;null;KZT;50;50;-558;-558;1
0;KZ75125KZT2069100108;2015-06-29;-572;-572;-572;36;36;KZT;null;null;-608;-608;1
0;KZ75125KZT2069100108;2015-06-30;-544;-544;-544;28;28;KZT;null;null;-572;-572;1
0;KZ75125KZT2069100108;2015-07-01;-564;-564;-564;null;null;KZT;20;20;-544;-544;1
0;KZ75125KZT2069100108;2015-07-02;-619;-619;-619;null;null;KZT;55;55;-564;-564;1
0;KZ75125KZT2069100108;2015-07-03;-718;-718;-718;null;null;KZT;99;99;-619;-619;1
0;KZ75125KZT2069100108;2015-07-04;-777;-777;-777;null;null;KZT;59;59;-718;-718;1
0;KZ75125KZT2069100108;2015-07-05;-848;-848;-848;null;null;KZT;71;71;-777;-777;1
0;KZ75125KZT2069100108;2015-07-06;-921;-921;-921;null;null;KZT;73;73;-848;-848;1
0;KZ75125KZT2069100108;2015-07-07;-876;-876;-876;45;45;KZT;null;null;-921;-921;1
0;KZ75125KZT2069100108;2015-07-08;-806;-806;-806;70;70;KZT;null;null;-876;-876;1
0;KZ75125KZT2069100108;2015-07-09;-712;-712;-712;94;94;KZT;null;null;-806;-806;1
0;KZ75125KZT2069100108;2015-07-10;-679;-679;-679;33;33;KZT;null;null;-712;-712;1
0;KZ75125KZT2069100108;2015-07-11;-669;-669;-669;10;10;KZT;null;null;-679;-679;1
0;KZ75125KZT2069100108;2015-07-12;-678;-678;-678;null;null;KZT;9;9;-669;-669;1
0;KZ75125KZT2069100108;2015-07-13;-726;-726;-726;null;null;KZT;48;48;-678;-678;1
0;KZ75125KZT2069100108;2015-07-14;-671;-671;-671;55;55;KZT;null;null;-726;-726;1
0;KZ75125KZT2069100108;2015-07-15;-578;-578;-578;93;93;KZT;null;null;-671;-671;1
0;KZ75125KZT2069100108;2015-07-16;-668;-668;-668;null;null;KZT;90;90;-578;-578;1
0;KZ75125KZT2069100108;2015-07-17;-684;-684;-684;null;null;KZT;16;16;-668;-668;1
0;KZ75125KZT2069100108;2015-07-18;-699;-699;-699;null;null;KZT;15;15;-684;-684;1
0;KZ75125KZT2069100108;2015-07-19;-754;-754;-754;null;null;KZT;55;55;-699;-699;1
0;KZ75125KZT2069100108;2015-07-20;-808;-808;-808;null;null;KZT;54;54;-754;-754;1
0;KZ75125KZT2069100108;2015-07-21;-717;-717;-717;91;91;KZT;null;null;-808;-808;1
0;KZ75125KZT2069100108;2015-07-22;-771;-771;-771;null;null;KZT;54;54;-717;-717;1
0;KZ75125KZT2069100108;2015-07-23;-770;-770;-770;1;1;KZT;null;null;-771;-771;1
0;KZ75125KZT2069100108;2015-07-24;-766;-766;-766;4;4;KZT;null;null;-770;-770;1
0;KZ75125KZT2069100108;2015-07-25;-719;-719;-719;47;47;KZT;null;null;-766;-766;1
0;KZ75125KZT2069100108;2015-07-26;-709;-709;-709;10;10;KZT;null;null;-719;-719;1
0;KZ75125KZT2069100108;2015-07-27;-656;-656;-656;53;53;KZT;null;null;-709;-709;1
0;KZ75125KZT2069100108;2015-07-28;-621;-621;-621;35;35;KZT;null;null;-656;-656;1
0;KZ75125KZT2069100108;2015-07-29;-590;-590;-590;31;31;KZT;null;null;-621;-621;1
0;KZ75125KZT2069100108;2015-07-30;-660;-660;-660;null;null;KZT;70;70;-590;-590;1
0;KZ75125KZT2069100108;2015-07-31;-628;-628;-628;32;32;KZT;null;null;-660;-660;1
0;KZ75125KZT2069100108;2015-08-01;-561;-561;-561;67;67;KZT;null;null;-628;-628;1
0;KZ75125KZT2069100108;2015-08-02;-586;-586;-586;null;null;KZT;25;25;-561;-561;1
0;KZ75125KZT2069100108;2015-08-03;-638;-638;-638;null;null;KZT;52;52;-586;-586;1
0;KZ75125KZT2069100108;2015-08-04;-735;-735;-735;null;null;KZT;97;97;-638;-638;1
0;KZ75125KZT2069100108;2015-08-05;-653;-653;-653;82;82;KZT;null;null;-735;-735;1
0;KZ75125KZT2069100108;2015-08-06;-611;-611;-611;42;42;KZT;null;null;-653;-653;1
0;KZ75125KZT2069100108;2015-08-07;-665;-665;-665;null;null;KZT;54;54;-611;-611;1
0;KZ75125KZT2069100108;2015-08-08;-656;-656;-656;9;9;KZT;null;null;-665;-665;1
0;KZ75125KZT2069100108;2015-08-09;-693;-693;-693;null;null;KZT;37;37;-656;-656;1
0;KZ75125KZT2069100108;2015-08-10;-783;-783;-783;null;null;KZT;90;90;-693;-693;1
0;KZ75125KZT2069100108;2015-08-11;-746;-746;-746;37;37;KZT;null;null;-783;-783;1
0;KZ75125KZT2069100108;2015-08-12;-651;-651;-651;95;95;KZT;null;null;-746;-746;1
0;KZ75125KZT2069100108;2015-08-13;-682;-682;-682;null;null;KZT;31;31;-651;-651;1
0;KZ75125KZT2069100108;2015-08-14;-718;-718;-718;null;null;KZT;36;36;-682;-682;1
0;KZ75125KZT2069100108;2015-08-15;-716;-716;-716;2;2;KZT;null;null;-718;-718;1
0;KZ75125KZT2069100108;2015-08-16;-803;-803;-803;null;null;KZT;87;87;-716;-716;1
0;KZ75125KZT2069100108;2015-08-17;-846;-846;-846;null;null;KZT;43;43;-803;-803;1
0;KZ75125KZT2069100108;2015-08-18;-872;-872;-872;null;null;KZT;26;26;-846;-846;1
0;KZ75125KZT2069100108;2015-08-19;-890;-890;-890;null;null;KZT;18;18;-872;-872;1
0;KZ75125KZT2069100108;2015-08-20;-989;-989;-989;null;null;KZT;99;99;-890;-890;1
0;KZ75125KZT2069100108;2015-08-21;-1071;-1071;-1071;null;null;KZT;82;82;-989;-989;1
0;KZ75125KZT2069100108;2015-08-22;-1000;-1000;-1000;71;71;KZT;null;null;-1071;-1071;1
0;KZ75125KZT2069100108;2015-08-23;-931;-931;-931;69;69;KZT;null;null;-1000;-1000;1
0;KZ75125KZT2069100108;2015-08-24;-967;-967;-967;null;null;KZT;36;36;-931;-931;1
0;KZ75125KZT2069100108;2015-08-25;-1041;-1041;-1041;null;null;KZT;74;74;-967;-967;1
0;KZ75125KZT2069100108;2015-08-26;-1051;-1051;-1051;null;null;KZT;10;10;-1041;-1041;1
0;KZ75125KZT2069100108;2015-08-27;-1002;-1002;-1002;49;49;KZT;null;null;-1051;-1051;1
0;KZ75125KZT2069100108;2015-08-28;-1003;-1003;-1003;null;null;KZT;1;1;-1002;-1002;1
0;KZ75125KZT2069100108;2015-08-29;-1062;-1062;-1062;null;null;KZT;59;59;-1003;-1003;1
0;KZ75125KZT2069100108;2015-08-30;-1018;-1018;-1018;44;44;KZT;null;null;-1062;-1062;1
0;KZ75125KZT2069100108;2015-08-31;-1117;-1117;-1117;null;null;KZT;99;99;-1018;-1018;1
0;KZ75125KZT2069100108;2015-09-01;-1080;-1080;-1080;37;37;KZT;null;null;-1117;-1117;1
0;KZ75125KZT2069100108;2015-09-02;-1107;-1107;-1107;null;null;KZT;27;27;-1080;-1080;1
0;KZ75125KZT2069100108;2015-09-03;-1168;-1168;-1168;null;null;KZT;61;61;-1107;-1107;1
0;KZ75125KZT2069100108;2015-09-04;-1117;-1117;-1117;51;51;KZT;null;null;-1168;-1168;1
0;KZ75125KZT2069100108;2015-09-05;-1169;-1169;-1169;null;null;KZT;52;52;-1117;-1117;1
0;KZ75125KZT2069100108;2015-09-06;-1157;-1157;-1157;12;12;KZT;null;null;-1169;-1169;1
0;KZ75125KZT2069100108;2015-09-07;-1110;-1110;-1110;47;47;KZT;null;null;-1157;-1157;1
0;KZ75125KZT2069100108;2015-09-08;-1179;-1179;-1179;null;null;KZT;69;69;-1110;-1110;1
0;KZ75125KZT2069100108;2015-09-09;-1250;-1250;-1250;null;null;KZT;71;71;-1179;-1179;1
0;KZ75125KZT2069100108;2015-09-10;-1267;-1267;-1267;null;null;KZT;17;17;-1250;-1250;1
0;KZ75125KZT2069100108;2015-09-11;-1366;-1366;-1366;null;null;KZT;99;99;-1267;-1267;1
0;KZ75125KZT2069100108;2015-09-12;-1308;-1308;-1308;58;58;KZT;null;null;-1366;-1366;1
0;KZ75125KZT2069100108;2015-09-13;-1337;-1337;-1337;null;null;KZT;29;29;-1308;-1308;1
0;KZ75125KZT2069100108;2015-09-14;-1309;-1309;-1309;28;28;KZT;null;null;-1337;-1337;1
0;KZ75125KZT2069100108;2015-09-15;-1269;-1269;-1269;40;40;KZT;null;null;-1309;-1309;1
0;KZ75125KZT2069100108;2015-09-16;-1220;-1220;-1220;49;49;KZT;null;null;-1269;-1269;1
0;KZ75125KZT2069100108;2015-09-17;-1227;-1227;-1227;null;null;KZT;7;7;-1220;-1220;1
0;KZ75125KZT2069100108;2015-09-18;-1176;-1176;-1176;51;51;KZT;null;null;-1227;-1227;1
0;KZ75125KZT2069100108;2015-09-19;-1260;-1260;-1260;null;null;KZT;84;84;-1176;-1176;1
0;KZ75125KZT2069100108;2015-09-20;-1270;-1270;-1270;null;null;KZT;10;10;-1260;-1260;1
0;KZ75125KZT2069100108;2015-09-21;-1298;-1298;-1298;null;null;KZT;28;28;-1270;-1270;1
0;KZ75125KZT2069100108;2015-09-22;-1271;-1271;-1271;27;27;KZT;null;null;-1298;-1298;1
0;KZ75125KZT2069100108;2015-09-23;-1223;-1223;-1223;48;48;KZT;null;null;-1271;-1271;1
0;KZ75125KZT2069100108;2015-09-24;-1130;-1130;-1130;93;93;KZT;null;null;-1223;-1223;1
0;KZ75125KZT2069100108;2015-09-25;-1127;-1127;-1127;3;3;KZT;null;null;-1130;-1130;1
0;KZ75125KZT2069100108;2015-09-26;-1102;-1102;-1102;25;25;KZT;null;null;-1127;-1127;1
0;KZ75125KZT2069100108;2015-09-27;-1095;-1095;-1095;7;7;KZT;null;null;-1102;-1102;1
0;KZ75125KZT2069100108;2015-09-28;-1058;-1058;-1058;37;37;KZT;null;null;-1095;-1095;1
0;KZ75125KZT2069100108;2015-09-29;-976;-976;-976;82;82;KZT;null;null;-1058;-1058;1
0;KZ75125KZT2069100108;2015-09-30;-975;-975;-975;1;1;KZT;null;null;-976;-976;1
0;KZ75125KZT2069100108;2015-10-01;-993;-993;-993;null;null;KZT;18;18;-975;-975;1
0;KZ75125KZT2069100108;2015-10-02;-1035;-1035;-1035;null;null;KZT;42;42;-993;-993;1
0;KZ75125KZT2069100108;2015-10-03;-982;-982;-982;53;53;KZT;null;null;-1035;-1035;1
0;KZ75125KZT2069100108;2015-10-04;-990;-990;-990;null;null;KZT;8;8;-982;-982;1
0;KZ75125KZT2069100108;2015-10-05;-1077;-1077;-1077;null;null;KZT;87;87;-990;-990;1
0;KZ75125KZT2069100108;2015-10-06;-1127;-1127;-1127;null;null;KZT;50;50;-1077;-1077;1
0;KZ75125KZT2069100108;2015-10-07;-1180;-1180;-1180;null;null;KZT;53;53;-1127;-1127;1
0;KZ75125KZT2069100108;2015-10-08;-1091;-1091;-1091;89;89;KZT;null;null;-1180;-1180;1
0;KZ75125KZT2069100108;2015-10-09;-1038;-1038;-1038;53;53;KZT;null;null;-1091;-1091;1
0;KZ75125KZT2069100108;2015-10-10;-967;-967;-967;71;71;KZT;null;null;-1038;-1038;1
0;KZ75125KZT2069100108;2015-10-11;-960;-960;-960;7;7;KZT;null;null;-967;-967;1
0;KZ75125KZT2069100108;2015-10-12;-929;-929;-929;31;31;KZT;null;null;-960;-960;1
0;KZ75125KZT2069100108;2015-10-13;-872;-872;-872;57;57;KZT;null;null;-929;-929;1
0;KZ75125KZT2069100108;2015-10-14;-819;-819;-819;53;53;KZT;null;null;-872;-872;1
0;KZ75125KZT2069100108;2015-10-15;-880;-880;-880;null;null;KZT;61;61;-819;-819;1
0;KZ75125KZT2069100108;2015-10-16;-883;-883;-883;null;null;KZT;3;3;-880;-880;1
0;KZ75125KZT2069100108;2015-10-17;-808;-808;-808;75;75;KZT;null;null;-883;-883;1
0;KZ75125KZT2069100108;2015-10-18;-759;-759;-759;49;49;KZT;null;null;-808;-808;1
0;KZ75125KZT2069100108;2015-10-19;-688;-688;-688;71;71;KZT;null;null;-759;-759;1
0;KZ75125KZT2069100108;2015-10-20;-675;-675;-675;13;13;KZT;null;null;-688;-688;1
0;KZ75125KZT2069100108;2015-10-21;-659;-659;-659;16;16;KZT;null;null;-675;-675;1
0;KZ75125KZT2069100108;2015-10-22;-724;-724;-724;null;null;KZT;65;65;-659;-659;1
0;KZ75125KZT2069100108;2015-10-23;-699;-699;-699;25;25;KZT;null;null;-724;-724;1
0;KZ75125KZT2069100108;2015-10-24;-600;-600;-600;99;99;KZT;null;null;-699;-699;1
0;KZ75125KZT2069100108;2015-10-25;-607;-607;-607;null;null;KZT;7;7;-600;-600;1
0;KZ75125KZT2069100108;2015-10-26;-668;-668;-668;null;null;KZT;61;61;-607;-607;1
0;KZ75125KZT2069100108;2015-10-27;-592;-592;-592;76;76;KZT;null;null;-668;-668;1
0;KZ75125KZT2069100108;2015-10-28;-578;-578;-578;14;14;KZT;null;null;-592;-592;1
0;KZ75125KZT2069100108;2015-10-29;-673;-673;-673;null;null;KZT;95;95;-578;-578;1
0;KZ75125KZT2069100108;2015-10-30;-734;-734;-734;null;null;KZT;61;61;-673;-673;1
0;KZ75125KZT2069100108;2015-10-31;-749;-749;-749;null;null;KZT;15;15;-734;-734;1
0;KZ75125KZT2069100108;2015-11-01;-746;-746;-746;3;3;KZT;null;null;-749;-749;1
0;KZ75125KZT2069100108;2015-11-02;-726;-726;-726;20;20;KZT;null;null;-746;-746;1
0;KZ75125KZT2069100108;2015-11-03;-741;-741;-741;null;null;KZT;15;15;-726;-726;1
0;KZ75125KZT2069100108;2015-11-04;-817;-817;-817;null;null;KZT;76;76;-741;-741;1
0;KZ75125KZT2069100108;2015-11-05;-776;-776;-776;41;41;KZT;null;null;-817;-817;1
0;KZ75125KZT2069100108;2015-11-06;-739;-739;-739;37;37;KZT;null;null;-776;-776;1
0;KZ75125KZT2069100108;2015-11-07;-805;-805;-805;null;null;KZT;66;66;-739;-739;1
0;KZ75125KZT2069100108;2015-11-08;-845;-845;-845;null;null;KZT;40;40;-805;-805;1
0;KZ75125KZT2069100108;2015-11-09;-936;-936;-936;null;null;KZT;91;91;-845;-845;1
0;KZ75125KZT2069100108;2015-11-10;-879;-879;-879;57;57;KZT;null;null;-936;-936;1
0;KZ75125KZT2069100108;2015-11-11;-821;-821;-821;58;58;KZT;null;null;-879;-879;1
0;KZ75125KZT2069100108;2015-11-12;-917;-917;-917;null;null;KZT;96;96;-821;-821;1
0;KZ75125KZT2069100108;2015-11-13;-953;-953;-953;null;null;KZT;36;36;-917;-917;1
0;KZ75125KZT2069100108;2015-11-14;-947;-947;-947;6;6;KZT;null;null;-953;-953;1
0;KZ75125KZT2069100108;2015-11-15;-951;-951;-951;null;null;KZT;4;4;-947;-947;1
0;KZ75125KZT2069100108;2015-11-16;-970;-970;-970;null;null;KZT;19;19;-951;-951;1
0;KZ75125KZT2069100108;2015-11-17;-927;-927;-927;43;43;KZT;null;null;-970;-970;1
0;KZ75125KZT2069100108;2015-11-18;-892;-892;-892;35;35;KZT;null;null;-927;-927;1
0;KZ75125KZT2069100108;2015-11-19;-966;-966;-966;null;null;KZT;74;74;-892;-892;1
0;KZ75125KZT2069100108;2015-11-20;-923;-923;-923;43;43;KZT;null;null;-966;-966;1
0;KZ75125KZT2069100108;2015-11-21;-910;-910;-910;13;13;KZT;null;null;-923;-923;1
0;KZ75125KZT2069100108;2015-11-22;-911;-911;-911;null;null;KZT;1;1;-910;-910;1
0;KZ75125KZT2069100108;2015-11-23;-974;-974;-974;null;null;KZT;63;63;-911;-911;1
0;KZ75125KZT2069100108;2015-11-24;-1042;-1042;-1042;null;null;KZT;68;68;-974;-974;1
0;KZ75125KZT2069100108;2015-11-25;-1007;-1007;-1007;35;35;KZT;null;null;-1042;-1042;1
0;KZ75125KZT2069100108;2015-11-26;-1033;-1033;-1033;null;null;KZT;26;26;-1007;-1007;1
0;KZ75125KZT2069100108;2015-11-27;-1000;-1000;-1000;33;33;KZT;null;null;-1033;-1033;1
0;KZ75125KZT2069100108;2015-11-28;-919;-919;-919;81;81;KZT;null;null;-1000;-1000;1
0;KZ75125KZT2069100108;2015-11-29;-860;-860;-860;59;59;KZT;null;null;-919;-919;1
0;KZ75125KZT2069100108;2015-11-30;-839;-839;-839;21;21;KZT;null;null;-860;-860;1
0;KZ75125KZT2069100108;2015-12-01;-780;-780;-780;59;59;KZT;null;null;-839;-839;1
0;KZ75125KZT2069100108;2015-12-02;-681;-681;-681;99;99;KZT;null;null;-780;-780;1
0;KZ75125KZT2069100108;2015-12-03;-723;-723;-723;null;null;KZT;42;42;-681;-681;1
0;KZ75125KZT2069100108;2015-12-04;-820;-820;-820;null;null;KZT;97;97;-723;-723;1
0;KZ75125KZT2069100108;2015-12-05;-737;-737;-737;83;83;KZT;null;null;-820;-820;1
0;KZ75125KZT2069100108;2015-12-06;-815;-815;-815;null;null;KZT;78;78;-737;-737;1
0;KZ75125KZT2069100108;2015-12-07;-887;-887;-887;null;null;KZT;72;72;-815;-815;1
0;KZ75125KZT2069100108;2015-12-08;-934;-934;-934;null;null;KZT;47;47;-887;-887;1
0;KZ75125KZT2069100108;2015-12-09;-984;-984;-984;null;null;KZT;50;50;-934;-934;1
0;KZ75125KZT2069100108;2015-12-10;-918;-918;-918;66;66;KZT;null;null;-984;-984;1
0;KZ75125KZT2069100108;2015-12-11;-873;-873;-873;45;45;KZT;null;null;-918;-918;1
0;KZ75125KZT2069100108;2015-12-12;-942;-942;-942;null;null;KZT;69;69;-873;-873;1
0;KZ75125KZT2069100108;2015-12-13;-977;-977;-977;null;null;KZT;35;35;-942;-942;1
0;KZ75125KZT2069100108;2015-12-14;-897;-897;-897;80;80;KZT;null;null;-977;-977;1
0;KZ75125KZT2069100108;2015-12-15;-834;-834;-834;63;63;KZT;null;null;-897;-897;1
0;KZ75125KZT2069100108;2015-12-16;-855;-855;-855;null;null;KZT;21;21;-834;-834;1
0;KZ75125KZT2069100108;2015-12-17;-867;-867;-867;null;null;KZT;12;12;-855;-855;1
0;KZ75125KZT2069100108;2015-12-18;-873;-873;-873;null;null;KZT;6;6;-867;-867;1
0;KZ75125KZT2069100108;2015-12-19;-971;-971;-971;null;null;KZT;98;98;-873;-873;1
0;KZ75125KZT2069100108;2015-12-20;-1061;-1061;-1061;null;null;KZT;90;90;-971;-971;1
0;KZ75125KZT2069100108;2015-12-21;-1037;-1037;-1037;24;24;KZT;null;null;-1061;-1061;1
0;KZ75125KZT2069100108;2015-12-22;-963;-963;-963;74;74;KZT;null;null;-1037;-1037;1
0;KZ75125KZT2069100108;2015-12-23;-1054;-1054;-1054;null;null;KZT;91;91;-963;-963;1
0;KZ75125KZT2069100108;2015-12-24;-1018;-1018;-1018;36;36;KZT;null;null;-1054;-1054;1
0;KZ75125KZT2069100108;2015-12-25;-923;-923;-923;95;95;KZT;null;null;-1018;-1018;1
0;KZ75125KZT2069100108;2015-12-26;-963;-963;-963;null;null;KZT;40;40;-923;-923;1
0;KZ75125KZT2069100108;2015-12-27;-878;-878;-878;85;85;KZT;null;null;-963;-963;1
0;KZ75125KZT2069100108;2015-12-28;-805;-805;-805;73;73;KZT;null;null;-878;-878;1
0;KZ75125KZT2069100108;2015-12-29;-871;-871;-871;null;null;KZT;66;66;-805;-805;1
0;KZ75125KZT2069100108;2015-12-30;-925;-925;-925;null;null;KZT;54;54;-871;-871;1
0;KZ75125KZT2069100108;2015-12-31;-930;-930;-930;null;null;KZT;5;5;-925;-925;1
0;KZ75125KZT2069100108;2016-01-01;-994;-994;-994;null;null;KZT;64;64;-930;-930;1
0;KZ75125KZT2069100108;2016-01-02;-898;-898;-898;96;96;KZT;null;null;-994;-994;1
0;KZ75125KZT2069100108;2016-01-03;-802;-802;-802;96;96;KZT;null;null;-898;-898;1
0;KZ75125KZT2069100108;2016-01-04;-769;-769;-769;33;33;KZT;null;null;-802;-802;1
0;KZ75125KZT2069100108;2016-01-05;-755;-755;-755;14;14;KZT;null;null;-769;-769;1
0;KZ75125KZT2069100108;2016-01-06;-710;-710;-710;45;45;KZT;null;null;-755;-755;1
0;KZ75125KZT2069100108;2016-01-07;-714;-714;-714;null;null;KZT;4;4;-710;-710;1
0;KZ75125KZT2069100108;2016-01-08;-703;-703;-703;11;11;KZT;null;null;-714;-714;1
0;KZ75125KZT2069100108;2016-01-09;-643;-643;-643;60;60;KZT;null;null;-703;-703;1
0;KZ75125KZT2069100108;2016-01-10;-734;-734;-734;null;null;KZT;91;91;-643;-643;1
0;KZ75125KZT2069100108;2016-01-11;-647;-647;-647;87;87;KZT;null;null;-734;-734;1
0;KZ75125KZT2069100108;2016-01-12;-586;-586;-586;61;61;KZT;null;null;-647;-647;1
0;KZ75125KZT2069100108;2016-01-13;-530;-530;-530;56;56;KZT;null;null;-586;-586;1
0;KZ75125KZT2069100108;2016-01-14;-536;-536;-536;null;null;KZT;6;6;-530;-530;1
0;KZ75125KZT2069100108;2016-01-15;-524;-524;-524;12;12;KZT;null;null;-536;-536;1
0;KZ75125KZT2069100108;2016-01-16;-546;-546;-546;null;null;KZT;22;22;-524;-524;1
0;KZ75125KZT2069100108;2016-01-17;-516;-516;-516;30;30;KZT;null;null;-546;-546;1
0;KZ75125KZT2069100108;2016-01-18;-475;-475;-475;41;41;KZT;null;null;-516;-516;1
0;KZ75125KZT2069100108;2016-01-19;-401;-401;-401;74;74;KZT;null;null;-475;-475;1
0;KZ75125KZT2069100108;2016-01-20;-478;-478;-478;null;null;KZT;77;77;-401;-401;1
0;KZ75125KZT2069100108;2016-01-21;-568;-568;-568;null;null;KZT;90;90;-478;-478;1
0;KZ75125KZT2069100108;2016-01-22;-650;-650;-650;null;null;KZT;82;82;-568;-568;1
0;KZ75125KZT2069100108;2016-01-23;-683;-683;-683;null;null;KZT;33;33;-650;-650;1
0;KZ75125KZT2069100108;2016-01-24;-638;-638;-638;45;45;KZT;null;null;-683;-683;1
0;KZ75125KZT2069100108;2016-01-25;-703;-703;-703;null;null;KZT;65;65;-638;-638;1
0;KZ75125KZT2069100108;2016-01-26;-779;-779;-779;null;null;KZT;76;76;-703;-703;1
0;KZ75125KZT2069100108;2016-01-27;-752;-752;-752;27;27;KZT;null;null;-779;-779;1
0;KZ75125KZT2069100108;2016-01-28;-770;-770;-770;null;null;KZT;18;18;-752;-752;1
0;KZ75125KZT2069100108;2016-01-29;-819;-819;-819;null;null;KZT;49;49;-770;-770;1
0;KZ75125KZT2069100108;2016-01-30;-833;-833;-833;null;null;KZT;14;14;-819;-819;1
0;KZ75125KZT2069100108;2016-01-31;-880;-880;-880;null;null;KZT;47;47;-833;-833;1
0;KZ75125KZT2069100108;2016-02-01;-904;-904;-904;null;null;KZT;24;24;-880;-880;1
0;KZ75125KZT2069100108;2016-02-02;-902;-902;-902;2;2;KZT;null;null;-904;-904;1
0;KZ75125KZT2069100108;2016-02-03;-871;-871;-871;31;31;KZT;null;null;-902;-902;1
0;KZ75125KZT2069100108;2016-02-04;-938;-938;-938;null;null;KZT;67;67;-871;-871;1
0;KZ75125KZT2069100108;2016-02-05;-992;-992;-992;null;null;KZT;54;54;-938;-938;1
0;KZ75125KZT2069100108;2016-02-06;-1084;-1084;-1084;null;null;KZT;92;92;-992;-992;1
0;KZ75125KZT2069100108;2016-02-07;-997;-997;-997;87;87;KZT;null;null;-1084;-1084;1
0;KZ75125KZT2069100108;2016-02-08;-941;-941;-941;56;56;KZT;null;null;-997;-997;1
0;KZ75125KZT2069100108;2016-02-09;-1009;-1009;-1009;null;null;KZT;68;68;-941;-941;1
0;KZ75125KZT2069100108;2016-02-10;-981;-981;-981;28;28;KZT;null;null;-1009;-1009;1
0;KZ75125KZT2069100108;2016-02-11;-935;-935;-935;46;46;KZT;null;null;-981;-981;1
0;KZ75125KZT2069100108;2016-02-12;-972;-972;-972;null;null;KZT;37;37;-935;-935;1
0;KZ75125KZT2069100108;2016-02-13;-1024;-1024;-1024;null;null;KZT;52;52;-972;-972;1
0;KZ75125KZT2069100108;2016-02-14;-1005;-1005;-1005;19;19;KZT;null;null;-1024;-1024;1
0;KZ75125KZT2069100108;2016-02-15;-942;-942;-942;63;63;KZT;null;null;-1005;-1005;1
0;KZ75125KZT2069100108;2016-02-16;-906;-906;-906;36;36;KZT;null;null;-942;-942;1
0;KZ75125KZT2069100108;2016-02-17;-809;-809;-809;97;97;KZT;null;null;-906;-906;1
0;KZ75125KZT2069100108;2016-02-18;-893;-893;-893;null;null;KZT;84;84;-809;-809;1
0;KZ75125KZT2069100108;2016-02-19;-798;-798;-798;95;95;KZT;null;null;-893;-893;1
0;KZ75125KZT2069100108;2016-02-20;-742;-742;-742;56;56;KZT;null;null;-798;-798;1
0;KZ75125KZT2069100108;2016-02-21;-746;-746;-746;null;null;KZT;4;4;-742;-742;1
0;KZ75125KZT2069100108;2016-02-22;-822;-822;-822;null;null;KZT;76;76;-746;-746;1
0;KZ75125KZT2069100108;2016-02-23;-766;-766;-766;56;56;KZT;null;null;-822;-822;1
0;KZ75125KZT2069100108;2016-02-24;-789;-789;-789;null;null;KZT;23;23;-766;-766;1
0;KZ75125KZT2069100108;2016-02-25;-696;-696;-696;93;93;KZT;null;null;-789;-789;1
0;KZ75125KZT2069100108;2016-02-26;-732;-732;-732;null;null;KZT;36;36;-696;-696;1
0;KZ75125KZT2069100108;2016-02-27;-703;-703;-703;29;29;KZT;null;null;-732;-732;1
0;KZ75125KZT2069100108;2016-02-28;-705;-705;-705;null;null;KZT;2;2;-703;-703;1
0;KZ75125KZT2069100108;2016-02-29;-804;-804;-804;null;null;KZT;99;99;-705;-705;1
0;KZ75125KZT2069100108;2016-03-01;-755;-755;-755;49;49;KZT;null;null;-804;-804;1
0;KZ75125KZT2069100108;2016-03-02;-714;-714;-714;41;41;KZT;null;null;-755;-755;1
0;KZ75125KZT2069100108;2016-03-03;-793;-793;-793;null;null;KZT;79;79;-714;-714;1
0;KZ75125KZT2069100108;2016-03-04;-805;-805;-805;null;null;KZT;12;12;-793;-793;1
0;KZ75125KZT2069100108;2016-03-05;-852;-852;-852;null;null;KZT;47;47;-805;-805;1
0;KZ75125KZT2069100108;2016-03-06;-775;-775;-775;77;77;KZT;null;null;-852;-852;1
0;KZ75125KZT2069100108;2016-03-07;-862;-862;-862;null;null;KZT;87;87;-775;-775;1
0;KZ75125KZT2069100108;2016-03-08;-868;-868;-868;null;null;KZT;6;6;-862;-862;1
0;KZ75125KZT2069100108;2016-03-09;-788;-788;-788;80;80;KZT;null;null;-868;-868;1
0;KZ75125KZT2069100108;2016-03-10;-767;-767;-767;21;21;KZT;null;null;-788;-788;1
0;KZ75125KZT2069100108;2016-03-11;-843;-843;-843;null;null;KZT;76;76;-767;-767;1
0;KZ75125KZT2069100108;2016-03-12;-875;-875;-875;null;null;KZT;32;32;-843;-843;1
0;KZ75125KZT2069100108;2016-03-13;-925;-925;-925;null;null;KZT;50;50;-875;-875;1
0;KZ75125KZT2069100108;2016-03-14;-997;-997;-997;null;null;KZT;72;72;-925;-925;1
0;KZ75125KZT2069100108;2016-03-15;-1031;-1031;-1031;null;null;KZT;34;34;-997;-997;1
0;KZ75125KZT2069100108;2016-03-16;-1006;-1006;-1006;25;25;KZT;null;null;-1031;-1031;1
0;KZ75125KZT2069100108;2016-03-17;-1061;-1061;-1061;null;null;KZT;55;55;-1006;-1006;1
0;KZ75125KZT2069100108;2016-03-18;-1010;-1010;-1010;51;51;KZT;null;null;-1061;-1061;1
0;KZ75125KZT2069100108;2016-03-19;-953;-953;-953;57;57;KZT;null;null;-1010;-1010;1
0;KZ75125KZT2069100108;2016-03-20;-963;-963;-963;null;null;KZT;10;10;-953;-953;1
0;KZ75125KZT2069100108;2016-03-21;-961;-961;-961;2;2;KZT;null;null;-963;-963;1
0;KZ75125KZT2069100108;2016-03-22;-876;-876;-876;85;85;KZT;null;null;-961;-961;1
0;KZ75125KZT2069100108;2016-03-23;-786;-786;-786;90;90;KZT;null;null;-876;-876;1
0;KZ75125KZT2069100108;2016-03-24;-884;-884;-884;null;null;KZT;98;98;-786;-786;1
0;KZ75125KZT2069100108;2016-03-25;-869;-869;-869;15;15;KZT;null;null;-884;-884;1
0;KZ75125KZT2069100108;2016-03-26;-795;-795;-795;74;74;KZT;null;null;-869;-869;1
0;KZ75125KZT2069100108;2016-03-27;-712;-712;-712;83;83;KZT;null;null;-795;-795;1
0;KZ75125KZT2069100108;2016-03-28;-763;-763;-763;null;null;KZT;51;51;-712;-712;1
0;KZ75125KZT2069100108;2016-03-29;-822;-822;-822;null;null;KZT;59;59;-763;-763;1
0;KZ75125KZT2069100108;2016-03-30;-771;-771;-771;51;51;KZT;null;null;-822;-822;1
0;KZ75125KZT2069100108;2016-03-31;-743;-743;-743;28;28;KZT;null;null;-771;-771;1
0;KZ75125KZT2069100108;2016-04-01;-644;-644;-644;99;99;KZT;null;null;-743;-743;1
0;KZ75125KZT2069100108;2016-04-02;-572;-572;-572;72;72;KZT;null;null;-644;-644;1
0;KZ75125KZT2069100108;2016-04-03;-549;-549;-549;23;23;KZT;null;null;-572;-572;1
0;KZ75125KZT2069100108;2016-04-04;-519;-519;-519;30;30;KZT;null;null;-549;-549;1
0;KZ75125KZT2069100108;2016-04-05;-522;-522;-522;null;null;KZT;3;3;-519;-519;1
0;KZ75125KZT2069100108;2016-04-06;-588;-588;-588;null;null;KZT;66;66;-522;-522;1
0;KZ75125KZT2069100108;2016-04-07;-515;-515;-515;73;73;KZT;null;null;-588;-588;1
0;KZ75125KZT2069100108;2016-04-08;-518;-518;-518;null;null;KZT;3;3;-515;-515;1
0;KZ75125KZT2069100108;2016-04-09;-573;-573;-573;null;null;KZT;55;55;-518;-518;1
0;KZ75125KZT2069100108;2016-04-10;-573;-573;-573;null;null;KZT;0;0;-573;-573;1
0;KZ75125KZT2069100108;2016-04-11;-488;-488;-488;85;85;KZT;null;null;-573;-573;1
0;KZ75125KZT2069100108;2016-04-12;-574;-574;-574;null;null;KZT;86;86;-488;-488;1
0;KZ75125KZT2069100108;2016-04-13;-514;-514;-514;60;60;KZT;null;null;-574;-574;1
0;KZ75125KZT2069100108;2016-04-14;-567;-567;-567;null;null;KZT;53;53;-514;-514;1
0;KZ75125KZT2069100108;2016-04-15;-656;-656;-656;null;null;KZT;89;89;-567;-567;1
0;KZ75125KZT2069100108;2016-04-16;-671;-671;-671;null;null;KZT;15;15;-656;-656;1
0;KZ75125KZT2069100108;2016-04-17;-768;-768;-768;null;null;KZT;97;97;-671;-671;1
0;KZ75125KZT2069100108;2016-04-18;-684;-684;-684;84;84;KZT;null;null;-768;-768;1
0;KZ75125KZT2069100108;2016-04-19;-605;-605;-605;79;79;KZT;null;null;-684;-684;1
0;KZ75125KZT2069100108;2016-04-20;-700;-700;-700;null;null;KZT;95;95;-605;-605;1
0;KZ75125KZT2069100108;2016-04-21;-629;-629;-629;71;71;KZT;null;null;-700;-700;1
0;KZ75125KZT2069100108;2016-04-22;-585;-585;-585;44;44;KZT;null;null;-629;-629;1
0;KZ75125KZT2069100108;2016-04-23;-517;-517;-517;68;68;KZT;null;null;-585;-585;1
0;KZ75125KZT2069100108;2016-04-24;-430;-430;-430;87;87;KZT;null;null;-517;-517;1
0;KZ75125KZT2069100108;2016-04-25;-499;-499;-499;null;null;KZT;69;69;-430;-430;1
0;KZ75125KZT2069100108;2016-04-26;-524;-524;-524;null;null;KZT;25;25;-499;-499;1
0;KZ75125KZT2069100108;2016-04-27;-587;-587;-587;null;null;KZT;63;63;-524;-524;1
0;KZ75125KZT2069100108;2016-04-28;-685;-685;-685;null;null;KZT;98;98;-587;-587;1
0;KZ75125KZT2069100108;2016-04-29;-621;-621;-621;64;64;KZT;null;null;-685;-685;1
0;KZ75125KZT2069100108;2016-04-30;-660;-660;-660;null;null;KZT;39;39;-621;-621;1
0;KZ75125KZT2069100108;2016-05-01;-617;-617;-617;43;43;KZT;null;null;-660;-660;1
0;KZ75125KZT2069100108;2016-05-02;-650;-650;-650;null;null;KZT;33;33;-617;-617;1
0;KZ75125KZT2069100108;2016-05-03;-669;-669;-669;null;null;KZT;19;19;-650;-650;1
0;KZ75125KZT2069100108;2016-05-04;-587;-587;-587;82;82;KZT;null;null;-669;-669;1
0;KZ75125KZT2069100108;2016-05-05;-645;-645;-645;null;null;KZT;58;58;-587;-587;1
0;KZ75125KZT2069100108;2016-05-06;-736;-736;-736;null;null;KZT;91;91;-645;-645;1
0;KZ75125KZT2069100108;2016-05-07;-778;-778;-778;null;null;KZT;42;42;-736;-736;1
0;KZ75125KZT2069100108;2016-05-08;-771;-771;-771;7;7;KZT;null;null;-778;-778;1
0;KZ75125KZT2069100108;2016-05-09;-835;-835;-835;null;null;KZT;64;64;-771;-771;1
0;KZ75125KZT2069100108;2016-05-10;-871;-871;-871;null;null;KZT;36;36;-835;-835;1
0;KZ75125KZT2069100108;2016-05-11;-894;-894;-894;null;null;KZT;23;23;-871;-871;1
0;KZ75125KZT2069100108;2016-05-12;-913;-913;-913;null;null;KZT;19;19;-894;-894;1
0;KZ75125KZT2069100108;2016-05-13;-888;-888;-888;25;25;KZT;null;null;-913;-913;1
0;KZ75125KZT2069100108;2016-05-14;-806;-806;-806;82;82;KZT;null;null;-888;-888;1
0;KZ75125KZT2069100108;2016-05-15;-726;-726;-726;80;80;KZT;null;null;-806;-806;1
0;KZ75125KZT2069100108;2016-05-16;-693;-693;-693;33;33;KZT;null;null;-726;-726;1
0;KZ75125KZT2069100108;2016-05-17;-642;-642;-642;51;51;KZT;null;null;-693;-693;1
0;KZ75125KZT2069100108;2016-05-18;-601;-601;-601;41;41;KZT;null;null;-642;-642;1
0;KZ75125KZT2069100108;2016-05-19;-541;-541;-541;60;60;KZT;null;null;-601;-601;1
0;KZ75125KZT2069100108;2016-05-20;-484;-484;-484;57;57;KZT;null;null;-541;-541;1
0;KZ75125KZT2069100108;2016-05-21;-426;-426;-426;58;58;KZT;null;null;-484;-484;1
0;KZ75125KZT2069100108;2016-05-22;-492;-492;-492;null;null;KZT;66;66;-426;-426;1
0;KZ75125KZT2069100108;2016-05-23;-541;-541;-541;null;null;KZT;49;49;-492;-492;1
0;KZ75125KZT2069100108;2016-05-24;-543;-543;-543;null;null;KZT;2;2;-541;-541;1
0;KZ75125KZT2069100108;2016-05-25;-553;-553;-553;null;null;KZT;10;10;-543;-543;1
0;KZ75125KZT2069100108;2016-05-26;-555;-555;-555;null;null;KZT;2;2;-553;-553;1
0;KZ75125KZT2069100108;2016-05-27;-614;-614;-614;null;null;KZT;59;59;-555;-555;1
0;KZ75125KZT2069100108;2016-05-28;-694;-694;-694;null;null;KZT;80;80;-614;-614;1
0;KZ75125KZT2069100108;2016-05-29;-750;-750;-750;null;null;KZT;56;56;-694;-694;1
0;KZ75125KZT2069100108;2016-05-30;-700;-700;-700;50;50;KZT;null;null;-750;-750;1
0;KZ75125KZT2069100108;2016-05-31;-645;-645;-645;55;55;KZT;null;null;-700;-700;1
0;KZ75125KZT2069100108;2016-06-01;-665;-665;-665;null;null;KZT;20;20;-645;-645;1
0;KZ75125KZT2069100108;2016-06-02;-758;-758;-758;null;null;KZT;93;93;-665;-665;1
0;KZ75125KZT2069100108;2016-06-03;-756;-756;-756;2;2;KZT;null;null;-758;-758;1
0;KZ75125KZT2069100108;2016-06-04;-735;-735;-735;21;21;KZT;null;null;-756;-756;1
0;KZ75125KZT2069100108;2016-06-05;-659;-659;-659;76;76;KZT;null;null;-735;-735;1
0;KZ75125KZT2069100108;2016-06-06;-706;-706;-706;null;null;KZT;47;47;-659;-659;1
0;KZ75125KZT2069100108;2016-06-07;-752;-752;-752;null;null;KZT;46;46;-706;-706;1
0;KZ75125KZT2069100108;2016-06-08;-682;-682;-682;70;70;KZT;null;null;-752;-752;1
0;KZ75125KZT2069100108;2016-06-09;-587;-587;-587;95;95;KZT;null;null;-682;-682;1
0;KZ75125KZT2069100108;2016-06-10;-640;-640;-640;null;null;KZT;53;53;-587;-587;1
0;KZ75125KZT2069100108;2016-06-11;-621;-621;-621;19;19;KZT;null;null;-640;-640;1
0;KZ75125KZT2069100108;2016-06-12;-564;-564;-564;57;57;KZT;null;null;-621;-621;1
0;KZ75125KZT2069100108;2016-06-13;-657;-657;-657;null;null;KZT;93;93;-564;-564;1
0;KZ75125KZT2069100108;2016-06-14;-645;-645;-645;12;12;KZT;null;null;-657;-657;1
0;KZ75125KZT2069100108;2016-06-15;-727;-727;-727;null;null;KZT;82;82;-645;-645;1
0;KZ75125KZT2069100108;2016-06-16;-781;-781;-781;null;null;KZT;54;54;-727;-727;1
0;KZ75125KZT2069100108;2016-06-17;-763;-763;-763;18;18;KZT;null;null;-781;-781;1
0;KZ75125KZT2069100108;2016-06-18;-697;-697;-697;66;66;KZT;null;null;-763;-763;1
0;KZ75125KZT2069100108;2016-06-19;-632;-632;-632;65;65;KZT;null;null;-697;-697;1
0;KZ75125KZT2069100108;2016-06-20;-716;-716;-716;null;null;KZT;84;84;-632;-632;1
0;KZ75125KZT2069100108;2016-06-21;-777;-777;-777;null;null;KZT;61;61;-716;-716;1
0;KZ75125KZT2069100108;2016-06-22;-702;-702;-702;75;75;KZT;null;null;-777;-777;1
0;KZ75125KZT2069100108;2016-06-23;-625;-625;-625;77;77;KZT;null;null;-702;-702;1
0;KZ75125KZT2069100108;2016-06-24;-628;-628;-628;null;null;KZT;3;3;-625;-625;1
0;KZ75125KZT2069100108;2016-06-25;-535;-535;-535;93;93;KZT;null;null;-628;-628;1
0;KZ75125KZT2069100108;2016-06-26;-625;-625;-625;null;null;KZT;90;90;-535;-535;1
0;KZ75125KZT2069100108;2016-06-27;-677;-677;-677;null;null;KZT;52;52;-625;-625;1
0;KZ75125KZT2069100108;2016-06-28;-604;-604;-604;73;73;KZT;null;null;-677;-677;1
0;KZ75125KZT2069100108;2016-06-29;-657;-657;-657;null;null;KZT;53;53;-604;-604;1
0;KZ75125KZT2069100108;2016-06-30;-669;-669;-669;null;null;KZT;12;12;-657;-657;1
0;KZ75125KZT2069100108;2016-07-01;-698;-698;-698;null;null;KZT;29;29;-669;-669;1
0;KZ75125KZT2069100108;2016-07-02;-761;-761;-761;null;null;KZT;63;63;-698;-698;1
0;KZ75125KZT2069100108;2016-07-03;-713;-713;-713;48;48;KZT;null;null;-761;-761;1
0;KZ75125KZT2069100108;2016-07-04;-642;-642;-642;71;71;KZT;null;null;-713;-713;1
0;KZ75125KZT2069100108;2016-07-05;-682;-682;-682;null;null;KZT;40;40;-642;-642;1
0;KZ75125KZT2069100108;2016-07-06;-733;-733;-733;null;null;KZT;51;51;-682;-682;1
0;KZ75125KZT2069100108;2016-07-07;-742;-742;-742;null;null;KZT;9;9;-733;-733;1
0;KZ75125KZT2069100108;2016-07-08;-658;-658;-658;84;84;KZT;null;null;-742;-742;1
0;KZ75125KZT2069100108;2016-07-09;-744;-744;-744;null;null;KZT;86;86;-658;-658;1
0;KZ75125KZT2069100108;2016-07-10;-658;-658;-658;86;86;KZT;null;null;-744;-744;1
0;KZ75125KZT2069100108;2016-07-11;-687;-687;-687;null;null;KZT;29;29;-658;-658;1
0;KZ75125KZT2069100108;2016-07-12;-778;-778;-778;null;null;KZT;91;91;-687;-687;1
0;KZ75125KZT2069100108;2016-07-13;-718;-718;-718;60;60;KZT;null;null;-778;-778;1
0;KZ75125KZT2069100108;2016-07-14;-728;-728;-728;null;null;KZT;10;10;-718;-718;1
0;KZ75125KZT2069100108;2016-07-15;-717;-717;-717;11;11;KZT;null;null;-728;-728;1
0;KZ75125KZT2069100108;2016-07-16;-687;-687;-687;30;30;KZT;null;null;-717;-717;1
0;KZ75125KZT2069100108;2016-07-17;-609;-609;-609;78;78;KZT;null;null;-687;-687;1
0;KZ75125KZT2069100108;2016-07-18;-619;-619;-619;null;null;KZT;10;10;-609;-609;1
0;KZ75125KZT2069100108;2016-07-19;-556;-556;-556;63;63;KZT;null;null;-619;-619;1
0;KZ75125KZT2069100108;2016-07-20;-618;-618;-618;null;null;KZT;62;62;-556;-556;1
0;KZ75125KZT2069100108;2016-07-21;-703;-703;-703;null;null;KZT;85;85;-618;-618;1
0;KZ75125KZT2069100108;2016-07-22;-792;-792;-792;null;null;KZT;89;89;-703;-703;1
0;KZ75125KZT2069100108;2016-07-23;-795;-795;-795;null;null;KZT;3;3;-792;-792;1
0;KZ75125KZT2069100108;2016-07-24;-760;-760;-760;35;35;KZT;null;null;-795;-795;1
0;KZ75125KZT2069100108;2016-07-25;-800;-800;-800;null;null;KZT;40;40;-760;-760;1
0;KZ75125KZT2069100108;2016-07-26;-822;-822;-822;null;null;KZT;22;22;-800;-800;1
0;KZ75125KZT2069100108;2016-07-27;-861;-861;-861;null;null;KZT;39;39;-822;-822;1
0;KZ75125KZT2069100108;2016-07-28;-791;-791;-791;70;70;KZT;null;null;-861;-861;1
0;KZ75125KZT2069100108;2016-07-29;-764;-764;-764;27;27;KZT;null;null;-791;-791;1
0;KZ75125KZT2069100108;2016-07-30;-852;-852;-852;null;null;KZT;88;88;-764;-764;1
0;KZ75125KZT2069100108;2016-07-31;-820;-820;-820;32;32;KZT;null;null;-852;-852;1
0;KZ75125KZT2069100108;2016-08-01;-771;-771;-771;49;49;KZT;null;null;-820;-820;1
0;KZ75125KZT2069100108;2016-08-02;-781;-781;-781;null;null;KZT;10;10;-771;-771;1
0;KZ75125KZT2069100108;2016-08-03;-766;-766;-766;15;15;KZT;null;null;-781;-781;1
0;KZ75125KZT2069100108;2016-08-04;-772;-772;-772;null;null;KZT;6;6;-766;-766;1
0;KZ75125KZT2069100108;2016-08-05;-736;-736;-736;36;36;KZT;null;null;-772;-772;1
0;KZ75125KZT2069100108;2016-08-06;-688;-688;-688;48;48;KZT;null;null;-736;-736;1
0;KZ75125KZT2069100108;2016-08-07;-726;-726;-726;null;null;KZT;38;38;-688;-688;1
0;KZ75125KZT2069100108;2016-08-08;-754;-754;-754;null;null;KZT;28;28;-726;-726;1
0;KZ75125KZT2069100108;2016-08-09;-762;-762;-762;null;null;KZT;8;8;-754;-754;1
0;KZ75125KZT2069100108;2016-08-10;-843;-843;-843;null;null;KZT;81;81;-762;-762;1
0;KZ75125KZT2069100108;2016-08-11;-783;-783;-783;60;60;KZT;null;null;-843;-843;1
0;KZ75125KZT2069100108;2016-08-12;-879;-879;-879;null;null;KZT;96;96;-783;-783;1
0;KZ75125KZT2069100108;2016-08-13;-942;-942;-942;null;null;KZT;63;63;-879;-879;1
0;KZ75125KZT2069100108;2016-08-14;-963;-963;-963;null;null;KZT;21;21;-942;-942;1
0;KZ75125KZT2069100108;2016-08-15;-872;-872;-872;91;91;KZT;null;null;-963;-963;1
0;KZ75125KZT2069100108;2016-08-16;-969;-969;-969;null;null;KZT;97;97;-872;-872;1
0;KZ75125KZT2069100108;2016-08-17;-871;-871;-871;98;98;KZT;null;null;-969;-969;1
0;KZ75125KZT2069100108;2016-08-18;-881;-881;-881;null;null;KZT;10;10;-871;-871;1
0;KZ75125KZT2069100108;2016-08-19;-902;-902;-902;null;null;KZT;21;21;-881;-881;1
0;KZ75125KZT2069100108;2016-08-20;-812;-812;-812;90;90;KZT;null;null;-902;-902;1
0;KZ75125KZT2069100108;2016-08-21;-838;-838;-838;null;null;KZT;26;26;-812;-812;1
0;KZ75125KZT2069100108;2016-08-22;-788;-788;-788;50;50;KZT;null;null;-838;-838;1
0;KZ75125KZT2069100108;2016-08-23;-720;-720;-720;68;68;KZT;null;null;-788;-788;1
0;KZ75125KZT2069100108;2016-08-24;-642;-642;-642;78;78;KZT;null;null;-720;-720;1
0;KZ75125KZT2069100108;2016-08-25;-693;-693;-693;null;null;KZT;51;51;-642;-642;1
0;KZ75125KZT2069100108;2016-08-26;-657;-657;-657;36;36;KZT;null;null;-693;-693;1
0;KZ75125KZT2069100108;2016-08-27;-718;-718;-718;null;null;KZT;61;61;-657;-657;1
0;KZ75125KZT2069100108;2016-08-28;-732;-732;-732;null;null;KZT;14;14;-718;-718;1
0;KZ75125KZT2069100108;2016-08-29;-713;-713;-713;19;19;KZT;null;null;-732;-732;1
0;KZ75125KZT2069100108;2016-08-30;-788;-788;-788;null;null;KZT;75;75;-713;-713;1
0;KZ75125KZT2069100108;2016-08-31;-696;-696;-696;92;92;KZT;null;null;-788;-788;1
0;KZ75125KZT2069100108;2016-09-01;-711;-711;-711;null;null;KZT;15;15;-696;-696;1
0;KZ75125KZT2069100108;2016-09-02;-756;-756;-756;null;null;KZT;45;45;-711;-711;1
0;KZ75125KZT2069100108;2016-09-03;-717;-717;-717;39;39;KZT;null;null;-756;-756;1
0;KZ75125KZT2069100108;2016-09-04;-683;-683;-683;34;34;KZT;null;null;-717;-717;1
0;KZ75125KZT2069100108;2016-09-05;-736;-736;-736;null;null;KZT;53;53;-683;-683;1
0;KZ75125KZT2069100108;2016-09-06;-787;-787;-787;null;null;KZT;51;51;-736;-736;1
0;KZ75125KZT2069100108;2016-09-07;-725;-725;-725;62;62;KZT;null;null;-787;-787;1
0;KZ75125KZT2069100108;2016-09-08;-721;-721;-721;4;4;KZT;null;null;-725;-725;1
0;KZ75125KZT2069100108;2016-09-09;-640;-640;-640;81;81;KZT;null;null;-721;-721;1
0;KZ75125KZT2069100108;2016-09-10;-663;-663;-663;null;null;KZT;23;23;-640;-640;1
0;KZ75125KZT2069100108;2016-09-11;-704;-704;-704;null;null;KZT;41;41;-663;-663;1
0;KZ75125KZT2069100108;2016-09-12;-744;-744;-744;null;null;KZT;40;40;-704;-704;1
0;KZ75125KZT2069100108;2016-09-13;-786;-786;-786;null;null;KZT;42;42;-744;-744;1
0;KZ75125KZT2069100108;2016-09-14;-883;-883;-883;null;null;KZT;97;97;-786;-786;1
0;KZ75125KZT2069100108;2016-09-15;-858;-858;-858;25;25;KZT;null;null;-883;-883;1
0;KZ75125KZT2069100108;2016-09-16;-921;-921;-921;null;null;KZT;63;63;-858;-858;1
0;KZ75125KZT2069100108;2016-09-17;-885;-885;-885;36;36;KZT;null;null;-921;-921;1
0;KZ75125KZT2069100108;2016-09-18;-935;-935;-935;null;null;KZT;50;50;-885;-885;1
0;KZ75125KZT2069100108;2016-09-19;-854;-854;-854;81;81;KZT;null;null;-935;-935;1
0;KZ75125KZT2069100108;2016-09-20;-871;-871;-871;null;null;KZT;17;17;-854;-854;1
0;KZ75125KZT2069100108;2016-09-21;-831;-831;-831;40;40;KZT;null;null;-871;-871;1
0;KZ75125KZT2069100108;2016-09-22;-913;-913;-913;null;null;KZT;82;82;-831;-831;1
0;KZ75125KZT2069100108;2016-09-23;-854;-854;-854;59;59;KZT;null;null;-913;-913;1
0;KZ75125KZT2069100108;2016-09-24;-864;-864;-864;null;null;KZT;10;10;-854;-854;1
0;KZ75125KZT2069100108;2016-09-25;-807;-807;-807;57;57;KZT;null;null;-864;-864;1
0;KZ75125KZT2069100108;2016-09-26;-732;-732;-732;75;75;KZT;null;null;-807;-807;1
0;KZ75125KZT2069100108;2016-09-27;-721;-721;-721;11;11;KZT;null;null;-732;-732;1
0;KZ75125KZT2069100108;2016-09-28;-787;-787;-787;null;null;KZT;66;66;-721;-721;1
0;KZ75125KZT2069100108;2016-09-29;-843;-843;-843;null;null;KZT;56;56;-787;-787;1
0;KZ75125KZT2069100108;2016-09-30;-863;-863;-863;null;null;KZT;20;20;-843;-843;1
0;KZ75125KZT2069100108;2016-10-01;-855;-855;-855;8;8;KZT;null;null;-863;-863;1
0;KZ75125KZT2069100108;2016-10-02;-882;-882;-882;null;null;KZT;27;27;-855;-855;1
0;KZ75125KZT2069100108;2016-10-03;-841;-841;-841;41;41;KZT;null;null;-882;-882;1
0;KZ75125KZT2069100108;2016-10-04;-865;-865;-865;null;null;KZT;24;24;-841;-841;1
0;KZ75125KZT2069100108;2016-10-05;-844;-844;-844;21;21;KZT;null;null;-865;-865;1
0;KZ75125KZT2069100108;2016-10-06;-876;-876;-876;null;null;KZT;32;32;-844;-844;1
0;KZ75125KZT2069100108;2016-10-07;-944;-944;-944;null;null;KZT;68;68;-876;-876;1
0;KZ75125KZT2069100108;2016-10-08;-908;-908;-908;36;36;KZT;null;null;-944;-944;1
0;KZ75125KZT2069100108;2016-10-09;-882;-882;-882;26;26;KZT;null;null;-908;-908;1
0;KZ75125KZT2069100108;2016-10-10;-788;-788;-788;94;94;KZT;null;null;-882;-882;1
0;KZ75125KZT2069100108;2016-10-11;-717;-717;-717;71;71;KZT;null;null;-788;-788;1
0;KZ75125KZT2069100108;2016-10-12;-665;-665;-665;52;52;KZT;null;null;-717;-717;1
0;KZ75125KZT2069100108;2016-10-13;-655;-655;-655;10;10;KZT;null;null;-665;-665;1
0;KZ75125KZT2069100108;2016-10-14;-735;-735;-735;null;null;KZT;80;80;-655;-655;1
0;KZ75125KZT2069100108;2016-10-15;-801;-801;-801;null;null;KZT;66;66;-735;-735;1
0;KZ75125KZT2069100108;2016-10-16;-865;-865;-865;null;null;KZT;64;64;-801;-801;1
0;KZ75125KZT2069100108;2016-10-17;-840;-840;-840;25;25;KZT;null;null;-865;-865;1
0;KZ75125KZT2069100108;2016-10-18;-901;-901;-901;null;null;KZT;61;61;-840;-840;1
0;KZ75125KZT2069100108;2016-10-19;-853;-853;-853;48;48;KZT;null;null;-901;-901;1
0;KZ75125KZT2069100108;2016-10-20;-896;-896;-896;null;null;KZT;43;43;-853;-853;1
0;KZ75125KZT2069100108;2016-10-21;-814;-814;-814;82;82;KZT;null;null;-896;-896;1
0;KZ75125KZT2069100108;2016-10-22;-724;-724;-724;90;90;KZT;null;null;-814;-814;1
0;KZ75125KZT2069100108;2016-10-23;-747;-747;-747;null;null;KZT;23;23;-724;-724;1
0;KZ75125KZT2069100108;2016-10-24;-840;-840;-840;null;null;KZT;93;93;-747;-747;1
0;KZ75125KZT2069100108;2016-10-25;-811;-811;-811;29;29;KZT;null;null;-840;-840;1
0;KZ75125KZT2069100108;2016-10-26;-712;-712;-712;99;99;KZT;null;null;-811;-811;1
0;KZ75125KZT2069100108;2016-10-27;-800;-800;-800;null;null;KZT;88;88;-712;-712;1
0;KZ75125KZT2069100108;2016-10-28;-889;-889;-889;null;null;KZT;89;89;-800;-800;1
0;KZ75125KZT2069100108;2016-10-29;-807;-807;-807;82;82;KZT;null;null;-889;-889;1
0;KZ75125KZT2069100108;2016-10-30;-804;-804;-804;3;3;KZT;null;null;-807;-807;1
0;KZ75125KZT2069100108;2016-10-31;-744;-744;-744;60;60;KZT;null;null;-804;-804;1
0;KZ75125KZT2069100108;2016-11-01;-673;-673;-673;71;71;KZT;null;null;-744;-744;1
0;KZ75125KZT2069100108;2016-11-02;-605;-605;-605;68;68;KZT;null;null;-673;-673;1
0;KZ75125KZT2069100108;2016-11-03;-670;-670;-670;null;null;KZT;65;65;-605;-605;1
0;KZ75125KZT2069100108;2016-11-04;-744;-744;-744;null;null;KZT;74;74;-670;-670;1
0;KZ75125KZT2069100108;2016-11-05;-662;-662;-662;82;82;KZT;null;null;-744;-744;1
0;KZ75125KZT2069100108;2016-11-06;-637;-637;-637;25;25;KZT;null;null;-662;-662;1
0;KZ75125KZT2069100108;2016-11-07;-575;-575;-575;62;62;KZT;null;null;-637;-637;1
0;KZ75125KZT2069100108;2016-11-08;-482;-482;-482;93;93;KZT;null;null;-575;-575;1
0;KZ75125KZT2069100108;2016-11-09;-384;-384;-384;98;98;KZT;null;null;-482;-482;1
0;KZ75125KZT2069100108;2016-11-10;-293;-293;-293;91;91;KZT;null;null;-384;-384;1
0;KZ75125KZT2069100108;2016-11-11;-197;-197;-197;96;96;KZT;null;null;-293;-293;1
0;KZ75125KZT2069100108;2016-11-12;-212;-212;-212;null;null;KZT;15;15;-197;-197;1
0;KZ75125KZT2069100108;2016-11-13;-154;-154;-154;58;58;KZT;null;null;-212;-212;1
0;KZ75125KZT2069100108;2016-11-14;-134;-134;-134;20;20;KZT;null;null;-154;-154;1
0;KZ75125KZT2069100108;2016-11-15;-188;-188;-188;null;null;KZT;54;54;-134;-134;1
0;KZ75125KZT2069100108;2016-11-16;-224;-224;-224;null;null;KZT;36;36;-188;-188;1
0;KZ75125KZT2069100108;2016-11-17;-257;-257;-257;null;null;KZT;33;33;-224;-224;1
0;KZ75125KZT2069100108;2016-11-18;-230;-230;-230;27;27;KZT;null;null;-257;-257;1
0;KZ75125KZT2069100108;2016-11-19;-237;-237;-237;null;null;KZT;7;7;-230;-230;1
0;KZ75125KZT2069100108;2016-11-20;-314;-314;-314;null;null;KZT;77;77;-237;-237;1
0;KZ75125KZT2069100108;2016-11-21;-400;-400;-400;null;null;KZT;86;86;-314;-314;1
0;KZ75125KZT2069100108;2016-11-22;-442;-442;-442;null;null;KZT;42;42;-400;-400;1
0;KZ75125KZT2069100108;2016-11-23;-462;-462;-462;null;null;KZT;20;20;-442;-442;1
0;KZ75125KZT2069100108;2016-11-24;-415;-415;-415;47;47;KZT;null;null;-462;-462;1
0;KZ75125KZT2069100108;2016-11-25;-336;-336;-336;79;79;KZT;null;null;-415;-415;1
0;KZ75125KZT2069100108;2016-11-26;-371;-371;-371;null;null;KZT;35;35;-336;-336;1
0;KZ75125KZT2069100108;2016-11-27;-415;-415;-415;null;null;KZT;44;44;-371;-371;1
0;KZ75125KZT2069100108;2016-11-28;-348;-348;-348;67;67;KZT;null;null;-415;-415;1
0;KZ75125KZT2069100108;2016-11-29;-320;-320;-320;28;28;KZT;null;null;-348;-348;1
0;KZ75125KZT2069100108;2016-11-30;-269;-269;-269;51;51;KZT;null;null;-320;-320;1
0;KZ75125KZT2069100108;2016-12-01;-259;-259;-259;10;10;KZT;null;null;-269;-269;1
0;KZ75125KZT2069100108;2016-12-02;-323;-323;-323;null;null;KZT;64;64;-259;-259;1
0;KZ75125KZT2069100108;2016-12-03;-337;-337;-337;null;null;KZT;14;14;-323;-323;1
0;KZ75125KZT2069100108;2016-12-04;-242;-242;-242;95;95;KZT;null;null;-337;-337;1
0;KZ75125KZT2069100108;2016-12-05;-287;-287;-287;null;null;KZT;45;45;-242;-242;1
0;KZ75125KZT2069100108;2016-12-06;-345;-345;-345;null;null;KZT;58;58;-287;-287;1
0;KZ75125KZT2069100108;2016-12-07;-298;-298;-298;47;47;KZT;null;null;-345;-345;1
0;KZ75125KZT2069100108;2016-12-08;-303;-303;-303;null;null;KZT;5;5;-298;-298;1
0;KZ75125KZT2069100108;2016-12-09;-371;-371;-371;null;null;KZT;68;68;-303;-303;1
0;KZ75125KZT2069100108;2016-12-10;-387;-387;-387;null;null;KZT;16;16;-371;-371;1
0;KZ75125KZT2069100108;2016-12-11;-358;-358;-358;29;29;KZT;null;null;-387;-387;1
0;KZ75125KZT2069100108;2016-12-12;-270;-270;-270;88;88;KZT;null;null;-358;-358;1
0;KZ75125KZT2069100108;2016-12-13;-328;-328;-328;null;null;KZT;58;58;-270;-270;1
0;KZ75125KZT2069100108;2016-12-14;-302;-302;-302;26;26;KZT;null;null;-328;-328;1
0;KZ75125KZT2069100108;2016-12-15;-278;-278;-278;24;24;KZT;null;null;-302;-302;1
0;KZ75125KZT2069100108;2016-12-16;-345;-345;-345;null;null;KZT;67;67;-278;-278;1
0;KZ75125KZT2069100108;2016-12-17;-270;-270;-270;75;75;KZT;null;null;-345;-345;1
0;KZ75125KZT2069100108;2016-12-18;-313;-313;-313;null;null;KZT;43;43;-270;-270;1
0;KZ75125KZT2069100108;2016-12-19;-389;-389;-389;null;null;KZT;76;76;-313;-313;1
0;KZ75125KZT2069100108;2016-12-20;-366;-366;-366;23;23;KZT;null;null;-389;-389;1
0;KZ75125KZT2069100108;2016-12-21;-409;-409;-409;null;null;KZT;43;43;-366;-366;1
0;KZ75125KZT2069100108;2016-12-22;-389;-389;-389;20;20;KZT;null;null;-409;-409;1
0;KZ75125KZT2069100108;2016-12-23;-331;-331;-331;58;58;KZT;null;null;-389;-389;1
0;KZ75125KZT2069100108;2016-12-24;-423;-423;-423;null;null;KZT;92;92;-331;-331;1
0;KZ75125KZT2069100108;2016-12-25;-488;-488;-488;null;null;KZT;65;65;-423;-423;1
0;KZ75125KZT2069100108;2016-12-26;-400;-400;-400;88;88;KZT;null;null;-488;-488;1
0;KZ75125KZT2069100108;2016-12-27;-362;-362;-362;38;38;KZT;null;null;-400;-400;1
0;KZ75125KZT2069100108;2016-12-28;-296;-296;-296;66;66;KZT;null;null;-362;-362;1
0;KZ75125KZT2069100108;2016-12-29;-309;-309;-309;null;null;KZT;13;13;-296;-296;1
0;KZ75125KZT2069100108;2016-12-30;-320;-320;-320;null;null;KZT;11;11;-309;-309;1
0;KZ75125KZT2069100108;2016-12-31;-350;-350;-350;null;null;KZT;30;30;-320;-320;1
0;KZ75125KZT2069100108;2017-01-01;-279;-279;-279;71;71;KZT;null;null;-350;-350;1
0;KZ75125KZT2069100108;2017-01-02;-362;-362;-362;null;null;KZT;83;83;-279;-279;1
0;KZ75125KZT2069100108;2017-01-03;-450;-450;-450;null;null;KZT;88;88;-362;-362;1
0;KZ75125KZT2069100108;2017-01-04;-351;-351;-351;99;99;KZT;null;null;-450;-450;1
0;KZ75125KZT2069100108;2017-01-05;-429;-429;-429;null;null;KZT;78;78;-351;-351;1
0;KZ75125KZT2069100108;2017-01-06;-420;-420;-420;9;9;KZT;null;null;-429;-429;1
0;KZ75125KZT2069100108;2017-01-07;-491;-491;-491;null;null;KZT;71;71;-420;-420;1
0;KZ75125KZT2069100108;2017-01-08;-494;-494;-494;null;null;KZT;3;3;-491;-491;1
0;KZ75125KZT2069100108;2017-01-09;-454;-454;-454;40;40;KZT;null;null;-494;-494;1
0;KZ75125KZT2069100108;2017-01-10;-358;-358;-358;96;96;KZT;null;null;-454;-454;1
0;KZ75125KZT2069100108;2017-01-11;-271;-271;-271;87;87;KZT;null;null;-358;-358;1
0;KZ75125KZT2069100108;2017-01-12;-260;-260;-260;11;11;KZT;null;null;-271;-271;1
0;KZ75125KZT2069100108;2017-01-13;-339;-339;-339;null;null;KZT;79;79;-260;-260;1
0;KZ75125KZT2069100108;2017-01-14;-429;-429;-429;null;null;KZT;90;90;-339;-339;1
0;KZ75125KZT2069100108;2017-01-15;-352;-352;-352;77;77;KZT;null;null;-429;-429;1
0;KZ75125KZT2069100108;2017-01-16;-365;-365;-365;null;null;KZT;13;13;-352;-352;1
0;KZ75125KZT2069100108;2017-01-17;-400;-400;-400;null;null;KZT;35;35;-365;-365;1
0;KZ75125KZT2069100108;2017-01-18;-423;-423;-423;null;null;KZT;23;23;-400;-400;1
0;KZ75125KZT2069100108;2017-01-19;-330;-330;-330;93;93;KZT;null;null;-423;-423;1
0;KZ75125KZT2069100108;2017-01-20;-350;-350;-350;null;null;KZT;20;20;-330;-330;1
0;KZ75125KZT2069100108;2017-01-21;-444;-444;-444;null;null;KZT;94;94;-350;-350;1
0;KZ75125KZT2069100108;2017-01-22;-451;-451;-451;null;null;KZT;7;7;-444;-444;1
0;KZ75125KZT2069100108;2017-01-23;-489;-489;-489;null;null;KZT;38;38;-451;-451;1
0;KZ75125KZT2069100108;2017-01-24;-532;-532;-532;null;null;KZT;43;43;-489;-489;1
0;KZ75125KZT2069100108;2017-01-25;-532;-532;-532;null;null;KZT;0;0;-532;-532;1
0;KZ75125KZT2069100108;2017-01-26;-620;-620;-620;null;null;KZT;88;88;-532;-532;1
0;KZ75125KZT2069100108;2017-01-27;-538;-538;-538;82;82;KZT;null;null;-620;-620;1
0;KZ75125KZT2069100108;2017-01-28;-585;-585;-585;null;null;KZT;47;47;-538;-538;1
0;KZ75125KZT2069100108;2017-01-29;-531;-531;-531;54;54;KZT;null;null;-585;-585;1
0;KZ75125KZT2069100108;2017-01-30;-432;-432;-432;99;99;KZT;null;null;-531;-531;1
0;KZ75125KZT2069100108;2017-01-31;-421;-421;-421;11;11;KZT;null;null;-432;-432;1
0;KZ75125KZT2069100108;2017-02-01;-439;-439;-439;null;null;KZT;18;18;-421;-421;1
0;KZ75125KZT2069100108;2017-02-02;-380;-380;-380;59;59;KZT;null;null;-439;-439;1
0;KZ75125KZT2069100108;2017-02-03;-468;-468;-468;null;null;KZT;88;88;-380;-380;1
0;KZ75125KZT2069100108;2017-02-04;-376;-376;-376;92;92;KZT;null;null;-468;-468;1
0;KZ75125KZT2069100108;2017-02-05;-322;-322;-322;54;54;KZT;null;null;-376;-376;1
0;KZ75125KZT2069100108;2017-02-06;-421;-421;-421;null;null;KZT;99;99;-322;-322;1
0;KZ75125KZT2069100108;2017-02-07;-478;-478;-478;null;null;KZT;57;57;-421;-421;1
0;KZ75125KZT2069100108;2017-02-08;-416;-416;-416;62;62;KZT;null;null;-478;-478;1
0;KZ75125KZT2069100108;2017-02-09;-405;-405;-405;11;11;KZT;null;null;-416;-416;1
0;KZ75125KZT2069100108;2017-02-10;-391;-391;-391;14;14;KZT;null;null;-405;-405;1
0;KZ75125KZT2069100108;2017-02-11;-409;-409;-409;null;null;KZT;18;18;-391;-391;1
0;KZ75125KZT2069100108;2017-02-12;-397;-397;-397;12;12;KZT;null;null;-409;-409;1
0;KZ75125KZT2069100108;2017-02-13;-452;-452;-452;null;null;KZT;55;55;-397;-397;1
0;KZ75125KZT2069100108;2017-02-14;-439;-439;-439;13;13;KZT;null;null;-452;-452;1
0;KZ75125KZT2069100108;2017-02-15;-492;-492;-492;null;null;KZT;53;53;-439;-439;1
0;KZ75125KZT2069100108;2017-02-16;-438;-438;-438;54;54;KZT;null;null;-492;-492;1
0;KZ75125KZT2069100108;2017-02-17;-386;-386;-386;52;52;KZT;null;null;-438;-438;1
0;KZ75125KZT2069100108;2017-02-18;-444;-444;-444;null;null;KZT;58;58;-386;-386;1
0;KZ75125KZT2069100108;2017-02-19;-434;-434;-434;10;10;KZT;null;null;-444;-444;1
0;KZ75125KZT2069100108;2017-02-20;-464;-464;-464;null;null;KZT;30;30;-434;-434;1
0;KZ75125KZT2069100108;2017-02-21;-416;-416;-416;48;48;KZT;null;null;-464;-464;1
0;KZ75125KZT2069100108;2017-02-22;-340;-340;-340;76;76;KZT;null;null;-416;-416;1
0;KZ75125KZT2069100108;2017-02-23;-388;-388;-388;null;null;KZT;48;48;-340;-340;1
0;KZ75125KZT2069100108;2017-02-24;-447;-447;-447;null;null;KZT;59;59;-388;-388;1
0;KZ75125KZT2069100108;2017-02-25;-427;-427;-427;20;20;KZT;null;null;-447;-447;1
0;KZ75125KZT2069100108;2017-02-26;-357;-357;-357;70;70;KZT;null;null;-427;-427;1
0;KZ75125KZT2069100108;2017-02-27;-293;-293;-293;64;64;KZT;null;null;-357;-357;1
0;KZ75125KZT2069100108;2017-02-28;-228;-228;-228;65;65;KZT;null;null;-293;-293;1
0;KZ75125KZT2069100108;2017-03-01;-307;-307;-307;null;null;KZT;79;79;-228;-228;1
0;KZ75125KZT2069100108;2017-03-02;-371;-371;-371;null;null;KZT;64;64;-307;-307;1
0;KZ75125KZT2069100108;2017-03-03;-444;-444;-444;null;null;KZT;73;73;-371;-371;1
0;KZ75125KZT2069100108;2017-03-04;-408;-408;-408;36;36;KZT;null;null;-444;-444;1
0;KZ75125KZT2069100108;2017-03-05;-398;-398;-398;10;10;KZT;null;null;-408;-408;1
0;KZ75125KZT2069100108;2017-03-06;-456;-456;-456;null;null;KZT;58;58;-398;-398;1
0;KZ75125KZT2069100108;2017-03-07;-456;-456;-456;null;null;KZT;0;0;-456;-456;1
0;KZ75125KZT2069100108;2017-03-08;-441;-441;-441;15;15;KZT;null;null;-456;-456;1
0;KZ75125KZT2069100108;2017-03-09;-466;-466;-466;null;null;KZT;25;25;-441;-441;1
0;KZ75125KZT2069100108;2017-03-10;-419;-419;-419;47;47;KZT;null;null;-466;-466;1
0;KZ75125KZT2069100108;2017-03-11;-449;-449;-449;null;null;KZT;30;30;-419;-419;1
0;KZ75125KZT2069100108;2017-03-12;-543;-543;-543;null;null;KZT;94;94;-449;-449;1
0;KZ75125KZT2069100108;2017-03-13;-558;-558;-558;null;null;KZT;15;15;-543;-543;1
0;KZ75125KZT2069100108;2017-03-14;-638;-638;-638;null;null;KZT;80;80;-558;-558;1
0;KZ75125KZT2069100108;2017-03-15;-681;-681;-681;null;null;KZT;43;43;-638;-638;1
0;KZ75125KZT2069100108;2017-03-16;-767;-767;-767;null;null;KZT;86;86;-681;-681;1
0;KZ75125KZT2069100108;2017-03-17;-838;-838;-838;null;null;KZT;71;71;-767;-767;1
0;KZ75125KZT2069100108;2017-03-18;-827;-827;-827;11;11;KZT;null;null;-838;-838;1
0;KZ75125KZT2069100108;2017-03-19;-784;-784;-784;43;43;KZT;null;null;-827;-827;1
0;KZ75125KZT2069100108;2017-03-20;-859;-859;-859;null;null;KZT;75;75;-784;-784;1
0;KZ75125KZT2069100108;2017-03-21;-942;-942;-942;null;null;KZT;83;83;-859;-859;1
0;KZ75125KZT2069100108;2017-03-22;-872;-872;-872;70;70;KZT;null;null;-942;-942;1
0;KZ75125KZT2069100108;2017-03-23;-941;-941;-941;null;null;KZT;69;69;-872;-872;1
0;KZ75125KZT2069100108;2017-03-24;-948;-948;-948;null;null;KZT;7;7;-941;-941;1
0;KZ75125KZT2069100108;2017-03-25;-1018;-1018;-1018;null;null;KZT;70;70;-948;-948;1
0;KZ75125KZT2069100108;2017-03-26;-1108;-1108;-1108;null;null;KZT;90;90;-1018;-1018;1
0;KZ75125KZT2069100108;2017-03-27;-1099;-1099;-1099;9;9;KZT;null;null;-1108;-1108;1
0;KZ75125KZT2069100108;2017-03-28;-1187;-1187;-1187;null;null;KZT;88;88;-1099;-1099;1
0;KZ75125KZT2069100108;2017-03-29;-1093;-1093;-1093;94;94;KZT;null;null;-1187;-1187;1
0;KZ75125KZT2069100108;2017-03-30;-1035;-1035;-1035;58;58;KZT;null;null;-1093;-1093;1
0;KZ75125KZT2069100108;2017-03-31;-1131;-1131;-1131;null;null;KZT;96;96;-1035;-1035;1
0;KZ75125KZT2069100108;2017-04-01;-1045;-1045;-1045;86;86;KZT;null;null;-1131;-1131;1
0;KZ75125KZT2069100108;2017-04-02;-1065;-1065;-1065;null;null;KZT;20;20;-1045;-1045;1
0;KZ75125KZT2069100108;2017-04-03;-1035;-1035;-1035;30;30;KZT;null;null;-1065;-1065;1
0;KZ75125KZT2069100108;2017-04-04;-1111;-1111;-1111;null;null;KZT;76;76;-1035;-1035;1
0;KZ75125KZT2069100108;2017-04-05;-1047;-1047;-1047;64;64;KZT;null;null;-1111;-1111;1
0;KZ75125KZT2069100108;2017-04-06;-1108;-1108;-1108;null;null;KZT;61;61;-1047;-1047;1
0;KZ75125KZT2069100108;2017-04-07;-1142;-1142;-1142;null;null;KZT;34;34;-1108;-1108;1
0;KZ75125KZT2069100108;2017-04-08;-1114;-1114;-1114;28;28;KZT;null;null;-1142;-1142;1
0;KZ75125KZT2069100108;2017-04-09;-1145;-1145;-1145;null;null;KZT;31;31;-1114;-1114;1
0;KZ75125KZT2069100108;2017-04-10;-1210;-1210;-1210;null;null;KZT;65;65;-1145;-1145;1
0;KZ75125KZT2069100108;2017-04-11;-1187;-1187;-1187;23;23;KZT;null;null;-1210;-1210;1
0;KZ75125KZT2069100108;2017-04-12;-1137;-1137;-1137;50;50;KZT;null;null;-1187;-1187;1
0;KZ75125KZT2069100108;2017-04-13;-1229;-1229;-1229;null;null;KZT;92;92;-1137;-1137;1
0;KZ75125KZT2069100108;2017-04-14;-1310;-1310;-1310;null;null;KZT;81;81;-1229;-1229;1
0;KZ75125KZT2069100108;2017-04-15;-1329;-1329;-1329;null;null;KZT;19;19;-1310;-1310;1
0;KZ75125KZT2069100108;2017-04-16;-1298;-1298;-1298;31;31;KZT;null;null;-1329;-1329;1
0;KZ75125KZT2069100108;2017-04-17;-1316;-1316;-1316;null;null;KZT;18;18;-1298;-1298;1
0;KZ75125KZT2069100108;2017-04-18;-1316;-1316;-1316;null;null;KZT;0;0;-1316;-1316;1
0;KZ75125KZT2069100108;2017-04-19;-1385;-1385;-1385;null;null;KZT;69;69;-1316;-1316;1
0;KZ75125KZT2069100108;2017-04-20;-1326;-1326;-1326;59;59;KZT;null;null;-1385;-1385;1
0;KZ75125KZT2069100108;2017-04-21;-1355;-1355;-1355;null;null;KZT;29;29;-1326;-1326;1
0;KZ75125KZT2069100108;2017-04-22;-1333;-1333;-1333;22;22;KZT;null;null;-1355;-1355;1
0;KZ75125KZT2069100108;2017-04-23;-1359;-1359;-1359;null;null;KZT;26;26;-1333;-1333;1
0;KZ75125KZT2069100108;2017-04-24;-1316;-1316;-1316;43;43;KZT;null;null;-1359;-1359;1
0;KZ75125KZT2069100108;2017-04-25;-1292;-1292;-1292;24;24;KZT;null;null;-1316;-1316;1
0;KZ75125KZT2069100108;2017-04-26;-1384;-1384;-1384;null;null;KZT;92;92;-1292;-1292;1
0;KZ75125KZT2069100108;2017-04-27;-1326;-1326;-1326;58;58;KZT;null;null;-1384;-1384;1
0;KZ75125KZT2069100108;2017-04-28;-1369;-1369;-1369;null;null;KZT;43;43;-1326;-1326;1
0;KZ75125KZT2069100108;2017-04-29;-1363;-1363;-1363;6;6;KZT;null;null;-1369;-1369;1
0;KZ75125KZT2069100108;2017-04-30;-1284;-1284;-1284;79;79;KZT;null;null;-1363;-1363;1
0;KZ75125KZT2069100108;2017-05-01;-1284;-1284;-1284;null;null;KZT;0;0;-1284;-1284;1
0;KZ75125KZT2069100108;2017-05-02;-1363;-1363;-1363;null;null;KZT;79;79;-1284;-1284;1
0;KZ75125KZT2069100108;2017-05-03;-1354;-1354;-1354;9;9;KZT;null;null;-1363;-1363;1
0;KZ75125KZT2069100108;2017-05-04;-1390;-1390;-1390;null;null;KZT;36;36;-1354;-1354;1
0;KZ75125KZT2069100108;2017-05-05;-1345;-1345;-1345;45;45;KZT;null;null;-1390;-1390;1
0;KZ75125KZT2069100108;2017-05-06;-1425;-1425;-1425;null;null;KZT;80;80;-1345;-1345;1
0;KZ75125KZT2069100108;2017-05-07;-1438;-1438;-1438;null;null;KZT;13;13;-1425;-1425;1
0;KZ75125KZT2069100108;2017-05-08;-1361;-1361;-1361;77;77;KZT;null;null;-1438;-1438;1
0;KZ75125KZT2069100108;2017-05-09;-1315;-1315;-1315;46;46;KZT;null;null;-1361;-1361;1
0;KZ75125KZT2069100108;2017-05-10;-1352;-1352;-1352;null;null;KZT;37;37;-1315;-1315;1
0;KZ75125KZT2069100108;2017-05-11;-1390;-1390;-1390;null;null;KZT;38;38;-1352;-1352;1
0;KZ75125KZT2069100108;2017-05-12;-1303;-1303;-1303;87;87;KZT;null;null;-1390;-1390;1
0;KZ75125KZT2069100108;2017-05-13;-1335;-1335;-1335;null;null;KZT;32;32;-1303;-1303;1
0;KZ75125KZT2069100108;2017-05-14;-1245;-1245;-1245;90;90;KZT;null;null;-1335;-1335;1
0;KZ75125KZT2069100108;2017-05-15;-1289;-1289;-1289;null;null;KZT;44;44;-1245;-1245;1
0;KZ75125KZT2069100108;2017-05-16;-1210;-1210;-1210;79;79;KZT;null;null;-1289;-1289;1
0;KZ75125KZT2069100108;2017-05-17;-1253;-1253;-1253;null;null;KZT;43;43;-1210;-1210;1
0;KZ75125KZT2069100108;2017-05-18;-1257;-1257;-1257;null;null;KZT;4;4;-1253;-1253;1
0;KZ75125KZT2069100108;2017-05-19;-1284;-1284;-1284;null;null;KZT;27;27;-1257;-1257;1
0;KZ75125KZT2069100108;2017-05-20;-1366;-1366;-1366;null;null;KZT;82;82;-1284;-1284;1
0;KZ75125KZT2069100108;2017-05-21;-1416;-1416;-1416;null;null;KZT;50;50;-1366;-1366;1
0;KZ75125KZT2069100108;2017-05-22;-1420;-1420;-1420;null;null;KZT;4;4;-1416;-1416;1
0;KZ75125KZT2069100108;2017-05-23;-1518;-1518;-1518;null;null;KZT;98;98;-1420;-1420;1
0;KZ75125KZT2069100108;2017-05-24;-1536;-1536;-1536;null;null;KZT;18;18;-1518;-1518;1
0;KZ75125KZT2069100108;2017-05-25;-1571;-1571;-1571;null;null;KZT;35;35;-1536;-1536;1
0;KZ75125KZT2069100108;2017-05-26;-1560;-1560;-1560;11;11;KZT;null;null;-1571;-1571;1
0;KZ75125KZT2069100108;2017-05-27;-1482;-1482;-1482;78;78;KZT;null;null;-1560;-1560;1
0;KZ75125KZT2069100108;2017-05-28;-1488;-1488;-1488;null;null;KZT;6;6;-1482;-1482;1
0;KZ75125KZT2069100108;2017-05-29;-1467;-1467;-1467;21;21;KZT;null;null;-1488;-1488;1
0;KZ75125KZT2069100108;2017-05-30;-1533;-1533;-1533;null;null;KZT;66;66;-1467;-1467;1
0;KZ75125KZT2069100108;2017-05-31;-1513;-1513;-1513;20;20;KZT;null;null;-1533;-1533;1
0;KZ75125KZT2069100108;2017-06-01;-1505;-1505;-1505;8;8;KZT;null;null;-1513;-1513;1
0;KZ75125KZT2069100108;2017-06-02;-1432;-1432;-1432;73;73;KZT;null;null;-1505;-1505;1
0;KZ75125KZT2069100108;2017-06-03;-1379;-1379;-1379;53;53;KZT;null;null;-1432;-1432;1
0;KZ75125KZT2069100108;2017-06-04;-1401;-1401;-1401;null;null;KZT;22;22;-1379;-1379;1
0;KZ75125KZT2069100108;2017-06-05;-1392;-1392;-1392;9;9;KZT;null;null;-1401;-1401;1
0;KZ75125KZT2069100108;2017-06-06;-1396;-1396;-1396;null;null;KZT;4;4;-1392;-1392;1
0;KZ75125KZT2069100108;2017-06-07;-1477;-1477;-1477;null;null;KZT;81;81;-1396;-1396;1
0;KZ75125KZT2069100108;2017-06-08;-1454;-1454;-1454;23;23;KZT;null;null;-1477;-1477;1
0;KZ75125KZT2069100108;2017-06-09;-1550;-1550;-1550;null;null;KZT;96;96;-1454;-1454;1
0;KZ75125KZT2069100108;2017-06-10;-1571;-1571;-1571;null;null;KZT;21;21;-1550;-1550;1
0;KZ75125KZT2069100108;2017-06-11;-1546;-1546;-1546;25;25;KZT;null;null;-1571;-1571;1
0;KZ75125KZT2069100108;2017-06-12;-1598;-1598;-1598;null;null;KZT;52;52;-1546;-1546;1



0;KZ75125EUR2069101106;2016-05-07;1440;1440;1440;null;null;KZT;32;32;1472;1472;1
0;KZ75125EUR2069101106;2016-05-08;1425;1425;1425;null;null;KZT;15;15;1440;1440;1
0;KZ75125EUR2069101106;2016-05-09;1376;1376;1376;null;null;KZT;49;49;1425;1425;1
0;KZ75125EUR2069101106;2016-05-10;1300;1300;1300;null;null;KZT;76;76;1376;1376;1
0;KZ75125EUR2069101106;2016-05-11;1263;1263;1263;null;null;KZT;37;37;1300;1300;1
0;KZ75125EUR2069101106;2016-05-12;1277;1277;1277;14;14;KZT;null;null;1263;1263;1
0;KZ75125EUR2069101106;2016-05-13;1239;1239;1239;null;null;KZT;38;38;1277;1277;1
0;KZ75125EUR2069101106;2016-05-14;1152;1152;1152;null;null;KZT;87;87;1239;1239;1
0;KZ75125EUR2069101106;2016-05-15;1106;1106;1106;null;null;KZT;46;46;1152;1152;1
0;KZ75125EUR2069101106;2016-05-16;1192;1192;1192;86;86;KZT;null;null;1106;1106;1
0;KZ75125EUR2069101106;2016-05-17;1171;1171;1171;null;null;KZT;21;21;1192;1192;1
0;KZ75125EUR2069101106;2016-05-18;1142;1142;1142;null;null;KZT;29;29;1171;1171;1
0;KZ75125EUR2069101106;2016-05-19;1047;1047;1047;null;null;KZT;95;95;1142;1142;1
0;KZ75125EUR2069101106;2016-05-20;949;949;949;null;null;KZT;98;98;1047;1047;1
0;KZ75125EUR2069101106;2016-05-21;898;898;898;null;null;KZT;51;51;949;949;1
0;KZ75125EUR2069101106;2016-05-22;903;903;903;5;5;KZT;null;null;898;898;1
0;KZ75125EUR2069101106;2016-05-23;878;878;878;null;null;KZT;25;25;903;903;1
0;KZ75125EUR2069101106;2016-05-24;838;838;838;null;null;KZT;40;40;878;878;1
0;KZ75125EUR2069101106;2016-05-25;932;932;932;94;94;KZT;null;null;838;838;1
0;KZ75125EUR2069101106;2016-05-26;870;870;870;null;null;KZT;62;62;932;932;1
0;KZ75125EUR2069101106;2016-05-27;779;779;779;null;null;KZT;91;91;870;870;1
0;KZ75125EUR2069101106;2016-05-28;754;754;754;null;null;KZT;25;25;779;779;1
0;KZ75125EUR2069101106;2016-05-29;737;737;737;null;null;KZT;17;17;754;754;1
0;KZ75125EUR2069101106;2016-05-30;740;740;740;3;3;KZT;null;null;737;737;1
0;KZ75125EUR2069101106;2016-05-31;791;791;791;51;51;KZT;null;null;740;740;1
0;KZ75125EUR2069101106;2016-06-01;848;848;848;57;57;KZT;null;null;791;791;1
0;KZ75125EUR2069101106;2016-06-02;764;764;764;null;null;KZT;84;84;848;848;1
0;KZ75125EUR2069101106;2016-06-03;673;673;673;null;null;KZT;91;91;764;764;1
0;KZ75125EUR2069101106;2016-06-04;739;739;739;66;66;KZT;null;null;673;673;1
0;KZ75125EUR2069101106;2016-06-05;698;698;698;null;null;KZT;41;41;739;739;1
0;KZ75125EUR2069101106;2016-06-06;662;662;662;null;null;KZT;36;36;698;698;1
0;KZ75125EUR2069101106;2016-06-07;603;603;603;null;null;KZT;59;59;662;662;1
0;KZ75125EUR2069101106;2016-06-08;519;519;519;null;null;KZT;84;84;603;603;1
0;KZ75125EUR2069101106;2016-06-09;582;582;582;63;63;KZT;null;null;519;519;1
0;KZ75125EUR2069101106;2016-06-10;536;536;536;null;null;KZT;46;46;582;582;1
0;KZ75125EUR2069101106;2016-06-11;536;536;536;null;null;KZT;0;0;536;536;1
0;KZ75125EUR2069101106;2016-06-12;541;541;541;5;5;KZT;null;null;536;536;1
0;KZ75125EUR2069101106;2016-06-13;585;585;585;44;44;KZT;null;null;541;541;1
0;KZ75125EUR2069101106;2016-06-14;656;656;656;71;71;KZT;null;null;585;585;1
0;KZ75125EUR2069101106;2016-06-15;714;714;714;58;58;KZT;null;null;656;656;1
0;KZ75125EUR2069101106;2016-06-16;732;732;732;18;18;KZT;null;null;714;714;1
0;KZ75125EUR2069101106;2016-06-17;677;677;677;null;null;KZT;55;55;732;732;1
0;KZ75125EUR2069101106;2016-06-18;750;750;750;73;73;KZT;null;null;677;677;1
0;KZ75125EUR2069101106;2016-06-19;764;764;764;14;14;KZT;null;null;750;750;1
0;KZ75125EUR2069101106;2016-06-20;803;803;803;39;39;KZT;null;null;764;764;1
0;KZ75125EUR2069101106;2016-06-21;719;719;719;null;null;KZT;84;84;803;803;1
0;KZ75125EUR2069101106;2016-06-22;746;746;746;27;27;KZT;null;null;719;719;1
0;KZ75125EUR2069101106;2016-06-23;747;747;747;1;1;KZT;null;null;746;746;1
0;KZ75125EUR2069101106;2016-06-24;760;760;760;13;13;KZT;null;null;747;747;1
0;KZ75125EUR2069101106;2016-06-25;728;728;728;null;null;KZT;32;32;760;760;1
0;KZ75125EUR2069101106;2016-06-26;741;741;741;13;13;KZT;null;null;728;728;1
0;KZ75125EUR2069101106;2016-06-27;821;821;821;80;80;KZT;null;null;741;741;1
0;KZ75125EUR2069101106;2016-06-28;805;805;805;null;null;KZT;16;16;821;821;1
0;KZ75125EUR2069101106;2016-06-29;835;835;835;30;30;KZT;null;null;805;805;1
0;KZ75125EUR2069101106;2016-06-30;907;907;907;72;72;KZT;null;null;835;835;1
0;KZ75125EUR2069101106;2016-07-01;907;907;907;null;null;KZT;0;0;907;907;1
0;KZ75125EUR2069101106;2016-07-02;863;863;863;null;null;KZT;44;44;907;907;1
0;KZ75125EUR2069101106;2016-07-03;857;857;857;null;null;KZT;6;6;863;863;1
0;KZ75125EUR2069101106;2016-07-04;836;836;836;null;null;KZT;21;21;857;857;1
0;KZ75125EUR2069101106;2016-07-05;901;901;901;65;65;KZT;null;null;836;836;1
0;KZ75125EUR2069101106;2016-07-06;923;923;923;22;22;KZT;null;null;901;901;1
0;KZ75125EUR2069101106;2016-07-07;908;908;908;null;null;KZT;15;15;923;923;1
0;KZ75125EUR2069101106;2016-07-08;949;949;949;41;41;KZT;null;null;908;908;1
0;KZ75125EUR2069101106;2016-07-09;908;908;908;null;null;KZT;41;41;949;949;1
0;KZ75125EUR2069101106;2016-07-10;843;843;843;null;null;KZT;65;65;908;908;1
0;KZ75125EUR2069101106;2016-07-11;873;873;873;30;30;KZT;null;null;843;843;1
0;KZ75125EUR2069101106;2016-07-12;855;855;855;null;null;KZT;18;18;873;873;1
0;KZ75125EUR2069101106;2016-07-13;825;825;825;null;null;KZT;30;30;855;855;1
0;KZ75125EUR2069101106;2016-07-14;874;874;874;49;49;KZT;null;null;825;825;1
0;KZ75125EUR2069101106;2016-07-15;917;917;917;43;43;KZT;null;null;874;874;1
0;KZ75125EUR2069101106;2016-07-16;827;827;827;null;null;KZT;90;90;917;917;1
0;KZ75125EUR2069101106;2016-07-17;807;807;807;null;null;KZT;20;20;827;827;1
0;KZ75125EUR2069101106;2016-07-18;712;712;712;null;null;KZT;95;95;807;807;1
0;KZ75125EUR2069101106;2016-07-19;756;756;756;44;44;KZT;null;null;712;712;1
0;KZ75125EUR2069101106;2016-07-20;818;818;818;62;62;KZT;null;null;756;756;1
0;KZ75125EUR2069101106;2016-07-21;811;811;811;null;null;KZT;7;7;818;818;1
0;KZ75125EUR2069101106;2016-07-22;797;797;797;null;null;KZT;14;14;811;811;1
0;KZ75125EUR2069101106;2016-07-23;800;800;800;3;3;KZT;null;null;797;797;1
0;KZ75125EUR2069101106;2016-07-24;871;871;871;71;71;KZT;null;null;800;800;1
0;KZ75125EUR2069101106;2016-07-25;833;833;833;null;null;KZT;38;38;871;871;1
0;KZ75125EUR2069101106;2016-07-26;748;748;748;null;null;KZT;85;85;833;833;1
0;KZ75125EUR2069101106;2016-07-27;650;650;650;null;null;KZT;98;98;748;748;1
0;KZ75125EUR2069101106;2016-07-28;599;599;599;null;null;KZT;51;51;650;650;1
0;KZ75125EUR2069101106;2016-07-29;606;606;606;7;7;KZT;null;null;599;599;1
0;KZ75125EUR2069101106;2016-07-30;596;596;596;null;null;KZT;10;10;606;606;1
0;KZ75125EUR2069101106;2016-07-31;545;545;545;null;null;KZT;51;51;596;596;1
0;KZ75125EUR2069101106;2016-08-01;586;586;586;41;41;KZT;null;null;545;545;1
0;KZ75125EUR2069101106;2016-08-02;671;671;671;85;85;KZT;null;null;586;586;1
0;KZ75125EUR2069101106;2016-08-03;675;675;675;4;4;KZT;null;null;671;671;1
0;KZ75125EUR2069101106;2016-08-04;642;642;642;null;null;KZT;33;33;675;675;1
0;KZ75125EUR2069101106;2016-08-05;627;627;627;null;null;KZT;15;15;642;642;1
0;KZ75125EUR2069101106;2016-08-06;632;632;632;5;5;KZT;null;null;627;627;1
0;KZ75125EUR2069101106;2016-08-07;597;597;597;null;null;KZT;35;35;632;632;1
0;KZ75125EUR2069101106;2016-08-08;570;570;570;null;null;KZT;27;27;597;597;1
0;KZ75125EUR2069101106;2016-08-09;497;497;497;null;null;KZT;73;73;570;570;1
0;KZ75125EUR2069101106;2016-08-10;426;426;426;null;null;KZT;71;71;497;497;1
0;KZ75125EUR2069101106;2016-08-11;496;496;496;70;70;KZT;null;null;426;426;1
0;KZ75125EUR2069101106;2016-08-12;401;401;401;null;null;KZT;95;95;496;496;1
0;KZ75125EUR2069101106;2016-08-13;402;402;402;1;1;KZT;null;null;401;401;1
0;KZ75125EUR2069101106;2016-08-14;357;357;357;null;null;KZT;45;45;402;402;1
0;KZ75125EUR2069101106;2016-08-15;335;335;335;null;null;KZT;22;22;357;357;1
0;KZ75125EUR2069101106;2016-08-16;262;262;262;null;null;KZT;73;73;335;335;1
0;KZ75125EUR2069101106;2016-08-17;340;340;340;78;78;KZT;null;null;262;262;1
0;KZ75125EUR2069101106;2016-08-18;274;274;274;null;null;KZT;66;66;340;340;1
0;KZ75125EUR2069101106;2016-08-19;345;345;345;71;71;KZT;null;null;274;274;1
0;KZ75125EUR2069101106;2016-08-20;269;269;269;null;null;KZT;76;76;345;345;1
0;KZ75125EUR2069101106;2016-08-21;319;319;319;50;50;KZT;null;null;269;269;1
0;KZ75125EUR2069101106;2016-08-22;256;256;256;null;null;KZT;63;63;319;319;1
0;KZ75125EUR2069101106;2016-08-23;354;354;354;98;98;KZT;null;null;256;256;1
0;KZ75125EUR2069101106;2016-08-24;317;317;317;null;null;KZT;37;37;354;354;1
0;KZ75125EUR2069101106;2016-08-25;267;267;267;null;null;KZT;50;50;317;317;1
0;KZ75125EUR2069101106;2016-08-26;319;319;319;52;52;KZT;null;null;267;267;1
0;KZ75125EUR2069101106;2016-08-27;295;295;295;null;null;KZT;24;24;319;319;1
0;KZ75125EUR2069101106;2016-08-28;205;205;205;null;null;KZT;90;90;295;295;1
0;KZ75125EUR2069101106;2016-08-29;176;176;176;null;null;KZT;29;29;205;205;1
0;KZ75125EUR2069101106;2016-08-30;87;87;87;null;null;KZT;89;89;176;176;1
0;KZ75125EUR2069101106;2016-08-31;62;62;62;null;null;KZT;25;25;87;87;1
0;KZ75125EUR2069101106;2016-09-01;106;106;106;44;44;KZT;null;null;62;62;1
0;KZ75125EUR2069101106;2016-09-02;182;182;182;76;76;KZT;null;null;106;106;1
0;KZ75125EUR2069101106;2016-09-03;201;201;201;19;19;KZT;null;null;182;182;1
0;KZ75125EUR2069101106;2016-09-04;113;113;113;null;null;KZT;88;88;201;201;1
0;KZ75125EUR2069101106;2016-09-05;90;90;90;null;null;KZT;23;23;113;113;1
0;KZ75125EUR2069101106;2016-09-06;105;105;105;15;15;KZT;null;null;90;90;1
0;KZ75125EUR2069101106;2016-09-07;164;164;164;59;59;KZT;null;null;105;105;1
0;KZ75125EUR2069101106;2016-09-08;96;96;96;null;null;KZT;68;68;164;164;1
0;KZ75125EUR2069101106;2016-09-09;172;172;172;76;76;KZT;null;null;96;96;1
0;KZ75125EUR2069101106;2016-09-10;96;96;96;null;null;KZT;76;76;172;172;1
0;KZ75125EUR2069101106;2016-09-11;32;32;32;null;null;KZT;64;64;96;96;1
0;KZ75125EUR2069101106;2016-09-12;66;66;66;34;34;KZT;null;null;32;32;1
0;KZ75125EUR2069101106;2016-09-13;60;60;60;null;null;KZT;6;6;66;66;1
0;KZ75125EUR2069101106;2016-09-14;75;75;75;15;15;KZT;null;null;60;60;1
0;KZ75125EUR2069101106;2016-09-15;49;49;49;null;null;KZT;26;26;75;75;1
0;KZ75125EUR2069101106;2016-09-16;96;96;96;47;47;KZT;null;null;49;49;1
0;KZ75125EUR2069101106;2016-09-17;37;37;37;null;null;KZT;59;59;96;96;1
0;KZ75125EUR2069101106;2016-09-18;21;21;21;null;null;KZT;16;16;37;37;1
0;KZ75125EUR2069101106;2016-09-19;-24;-24;-24;null;null;KZT;45;45;21;21;1
0;KZ75125EUR2069101106;2016-09-20;40;40;40;64;64;KZT;null;null;-24;-24;1
0;KZ75125EUR2069101106;2016-09-21;-41;-41;-41;null;null;KZT;81;81;40;40;1
0;KZ75125EUR2069101106;2016-09-22;-56;-56;-56;null;null;KZT;15;15;-41;-41;1
0;KZ75125EUR2069101106;2016-09-23;-135;-135;-135;null;null;KZT;79;79;-56;-56;1
0;KZ75125EUR2069101106;2016-09-24;-74;-74;-74;61;61;KZT;null;null;-135;-135;1
0;KZ75125EUR2069101106;2016-09-25;-96;-96;-96;null;null;KZT;22;22;-74;-74;1
0;KZ75125EUR2069101106;2016-09-26;-98;-98;-98;null;null;KZT;2;2;-96;-96;1
0;KZ75125EUR2069101106;2016-09-27;-59;-59;-59;39;39;KZT;null;null;-98;-98;1
0;KZ75125EUR2069101106;2016-09-28;-142;-142;-142;null;null;KZT;83;83;-59;-59;1
0;KZ75125EUR2069101106;2016-09-29;-162;-162;-162;null;null;KZT;20;20;-142;-142;1
0;KZ75125EUR2069101106;2016-09-30;-198;-198;-198;null;null;KZT;36;36;-162;-162;1
0;KZ75125EUR2069101106;2016-10-01;-238;-238;-238;null;null;KZT;40;40;-198;-198;1
0;KZ75125EUR2069101106;2016-10-02;-157;-157;-157;81;81;KZT;null;null;-238;-238;1
0;KZ75125EUR2069101106;2016-10-03;-242;-242;-242;null;null;KZT;85;85;-157;-157;1
0;KZ75125EUR2069101106;2016-10-04;-276;-276;-276;null;null;KZT;34;34;-242;-242;1
0;KZ75125EUR2069101106;2016-10-05;-210;-210;-210;66;66;KZT;null;null;-276;-276;1
0;KZ75125EUR2069101106;2016-10-06;-143;-143;-143;67;67;KZT;null;null;-210;-210;1
0;KZ75125EUR2069101106;2016-10-07;-92;-92;-92;51;51;KZT;null;null;-143;-143;1
0;KZ75125EUR2069101106;2016-10-08;-189;-189;-189;null;null;KZT;97;97;-92;-92;1
0;KZ75125EUR2069101106;2016-10-09;-128;-128;-128;61;61;KZT;null;null;-189;-189;1
0;KZ75125EUR2069101106;2016-10-10;-82;-82;-82;46;46;KZT;null;null;-128;-128;1
0;KZ75125EUR2069101106;2016-10-11;-14;-14;-14;68;68;KZT;null;null;-82;-82;1
0;KZ75125EUR2069101106;2016-10-12;-86;-86;-86;null;null;KZT;72;72;-14;-14;1
0;KZ75125EUR2069101106;2016-10-13;-118;-118;-118;null;null;KZT;32;32;-86;-86;1
0;KZ75125EUR2069101106;2016-10-14;-134;-134;-134;null;null;KZT;16;16;-118;-118;1
0;KZ75125EUR2069101106;2016-10-15;-167;-167;-167;null;null;KZT;33;33;-134;-134;1
0;KZ75125EUR2069101106;2016-10-16;-91;-91;-91;76;76;KZT;null;null;-167;-167;1
0;KZ75125EUR2069101106;2016-10-17;-28;-28;-28;63;63;KZT;null;null;-91;-91;1
0;KZ75125EUR2069101106;2016-10-18;-27;-27;-27;1;1;KZT;null;null;-28;-28;1
0;KZ75125EUR2069101106;2016-10-19;-99;-99;-99;null;null;KZT;72;72;-27;-27;1
0;KZ75125EUR2069101106;2016-10-20;-13;-13;-13;86;86;KZT;null;null;-99;-99;1
0;KZ75125EUR2069101106;2016-10-21;60;60;60;73;73;KZT;null;null;-13;-13;1
0;KZ75125EUR2069101106;2016-10-22;19;19;19;null;null;KZT;41;41;60;60;1
0;KZ75125EUR2069101106;2016-10-23;11;11;11;null;null;KZT;8;8;19;19;1
0;KZ75125EUR2069101106;2016-10-24;-55;-55;-55;null;null;KZT;66;66;11;11;1
0;KZ75125EUR2069101106;2016-10-25;-108;-108;-108;null;null;KZT;53;53;-55;-55;1
0;KZ75125EUR2069101106;2016-10-26;-47;-47;-47;61;61;KZT;null;null;-108;-108;1
0;KZ75125EUR2069101106;2016-10-27;-8;-8;-8;39;39;KZT;null;null;-47;-47;1
0;KZ75125EUR2069101106;2016-10-28;-74;-74;-74;null;null;KZT;66;66;-8;-8;1
0;KZ75125EUR2069101106;2016-10-29;-15;-15;-15;59;59;KZT;null;null;-74;-74;1
0;KZ75125EUR2069101106;2016-10-30;-28;-28;-28;null;null;KZT;13;13;-15;-15;1
0;KZ75125EUR2069101106;2016-10-31;-89;-89;-89;null;null;KZT;61;61;-28;-28;1
0;KZ75125EUR2069101106;2016-11-01;-120;-120;-120;null;null;KZT;31;31;-89;-89;1
0;KZ75125EUR2069101106;2016-11-02;-157;-157;-157;null;null;KZT;37;37;-120;-120;1
0;KZ75125EUR2069101106;2016-11-03;-163;-163;-163;null;null;KZT;6;6;-157;-157;1
0;KZ75125EUR2069101106;2016-11-04;-148;-148;-148;15;15;KZT;null;null;-163;-163;1
0;KZ75125EUR2069101106;2016-11-05;-80;-80;-80;68;68;KZT;null;null;-148;-148;1
0;KZ75125EUR2069101106;2016-11-06;-143;-143;-143;null;null;KZT;63;63;-80;-80;1
0;KZ75125EUR2069101106;2016-11-07;-238;-238;-238;null;null;KZT;95;95;-143;-143;1
0;KZ75125EUR2069101106;2016-11-08;-227;-227;-227;11;11;KZT;null;null;-238;-238;1
0;KZ75125EUR2069101106;2016-11-09;-193;-193;-193;34;34;KZT;null;null;-227;-227;1
0;KZ75125EUR2069101106;2016-11-10;-216;-216;-216;null;null;KZT;23;23;-193;-193;1
0;KZ75125EUR2069101106;2016-11-11;-202;-202;-202;14;14;KZT;null;null;-216;-216;1
0;KZ75125EUR2069101106;2016-11-12;-131;-131;-131;71;71;KZT;null;null;-202;-202;1
0;KZ75125EUR2069101106;2016-11-13;-61;-61;-61;70;70;KZT;null;null;-131;-131;1
0;KZ75125EUR2069101106;2016-11-14;-44;-44;-44;17;17;KZT;null;null;-61;-61;1
0;KZ75125EUR2069101106;2016-11-15;-96;-96;-96;null;null;KZT;52;52;-44;-44;1
0;KZ75125EUR2069101106;2016-11-16;-126;-126;-126;null;null;KZT;30;30;-96;-96;1
0;KZ75125EUR2069101106;2016-11-17;-163;-163;-163;null;null;KZT;37;37;-126;-126;1
0;KZ75125EUR2069101106;2016-11-18;-88;-88;-88;75;75;KZT;null;null;-163;-163;1
0;KZ75125EUR2069101106;2016-11-19;-57;-57;-57;31;31;KZT;null;null;-88;-88;1
0;KZ75125EUR2069101106;2016-11-20;-44;-44;-44;13;13;KZT;null;null;-57;-57;1
0;KZ75125EUR2069101106;2016-11-21;-40;-40;-40;4;4;KZT;null;null;-44;-44;1
0;KZ75125EUR2069101106;2016-11-22;-61;-61;-61;null;null;KZT;21;21;-40;-40;1
0;KZ75125EUR2069101106;2016-11-23;-10;-10;-10;51;51;KZT;null;null;-61;-61;1
0;KZ75125EUR2069101106;2016-11-24;8;8;8;18;18;KZT;null;null;-10;-10;1
0;KZ75125EUR2069101106;2016-11-25;29;29;29;21;21;KZT;null;null;8;8;1
0;KZ75125EUR2069101106;2016-11-26;-64;-64;-64;null;null;KZT;93;93;29;29;1
0;KZ75125EUR2069101106;2016-11-27;-55;-55;-55;9;9;KZT;null;null;-64;-64;1
0;KZ75125EUR2069101106;2016-11-28;-53;-53;-53;2;2;KZT;null;null;-55;-55;1
0;KZ75125EUR2069101106;2016-11-29;-31;-31;-31;22;22;KZT;null;null;-53;-53;1
0;KZ75125EUR2069101106;2016-11-30;20;20;20;51;51;KZT;null;null;-31;-31;1
0;KZ75125EUR2069101106;2016-12-01;-61;-61;-61;null;null;KZT;81;81;20;20;1
0;KZ75125EUR2069101106;2016-12-02;36;36;36;97;97;KZT;null;null;-61;-61;1
0;KZ75125EUR2069101106;2016-12-03;20;20;20;null;null;KZT;16;16;36;36;1
0;KZ75125EUR2069101106;2016-12-04;89;89;89;69;69;KZT;null;null;20;20;1
0;KZ75125EUR2069101106;2016-12-05;99;99;99;10;10;KZT;null;null;89;89;1
0;KZ75125EUR2069101106;2016-12-06;185;185;185;86;86;KZT;null;null;99;99;1
0;KZ75125EUR2069101106;2016-12-07;135;135;135;null;null;KZT;50;50;185;185;1
0;KZ75125EUR2069101106;2016-12-08;113;113;113;null;null;KZT;22;22;135;135;1
0;KZ75125EUR2069101106;2016-12-09;32;32;32;null;null;KZT;81;81;113;113;1
0;KZ75125EUR2069101106;2016-12-10;101;101;101;69;69;KZT;null;null;32;32;1
0;KZ75125EUR2069101106;2016-12-11;120;120;120;19;19;KZT;null;null;101;101;1
0;KZ75125EUR2069101106;2016-12-12;86;86;86;null;null;KZT;34;34;120;120;1
0;KZ75125EUR2069101106;2016-12-13;158;158;158;72;72;KZT;null;null;86;86;1
0;KZ75125EUR2069101106;2016-12-14;110;110;110;null;null;KZT;48;48;158;158;1
0;KZ75125EUR2069101106;2016-12-15;116;116;116;6;6;KZT;null;null;110;110;1
0;KZ75125EUR2069101106;2016-12-16;158;158;158;42;42;KZT;null;null;116;116;1
0;KZ75125EUR2069101106;2016-12-17;75;75;75;null;null;KZT;83;83;158;158;1
0;KZ75125EUR2069101106;2016-12-18;75;75;75;null;null;KZT;0;0;75;75;1
0;KZ75125EUR2069101106;2016-12-19;174;174;174;99;99;KZT;null;null;75;75;1
0;KZ75125EUR2069101106;2016-12-20;79;79;79;null;null;KZT;95;95;174;174;1
0;KZ75125EUR2069101106;2016-12-21;63;63;63;null;null;KZT;16;16;79;79;1
0;KZ75125EUR2069101106;2016-12-22;34;34;34;null;null;KZT;29;29;63;63;1
0;KZ75125EUR2069101106;2016-12-23;101;101;101;67;67;KZT;null;null;34;34;1
0;KZ75125EUR2069101106;2016-12-24;36;36;36;null;null;KZT;65;65;101;101;1
0;KZ75125EUR2069101106;2016-12-25;41;41;41;5;5;KZT;null;null;36;36;1
0;KZ75125EUR2069101106;2016-12-26;-42;-42;-42;null;null;KZT;83;83;41;41;1
0;KZ75125EUR2069101106;2016-12-27;-27;-27;-27;15;15;KZT;null;null;-42;-42;1
0;KZ75125EUR2069101106;2016-12-28;-60;-60;-60;null;null;KZT;33;33;-27;-27;1
0;KZ75125EUR2069101106;2016-12-29;-40;-40;-40;20;20;KZT;null;null;-60;-60;1
0;KZ75125EUR2069101106;2016-12-30;-136;-136;-136;null;null;KZT;96;96;-40;-40;1
0;KZ75125EUR2069101106;2016-12-31;-41;-41;-41;95;95;KZT;null;null;-136;-136;1
0;KZ75125EUR2069101106;2017-01-01;-3;-3;-3;38;38;KZT;null;null;-41;-41;1
0;KZ75125EUR2069101106;2017-01-02;-63;-63;-63;null;null;KZT;60;60;-3;-3;1
0;KZ75125EUR2069101106;2017-01-03;-120;-120;-120;null;null;KZT;57;57;-63;-63;1
0;KZ75125EUR2069101106;2017-01-04;-117;-117;-117;3;3;KZT;null;null;-120;-120;1
0;KZ75125EUR2069101106;2017-01-05;-177;-177;-177;null;null;KZT;60;60;-117;-117;1
0;KZ75125EUR2069101106;2017-01-06;-182;-182;-182;null;null;KZT;5;5;-177;-177;1
0;KZ75125EUR2069101106;2017-01-07;-155;-155;-155;27;27;KZT;null;null;-182;-182;1
0;KZ75125EUR2069101106;2017-01-08;-102;-102;-102;53;53;KZT;null;null;-155;-155;1
0;KZ75125EUR2069101106;2017-01-09;-89;-89;-89;13;13;KZT;null;null;-102;-102;1
0;KZ75125EUR2069101106;2017-01-10;-151;-151;-151;null;null;KZT;62;62;-89;-89;1
0;KZ75125EUR2069101106;2017-01-11;-59;-59;-59;92;92;KZT;null;null;-151;-151;1
0;KZ75125EUR2069101106;2017-01-12;-68;-68;-68;null;null;KZT;9;9;-59;-59;1
0;KZ75125EUR2069101106;2017-01-13;-151;-151;-151;null;null;KZT;83;83;-68;-68;1
0;KZ75125EUR2069101106;2017-01-14;-159;-159;-159;null;null;KZT;8;8;-151;-151;1
0;KZ75125EUR2069101106;2017-01-15;-204;-204;-204;null;null;KZT;45;45;-159;-159;1
0;KZ75125EUR2069101106;2017-01-16;-150;-150;-150;54;54;KZT;null;null;-204;-204;1
0;KZ75125EUR2069101106;2017-01-17;-186;-186;-186;null;null;KZT;36;36;-150;-150;1
0;KZ75125EUR2069101106;2017-01-18;-222;-222;-222;null;null;KZT;36;36;-186;-186;1
0;KZ75125EUR2069101106;2017-01-19;-300;-300;-300;null;null;KZT;78;78;-222;-222;1
0;KZ75125EUR2069101106;2017-01-20;-369;-369;-369;null;null;KZT;69;69;-300;-300;1
0;KZ75125EUR2069101106;2017-01-21;-393;-393;-393;null;null;KZT;24;24;-369;-369;1
0;KZ75125EUR2069101106;2017-01-22;-365;-365;-365;28;28;KZT;null;null;-393;-393;1
0;KZ75125EUR2069101106;2017-01-23;-357;-357;-357;8;8;KZT;null;null;-365;-365;1
0;KZ75125EUR2069101106;2017-01-24;-440;-440;-440;null;null;KZT;83;83;-357;-357;1
0;KZ75125EUR2069101106;2017-01-25;-489;-489;-489;null;null;KZT;49;49;-440;-440;1
0;KZ75125EUR2069101106;2017-01-26;-448;-448;-448;41;41;KZT;null;null;-489;-489;1
0;KZ75125EUR2069101106;2017-01-27;-421;-421;-421;27;27;KZT;null;null;-448;-448;1
0;KZ75125EUR2069101106;2017-01-28;-465;-465;-465;null;null;KZT;44;44;-421;-421;1
0;KZ75125EUR2069101106;2017-01-29;-439;-439;-439;26;26;KZT;null;null;-465;-465;1
0;KZ75125EUR2069101106;2017-01-30;-508;-508;-508;null;null;KZT;69;69;-439;-439;1
0;KZ75125EUR2069101106;2017-01-31;-587;-587;-587;null;null;KZT;79;79;-508;-508;1
0;KZ75125EUR2069101106;2017-02-01;-583;-583;-583;4;4;KZT;null;null;-587;-587;1
0;KZ75125EUR2069101106;2017-02-02;-528;-528;-528;55;55;KZT;null;null;-583;-583;1
0;KZ75125EUR2069101106;2017-02-03;-511;-511;-511;17;17;KZT;null;null;-528;-528;1
0;KZ75125EUR2069101106;2017-02-04;-428;-428;-428;83;83;KZT;null;null;-511;-511;1
0;KZ75125EUR2069101106;2017-02-05;-505;-505;-505;null;null;KZT;77;77;-428;-428;1
0;KZ75125EUR2069101106;2017-02-06;-555;-555;-555;null;null;KZT;50;50;-505;-505;1
0;KZ75125EUR2069101106;2017-02-07;-603;-603;-603;null;null;KZT;48;48;-555;-555;1
0;KZ75125EUR2069101106;2017-02-08;-578;-578;-578;25;25;KZT;null;null;-603;-603;1
0;KZ75125EUR2069101106;2017-02-09;-546;-546;-546;32;32;KZT;null;null;-578;-578;1
0;KZ75125EUR2069101106;2017-02-10;-506;-506;-506;40;40;KZT;null;null;-546;-546;1
0;KZ75125EUR2069101106;2017-02-11;-468;-468;-468;38;38;KZT;null;null;-506;-506;1
0;KZ75125EUR2069101106;2017-02-12;-561;-561;-561;null;null;KZT;93;93;-468;-468;1
0;KZ75125EUR2069101106;2017-02-13;-594;-594;-594;null;null;KZT;33;33;-561;-561;1
0;KZ75125EUR2069101106;2017-02-14;-582;-582;-582;12;12;KZT;null;null;-594;-594;1
0;KZ75125EUR2069101106;2017-02-15;-660;-660;-660;null;null;KZT;78;78;-582;-582;1
0;KZ75125EUR2069101106;2017-02-16;-661;-661;-661;null;null;KZT;1;1;-660;-660;1
0;KZ75125EUR2069101106;2017-02-17;-675;-675;-675;null;null;KZT;14;14;-661;-661;1
0;KZ75125EUR2069101106;2017-02-18;-752;-752;-752;null;null;KZT;77;77;-675;-675;1
0;KZ75125EUR2069101106;2017-02-19;-720;-720;-720;32;32;KZT;null;null;-752;-752;1
0;KZ75125EUR2069101106;2017-02-20;-781;-781;-781;null;null;KZT;61;61;-720;-720;1
0;KZ75125EUR2069101106;2017-02-21;-845;-845;-845;null;null;KZT;64;64;-781;-781;1
0;KZ75125EUR2069101106;2017-02-22;-865;-865;-865;null;null;KZT;20;20;-845;-845;1
0;KZ75125EUR2069101106;2017-02-23;-897;-897;-897;null;null;KZT;32;32;-865;-865;1
0;KZ75125EUR2069101106;2017-02-24;-864;-864;-864;33;33;KZT;null;null;-897;-897;1
0;KZ75125EUR2069101106;2017-02-25;-905;-905;-905;null;null;KZT;41;41;-864;-864;1
0;KZ75125EUR2069101106;2017-02-26;-910;-910;-910;null;null;KZT;5;5;-905;-905;1
0;KZ75125EUR2069101106;2017-02-27;-927;-927;-927;null;null;KZT;17;17;-910;-910;1
0;KZ75125EUR2069101106;2017-02-28;-974;-974;-974;null;null;KZT;47;47;-927;-927;1
0;KZ75125EUR2069101106;2017-03-01;-934;-934;-934;40;40;KZT;null;null;-974;-974;1
0;KZ75125EUR2069101106;2017-03-02;-927;-927;-927;7;7;KZT;null;null;-934;-934;1
0;KZ75125EUR2069101106;2017-03-03;-847;-847;-847;80;80;KZT;null;null;-927;-927;1
0;KZ75125EUR2069101106;2017-03-04;-854;-854;-854;null;null;KZT;7;7;-847;-847;1
0;KZ75125EUR2069101106;2017-03-05;-904;-904;-904;null;null;KZT;50;50;-854;-854;1
0;KZ75125EUR2069101106;2017-03-06;-978;-978;-978;null;null;KZT;74;74;-904;-904;1
0;KZ75125EUR2069101106;2017-03-07;-1001;-1001;-1001;null;null;KZT;23;23;-978;-978;1
0;KZ75125EUR2069101106;2017-03-08;-953;-953;-953;48;48;KZT;null;null;-1001;-1001;1
0;KZ75125EUR2069101106;2017-03-09;-876;-876;-876;77;77;KZT;null;null;-953;-953;1
0;KZ75125EUR2069101106;2017-03-10;-825;-825;-825;51;51;KZT;null;null;-876;-876;1
0;KZ75125EUR2069101106;2017-03-11;-756;-756;-756;69;69;KZT;null;null;-825;-825;1
0;KZ75125EUR2069101106;2017-03-12;-829;-829;-829;null;null;KZT;73;73;-756;-756;1
0;KZ75125EUR2069101106;2017-03-13;-906;-906;-906;null;null;KZT;77;77;-829;-829;1
0;KZ75125EUR2069101106;2017-03-14;-939;-939;-939;null;null;KZT;33;33;-906;-906;1
0;KZ75125EUR2069101106;2017-03-15;-1025;-1025;-1025;null;null;KZT;86;86;-939;-939;1
0;KZ75125EUR2069101106;2017-03-16;-970;-970;-970;55;55;KZT;null;null;-1025;-1025;1
0;KZ75125EUR2069101106;2017-03-17;-912;-912;-912;58;58;KZT;null;null;-970;-970;1
0;KZ75125EUR2069101106;2017-03-18;-957;-957;-957;null;null;KZT;45;45;-912;-912;1
0;KZ75125EUR2069101106;2017-03-19;-862;-862;-862;95;95;KZT;null;null;-957;-957;1
0;KZ75125EUR2069101106;2017-03-20;-858;-858;-858;4;4;KZT;null;null;-862;-862;1
0;KZ75125EUR2069101106;2017-03-21;-793;-793;-793;65;65;KZT;null;null;-858;-858;1
0;KZ75125EUR2069101106;2017-03-22;-809;-809;-809;null;null;KZT;16;16;-793;-793;1
0;KZ75125EUR2069101106;2017-03-23;-845;-845;-845;null;null;KZT;36;36;-809;-809;1
0;KZ75125EUR2069101106;2017-03-24;-933;-933;-933;null;null;KZT;88;88;-845;-845;1
0;KZ75125EUR2069101106;2017-03-25;-1027;-1027;-1027;null;null;KZT;94;94;-933;-933;1
0;KZ75125EUR2069101106;2017-03-26;-968;-968;-968;59;59;KZT;null;null;-1027;-1027;1
0;KZ75125EUR2069101106;2017-03-27;-969;-969;-969;null;null;KZT;1;1;-968;-968;1
0;KZ75125EUR2069101106;2017-03-28;-1027;-1027;-1027;null;null;KZT;58;58;-969;-969;1
0;KZ75125EUR2069101106;2017-03-29;-960;-960;-960;67;67;KZT;null;null;-1027;-1027;1
0;KZ75125EUR2069101106;2017-03-30;-900;-900;-900;60;60;KZT;null;null;-960;-960;1
0;KZ75125EUR2069101106;2017-03-31;-953;-953;-953;null;null;KZT;53;53;-900;-900;1
0;KZ75125EUR2069101106;2017-04-01;-923;-923;-923;30;30;KZT;null;null;-953;-953;1
0;KZ75125EUR2069101106;2017-04-02;-963;-963;-963;null;null;KZT;40;40;-923;-923;1
0;KZ75125EUR2069101106;2017-04-03;-953;-953;-953;10;10;KZT;null;null;-963;-963;1
0;KZ75125EUR2069101106;2017-04-04;-1022;-1022;-1022;null;null;KZT;69;69;-953;-953;1
0;KZ75125EUR2069101106;2017-04-05;-947;-947;-947;75;75;KZT;null;null;-1022;-1022;1
0;KZ75125EUR2069101106;2017-04-06;-911;-911;-911;36;36;KZT;null;null;-947;-947;1
0;KZ75125EUR2069101106;2017-04-07;-817;-817;-817;94;94;KZT;null;null;-911;-911;1
0;KZ75125EUR2069101106;2017-04-08;-773;-773;-773;44;44;KZT;null;null;-817;-817;1
0;KZ75125EUR2069101106;2017-04-09;-848;-848;-848;null;null;KZT;75;75;-773;-773;1
0;KZ75125EUR2069101106;2017-04-10;-804;-804;-804;44;44;KZT;null;null;-848;-848;1
0;KZ75125EUR2069101106;2017-04-11;-718;-718;-718;86;86;KZT;null;null;-804;-804;1
0;KZ75125EUR2069101106;2017-04-12;-711;-711;-711;7;7;KZT;null;null;-718;-718;1
0;KZ75125EUR2069101106;2017-04-13;-643;-643;-643;68;68;KZT;null;null;-711;-711;1
0;KZ75125EUR2069101106;2017-04-14;-670;-670;-670;null;null;KZT;27;27;-643;-643;1
0;KZ75125EUR2069101106;2017-04-15;-668;-668;-668;2;2;KZT;null;null;-670;-670;1
0;KZ75125EUR2069101106;2017-04-16;-577;-577;-577;91;91;KZT;null;null;-668;-668;1
0;KZ75125EUR2069101106;2017-04-17;-569;-569;-569;8;8;KZT;null;null;-577;-577;1
0;KZ75125EUR2069101106;2017-04-18;-637;-637;-637;null;null;KZT;68;68;-569;-569;1
0;KZ75125EUR2069101106;2017-04-19;-600;-600;-600;37;37;KZT;null;null;-637;-637;1
0;KZ75125EUR2069101106;2017-04-20;-625;-625;-625;null;null;KZT;25;25;-600;-600;1
0;KZ75125EUR2069101106;2017-04-21;-532;-532;-532;93;93;KZT;null;null;-625;-625;1
0;KZ75125EUR2069101106;2017-04-22;-589;-589;-589;null;null;KZT;57;57;-532;-532;1
0;KZ75125EUR2069101106;2017-04-23;-500;-500;-500;89;89;KZT;null;null;-589;-589;1
0;KZ75125EUR2069101106;2017-04-24;-524;-524;-524;null;null;KZT;24;24;-500;-500;1
0;KZ75125EUR2069101106;2017-04-25;-592;-592;-592;null;null;KZT;68;68;-524;-524;1
0;KZ75125EUR2069101106;2017-04-26;-528;-528;-528;64;64;KZT;null;null;-592;-592;1
0;KZ75125EUR2069101106;2017-04-27;-485;-485;-485;43;43;KZT;null;null;-528;-528;1
0;KZ75125EUR2069101106;2017-04-28;-560;-560;-560;null;null;KZT;75;75;-485;-485;1
0;KZ75125EUR2069101106;2017-04-29;-582;-582;-582;null;null;KZT;22;22;-560;-560;1
0;KZ75125EUR2069101106;2017-04-30;-644;-644;-644;null;null;KZT;62;62;-582;-582;1
0;KZ75125EUR2069101106;2017-05-01;-556;-556;-556;88;88;KZT;null;null;-644;-644;1
0;KZ75125EUR2069101106;2017-05-02;-465;-465;-465;91;91;KZT;null;null;-556;-556;1
0;KZ75125EUR2069101106;2017-05-03;-393;-393;-393;72;72;KZT;null;null;-465;-465;1
0;KZ75125EUR2069101106;2017-05-04;-313;-313;-313;80;80;KZT;null;null;-393;-393;1
0;KZ75125EUR2069101106;2017-05-05;-410;-410;-410;null;null;KZT;97;97;-313;-313;1
0;KZ75125EUR2069101106;2017-05-06;-465;-465;-465;null;null;KZT;55;55;-410;-410;1
0;KZ75125EUR2069101106;2017-05-07;-405;-405;-405;60;60;KZT;null;null;-465;-465;1
0;KZ75125EUR2069101106;2017-05-08;-314;-314;-314;91;91;KZT;null;null;-405;-405;1
0;KZ75125EUR2069101106;2017-05-09;-410;-410;-410;null;null;KZT;96;96;-314;-314;1
0;KZ75125EUR2069101106;2017-05-10;-346;-346;-346;64;64;KZT;null;null;-410;-410;1
0;KZ75125EUR2069101106;2017-05-11;-288;-288;-288;58;58;KZT;null;null;-346;-346;1
0;KZ75125EUR2069101106;2017-05-12;-203;-203;-203;85;85;KZT;null;null;-288;-288;1
0;KZ75125EUR2069101106;2017-05-13;-259;-259;-259;null;null;KZT;56;56;-203;-203;1
0;KZ75125EUR2069101106;2017-05-14;-231;-231;-231;28;28;KZT;null;null;-259;-259;1
0;KZ75125EUR2069101106;2017-05-15;-280;-280;-280;null;null;KZT;49;49;-231;-231;1
0;KZ75125EUR2069101106;2017-05-16;-354;-354;-354;null;null;KZT;74;74;-280;-280;1
0;KZ75125EUR2069101106;2017-05-17;-449;-449;-449;null;null;KZT;95;95;-354;-354;1
0;KZ75125EUR2069101106;2017-05-18;-445;-445;-445;4;4;KZT;null;null;-449;-449;1
0;KZ75125EUR2069101106;2017-05-19;-430;-430;-430;15;15;KZT;null;null;-445;-445;1
0;KZ75125EUR2069101106;2017-05-20;-518;-518;-518;null;null;KZT;88;88;-430;-430;1
0;KZ75125EUR2069101106;2017-05-21;-451;-451;-451;67;67;KZT;null;null;-518;-518;1
0;KZ75125EUR2069101106;2017-05-22;-401;-401;-401;50;50;KZT;null;null;-451;-451;1
0;KZ75125EUR2069101106;2017-05-23;-382;-382;-382;19;19;KZT;null;null;-401;-401;1
0;KZ75125EUR2069101106;2017-05-24;-392;-392;-392;null;null;KZT;10;10;-382;-382;1
0;KZ75125EUR2069101106;2017-05-25;-326;-326;-326;66;66;KZT;null;null;-392;-392;1
0;KZ75125EUR2069101106;2017-05-26;-328;-328;-328;null;null;KZT;2;2;-326;-326;1
0;KZ75125EUR2069101106;2017-05-27;-394;-394;-394;null;null;KZT;66;66;-328;-328;1
0;KZ75125EUR2069101106;2017-05-28;-358;-358;-358;36;36;KZT;null;null;-394;-394;1
0;KZ75125EUR2069101106;2017-05-29;-424;-424;-424;null;null;KZT;66;66;-358;-358;1
0;KZ75125EUR2069101106;2017-05-30;-407;-407;-407;17;17;KZT;null;null;-424;-424;1
0;KZ75125EUR2069101106;2017-05-31;-477;-477;-477;null;null;KZT;70;70;-407;-407;1
0;KZ75125EUR2069101106;2017-06-01;-391;-391;-391;86;86;KZT;null;null;-477;-477;1
0;KZ75125EUR2069101106;2017-06-02;-468;-468;-468;null;null;KZT;77;77;-391;-391;1
0;KZ75125EUR2069101106;2017-06-03;-466;-466;-466;2;2;KZT;null;null;-468;-468;1
0;KZ75125EUR2069101106;2017-06-04;-520;-520;-520;null;null;KZT;54;54;-466;-466;1
0;KZ75125EUR2069101106;2017-06-05;-442;-442;-442;78;78;KZT;null;null;-520;-520;1
0;KZ75125EUR2069101106;2017-06-06;-466;-466;-466;null;null;KZT;24;24;-442;-442;1
0;KZ75125EUR2069101106;2017-06-07;-560;-560;-560;null;null;KZT;94;94;-466;-466;1
0;KZ75125EUR2069101106;2017-06-08;-622;-622;-622;null;null;KZT;62;62;-560;-560;1
0;KZ75125EUR2069101106;2017-06-09;-691;-691;-691;null;null;KZT;69;69;-622;-622;1
0;KZ75125EUR2069101106;2017-06-10;-767;-767;-767;null;null;KZT;76;76;-691;-691;1
0;KZ75125EUR2069101106;2017-06-11;-819;-819;-819;null;null;KZT;52;52;-767;-767;1
0;KZ75125EUR2069101106;2017-06-12;-824;-824;-824;null;null;KZT;5;5;-819;-819;1
0;KZ75125KZT2069101999;2015-05-11;143;143;71.5;43;21.5;EUR;null;null;100;50;0.5
0;KZ75125KZT2069101999;2015-05-12;113;113;56.5;null;null;EUR;30;15;143;71.5;0.5
0;KZ75125KZT2069101999;2015-05-13;105;105;52.5;null;null;EUR;8;4;113;56.5;0.5
0;KZ75125KZT2069101999;2015-05-14;69;69;34.5;null;null;EUR;36;18;105;52.5;0.5
0;KZ75125KZT2069101999;2015-05-15;7;7;3.5;null;null;EUR;62;31;69;34.5;0.5
0;KZ75125KZT2069101999;2015-05-16;71;71;35.5;64;32;EUR;null;null;7;3.5;0.5
0;KZ75125KZT2069101999;2015-05-17;-23;-23;-11.5;null;null;EUR;94;47;71;35.5;0.5
0;KZ75125KZT2069101999;2015-05-18;-8;-8;-4;15;7.5;EUR;null;null;-23;-11.5;0.5
0;KZ75125KZT2069101999;2015-05-19;-63;-63;-31.5;null;null;EUR;55;27.5;-8;-4;0.5
0;KZ75125KZT2069101999;2015-05-20;-121;-121;-60.5;null;null;EUR;58;29;-63;-31.5;0.5
0;KZ75125KZT2069101999;2015-05-21;-28;-28;-14;93;46.5;EUR;null;null;-121;-60.5;0.5
0;KZ75125KZT2069101999;2015-05-22;31;31;15.5;59;29.5;EUR;null;null;-28;-14;0.5
0;KZ75125KZT2069101999;2015-05-23;125;125;62.5;94;47;EUR;null;null;31;15.5;0.5
0;KZ75125KZT2069101999;2015-05-24;199;199;99.5;74;37;EUR;null;null;125;62.5;0.5
0;KZ75125KZT2069101999;2015-05-25;249;249;124.5;50;25;EUR;null;null;199;99.5;0.5
0;KZ75125KZT2069101999;2015-05-26;223;223;111.5;null;null;EUR;26;13;249;124.5;0.5
0;KZ75125KZT2069101999;2015-05-27;293;293;146.5;70;35;EUR;null;null;223;111.5;0.5
0;KZ75125KZT2069101999;2015-05-28;330;330;165;37;18.5;EUR;null;null;293;146.5;0.5
0;KZ75125KZT2069101999;2015-05-29;261;261;130.5;null;null;EUR;69;34.5;330;165;0.5
0;KZ75125KZT2069101999;2015-05-30;244;244;122;null;null;EUR;17;8.5;261;130.5;0.5
0;KZ75125KZT2069101999;2015-05-31;153;153;76.5;null;null;EUR;91;45.5;244;122;0.5
0;KZ75125KZT2069101999;2015-06-01;92;92;46;null;null;EUR;61;30.5;153;76.5;0.5
0;KZ75125KZT2069101999;2015-06-02;35;35;17.5;null;null;EUR;57;28.5;92;46;0.5
0;KZ75125KZT2069101999;2015-06-03;35;35;17.5;null;null;EUR;0;0;35;17.5;0.5
0;KZ75125KZT2069101999;2015-06-04;56;56;28;21;10.5;EUR;null;null;35;17.5;0.5
0;KZ75125KZT2069101999;2015-06-05;91;91;45.5;35;17.5;EUR;null;null;56;28;0.5
0;KZ75125KZT2069101999;2015-06-06;185;185;92.5;94;47;EUR;null;null;91;45.5;0.5
0;KZ75125KZT2069101999;2015-06-07;191;191;95.5;6;3;EUR;null;null;185;92.5;0.5
0;KZ75125KZT2069101999;2015-06-08;263;263;131.5;72;36;EUR;null;null;191;95.5;0.5
0;KZ75125KZT2069101999;2015-06-09;197;197;98.5;null;null;EUR;66;33;263;131.5;0.5
0;KZ75125KZT2069101999;2015-06-10;176;176;88;null;null;EUR;21;10.5;197;98.5;0.5
0;KZ75125KZT2069101999;2015-06-11;252;252;126;76;38;EUR;null;null;176;88;0.5
0;KZ75125KZT2069101999;2015-06-12;343;343;171.5;91;45.5;EUR;null;null;252;126;0.5
0;KZ75125KZT2069101999;2015-06-13;372;372;186;29;14.5;EUR;null;null;343;171.5;0.5
0;KZ75125KZT2069101999;2015-06-14;356;356;178;null;null;EUR;16;8;372;186;0.5
0;KZ75125KZT2069101999;2015-06-15;319;319;159.5;null;null;EUR;37;18.5;356;178;0.5
0;KZ75125KZT2069101999;2015-06-16;282;282;141;null;null;EUR;37;18.5;319;159.5;0.5
0;KZ75125KZT2069101999;2015-06-17;335;335;167.5;53;26.5;EUR;null;null;282;141;0.5
0;KZ75125KZT2069101999;2015-06-18;375;375;187.5;40;20;EUR;null;null;335;167.5;0.5
0;KZ75125KZT2069101999;2015-06-19;369;369;184.5;null;null;EUR;6;3;375;187.5;0.5
0;KZ75125KZT2069101999;2015-06-20;375;375;187.5;6;3;EUR;null;null;369;184.5;0.5
0;KZ75125KZT2069101999;2015-06-21;441;441;220.5;66;33;EUR;null;null;375;187.5;0.5
0;KZ75125KZT2069101999;2015-06-22;495;495;247.5;54;27;EUR;null;null;441;220.5;0.5
0;KZ75125KZT2069101999;2015-06-23;447;447;223.5;null;null;EUR;48;24;495;247.5;0.5
0;KZ75125KZT2069101999;2015-06-24;544;544;272;97;48.5;EUR;null;null;447;223.5;0.5
0;KZ75125KZT2069101999;2015-06-25;460;460;230;null;null;EUR;84;42;544;272;0.5
0;KZ75125KZT2069101999;2015-06-26;533;533;266.5;73;36.5;EUR;null;null;460;230;0.5
0;KZ75125KZT2069101999;2015-06-27;475;475;237.5;null;null;EUR;58;29;533;266.5;0.5
0;KZ75125KZT2069101999;2015-06-28;387;387;193.5;null;null;EUR;88;44;475;237.5;0.5
0;KZ75125KZT2069101999;2015-06-29;345;345;172.5;null;null;EUR;42;21;387;193.5;0.5
0;KZ75125KZT2069101999;2015-06-30;401;401;200.5;56;28;EUR;null;null;345;172.5;0.5
0;KZ75125KZT2069101999;2015-07-01;420;420;210;19;9.5;EUR;null;null;401;200.5;0.5
0;KZ75125KZT2069101999;2015-07-02;393;393;196.5;null;null;EUR;27;13.5;420;210;0.5
0;KZ75125KZT2069101999;2015-07-03;295;295;147.5;null;null;EUR;98;49;393;196.5;0.5
0;KZ75125KZT2069101999;2015-07-04;238;238;119;null;null;EUR;57;28.5;295;147.5;0.5
0;KZ75125KZT2069101999;2015-07-05;195;195;97.5;null;null;EUR;43;21.5;238;119;0.5
0;KZ75125KZT2069101999;2015-07-06;103;103;51.5;null;null;EUR;92;46;195;97.5;0.5
0;KZ75125KZT2069101999;2015-07-07;61;61;30.5;null;null;EUR;42;21;103;51.5;0.5
0;KZ75125KZT2069101999;2015-07-08;-22;-22;-11;null;null;EUR;83;41.5;61;30.5;0.5
0;KZ75125KZT2069101999;2015-07-09;-80;-80;-40;null;null;EUR;58;29;-22;-11;0.5
0;KZ75125KZT2069101999;2015-07-10;-177;-177;-88.5;null;null;EUR;97;48.5;-80;-40;0.5
0;KZ75125KZT2069101999;2015-07-11;-231;-231;-115.5;null;null;EUR;54;27;-177;-88.5;0.5
0;KZ75125KZT2069101999;2015-07-12;-257;-257;-128.5;null;null;EUR;26;13;-231;-115.5;0.5
0;KZ75125KZT2069101999;2015-07-13;-172;-172;-86;85;42.5;EUR;null;null;-257;-128.5;0.5
0;KZ75125KZT2069101999;2015-07-14;-246;-246;-123;null;null;EUR;74;37;-172;-86;0.5
0;KZ75125KZT2069101999;2015-07-15;-226;-226;-113;20;10;EUR;null;null;-246;-123;0.5
0;KZ75125KZT2069101999;2015-07-16;-218;-218;-109;8;4;EUR;null;null;-226;-113;0.5
0;KZ75125KZT2069101999;2015-07-17;-122;-122;-61;96;48;EUR;null;null;-218;-109;0.5
0;KZ75125KZT2069101999;2015-07-18;-145;-145;-72.5;null;null;EUR;23;11.5;-122;-61;0.5
0;KZ75125KZT2069101999;2015-07-19;-132;-132;-66;13;6.5;EUR;null;null;-145;-72.5;0.5
0;KZ75125KZT2069101999;2015-07-20;-74;-74;-37;58;29;EUR;null;null;-132;-66;0.5
0;KZ75125KZT2069101999;2015-07-21;-86;-86;-43;null;null;EUR;12;6;-74;-37;0.5
0;KZ75125KZT2069101999;2015-07-22;-126;-126;-63;null;null;EUR;40;20;-86;-43;0.5
0;KZ75125KZT2069101999;2015-07-23;-97;-97;-48.5;29;14.5;EUR;null;null;-126;-63;0.5
0;KZ75125KZT2069101999;2015-07-24;-90;-90;-45;7;3.5;EUR;null;null;-97;-48.5;0.5
0;KZ75125KZT2069101999;2015-07-25;-5;-5;-2.5;85;42.5;EUR;null;null;-90;-45;0.5
0;KZ75125KZT2069101999;2015-07-26;77;77;38.5;82;41;EUR;null;null;-5;-2.5;0.5
0;KZ75125KZT2069101999;2015-07-27;62;62;31;null;null;EUR;15;7.5;77;38.5;0.5
0;KZ75125KZT2069101999;2015-07-28;71;71;35.5;9;4.5;EUR;null;null;62;31;0.5
0;KZ75125KZT2069101999;2015-07-29;7;7;3.5;null;null;EUR;64;32;71;35.5;0.5
0;KZ75125KZT2069101999;2015-07-30;-73;-73;-36.5;null;null;EUR;80;40;7;3.5;0.5
0;KZ75125KZT2069101999;2015-07-31;-53;-53;-26.5;20;10;EUR;null;null;-73;-36.5;0.5
0;KZ75125KZT2069101999;2015-08-01;-106;-106;-53;null;null;EUR;53;26.5;-53;-26.5;0.5
0;KZ75125KZT2069101999;2015-08-02;-132;-132;-66;null;null;EUR;26;13;-106;-53;0.5
0;KZ75125KZT2069101999;2015-08-03;-149;-149;-74.5;null;null;EUR;17;8.5;-132;-66;0.5
0;KZ75125KZT2069101999;2015-08-04;-62;-62;-31;87;43.5;EUR;null;null;-149;-74.5;0.5
0;KZ75125KZT2069101999;2015-08-05;-120;-120;-60;null;null;EUR;58;29;-62;-31;0.5
0;KZ75125KZT2069101999;2015-08-06;-84;-84;-42;36;18;EUR;null;null;-120;-60;0.5
0;KZ75125KZT2069101999;2015-08-07;-44;-44;-22;40;20;EUR;null;null;-84;-42;0.5
0;KZ75125KZT2069101999;2015-08-08;31;31;15.5;75;37.5;EUR;null;null;-44;-22;0.5
0;KZ75125KZT2069101999;2015-08-09;2;2;1;null;null;EUR;29;14.5;31;15.5;0.5
0;KZ75125KZT2069101999;2015-08-10;-93;-93;-46.5;null;null;EUR;95;47.5;2;1;0.5
0;KZ75125KZT2069101999;2015-08-11;-5;-5;-2.5;88;44;EUR;null;null;-93;-46.5;0.5
0;KZ75125KZT2069101999;2015-08-12;82;82;41;87;43.5;EUR;null;null;-5;-2.5;0.5
0;KZ75125KZT2069101999;2015-08-13;166;166;83;84;42;EUR;null;null;82;41;0.5
0;KZ75125KZT2069101999;2015-08-14;108;108;54;null;null;EUR;58;29;166;83;0.5
0;KZ75125KZT2069101999;2015-08-15;121;121;60.5;13;6.5;EUR;null;null;108;54;0.5
0;KZ75125KZT2069101999;2015-08-16;145;145;72.5;24;12;EUR;null;null;121;60.5;0.5
0;KZ75125KZT2069101999;2015-08-17;72;72;36;null;null;EUR;73;36.5;145;72.5;0.5
0;KZ75125KZT2069101999;2015-08-18;152;152;76;80;40;EUR;null;null;72;36;0.5
0;KZ75125KZT2069101999;2015-08-19;208;208;104;56;28;EUR;null;null;152;76;0.5
0;KZ75125KZT2069101999;2015-08-20;302;302;151;94;47;EUR;null;null;208;104;0.5
0;KZ75125KZT2069101999;2015-08-21;390;390;195;88;44;EUR;null;null;302;151;0.5
0;KZ75125KZT2069101999;2015-08-22;339;339;169.5;null;null;EUR;51;25.5;390;195;0.5
0;KZ75125KZT2069101999;2015-08-23;402;402;201;63;31.5;EUR;null;null;339;169.5;0.5
0;KZ75125KZT2069101999;2015-08-24;331;331;165.5;null;null;EUR;71;35.5;402;201;0.5
0;KZ75125KZT2069101999;2015-08-25;290;290;145;null;null;EUR;41;20.5;331;165.5;0.5
0;KZ75125KZT2069101999;2015-08-26;229;229;114.5;null;null;EUR;61;30.5;290;145;0.5
0;KZ75125KZT2069101999;2015-08-27;149;149;74.5;null;null;EUR;80;40;229;114.5;0.5
0;KZ75125KZT2069101999;2015-08-28;224;224;112;75;37.5;EUR;null;null;149;74.5;0.5
0;KZ75125KZT2069101999;2015-08-29;156;156;78;null;null;EUR;68;34;224;112;0.5
0;KZ75125KZT2069101999;2015-08-30;236;236;118;80;40;EUR;null;null;156;78;0.5
0;KZ75125KZT2069101999;2015-08-31;280;280;140;44;22;EUR;null;null;236;118;0.5
0;KZ75125KZT2069101999;2015-09-01;251;251;125.5;null;null;EUR;29;14.5;280;140;0.5
0;KZ75125KZT2069101999;2015-09-02;215;215;107.5;null;null;EUR;36;18;251;125.5;0.5
0;KZ75125KZT2069101999;2015-09-03;240;240;120;25;12.5;EUR;null;null;215;107.5;0.5
0;KZ75125KZT2069101999;2015-09-04;210;210;105;null;null;EUR;30;15;240;120;0.5
0;KZ75125KZT2069101999;2015-09-05;257;257;128.5;47;23.5;EUR;null;null;210;105;0.5
0;KZ75125KZT2069101999;2015-09-06;241;241;120.5;null;null;EUR;16;8;257;128.5;0.5
0;KZ75125KZT2069101999;2015-09-07;186;186;93;null;null;EUR;55;27.5;241;120.5;0.5
0;KZ75125KZT2069101999;2015-09-08;260;260;130;74;37;EUR;null;null;186;93;0.5
0;KZ75125KZT2069101999;2015-09-09;298;298;149;38;19;EUR;null;null;260;130;0.5
0;KZ75125KZT2069101999;2015-09-10;276;276;138;null;null;EUR;22;11;298;149;0.5
0;KZ75125KZT2069101999;2015-09-11;187;187;93.5;null;null;EUR;89;44.5;276;138;0.5
0;KZ75125KZT2069101999;2015-09-12;234;234;117;47;23.5;EUR;null;null;187;93.5;0.5
0;KZ75125KZT2069101999;2015-09-13;169;169;84.5;null;null;EUR;65;32.5;234;117;0.5
0;KZ75125KZT2069101999;2015-09-14;221;221;110.5;52;26;EUR;null;null;169;84.5;0.5
0;KZ75125KZT2069101999;2015-09-15;262;262;131;41;20.5;EUR;null;null;221;110.5;0.5
0;KZ75125KZT2069101999;2015-09-16;352;352;176;90;45;EUR;null;null;262;131;0.5
0;KZ75125KZT2069101999;2015-09-17;280;280;140;null;null;EUR;72;36;352;176;0.5
0;KZ75125KZT2069101999;2015-09-18;316;316;158;36;18;EUR;null;null;280;140;0.5
0;KZ75125KZT2069101999;2015-09-19;242;242;121;null;null;EUR;74;37;316;158;0.5
0;KZ75125KZT2069101999;2015-09-20;151;151;75.5;null;null;EUR;91;45.5;242;121;0.5
0;KZ75125KZT2069101999;2015-09-21;105;105;52.5;null;null;EUR;46;23;151;75.5;0.5
0;KZ75125KZT2069101999;2015-09-22;157;157;78.5;52;26;EUR;null;null;105;52.5;0.5
0;KZ75125KZT2069101999;2015-09-23;198;198;99;41;20.5;EUR;null;null;157;78.5;0.5
0;KZ75125KZT2069101999;2015-09-24;131;131;65.5;null;null;EUR;67;33.5;198;99;0.5
0;KZ75125KZT2069101999;2015-09-25;69;69;34.5;null;null;EUR;62;31;131;65.5;0.5
0;KZ75125KZT2069101999;2015-09-26;156;156;78;87;43.5;EUR;null;null;69;34.5;0.5
0;KZ75125KZT2069101999;2015-09-27;120;120;60;null;null;EUR;36;18;156;78;0.5
0;KZ75125KZT2069101999;2015-09-28;168;168;84;48;24;EUR;null;null;120;60;0.5
0;KZ75125KZT2069101999;2015-09-29;203;203;101.5;35;17.5;EUR;null;null;168;84;0.5
0;KZ75125KZT2069101999;2015-09-30;230;230;115;27;13.5;EUR;null;null;203;101.5;0.5
0;KZ75125KZT2069101999;2015-10-01;227;227;113.5;null;null;EUR;3;1.5;230;115;0.5
0;KZ75125KZT2069101999;2015-10-02;269;269;134.5;42;21;EUR;null;null;227;113.5;0.5
0;KZ75125KZT2069101999;2015-10-03;367;367;183.5;98;49;EUR;null;null;269;134.5;0.5
0;KZ75125KZT2069101999;2015-10-04;368;368;184;1;0.5;EUR;null;null;367;183.5;0.5
0;KZ75125KZT2069101999;2015-10-05;424;424;212;56;28;EUR;null;null;368;184;0.5
0;KZ75125KZT2069101999;2015-10-06;381;381;190.5;null;null;EUR;43;21.5;424;212;0.5
0;KZ75125KZT2069101999;2015-10-07;407;407;203.5;26;13;EUR;null;null;381;190.5;0.5
0;KZ75125KZT2069101999;2015-10-08;468;468;234;61;30.5;EUR;null;null;407;203.5;0.5
0;KZ75125KZT2069101999;2015-10-09;567;567;283.5;99;49.5;EUR;null;null;468;234;0.5
0;KZ75125KZT2069101999;2015-10-10;655;655;327.5;88;44;EUR;null;null;567;283.5;0.5
0;KZ75125KZT2069101999;2015-10-11;560;560;280;null;null;EUR;95;47.5;655;327.5;0.5
0;KZ75125KZT2069101999;2015-10-12;514;514;257;null;null;EUR;46;23;560;280;0.5
0;KZ75125KZT2069101999;2015-10-13;552;552;276;38;19;EUR;null;null;514;257;0.5
0;KZ75125KZT2069101999;2015-10-14;609;609;304.5;57;28.5;EUR;null;null;552;276;0.5
0;KZ75125KZT2069101999;2015-10-15;689;689;344.5;80;40;EUR;null;null;609;304.5;0.5
0;KZ75125KZT2069101999;2015-10-16;606;606;303;null;null;EUR;83;41.5;689;344.5;0.5
0;KZ75125KZT2069101999;2015-10-17;664;664;332;58;29;EUR;null;null;606;303;0.5
0;KZ75125KZT2069101999;2015-10-18;569;569;284.5;null;null;EUR;95;47.5;664;332;0.5
0;KZ75125KZT2069101999;2015-10-19;642;642;321;73;36.5;EUR;null;null;569;284.5;0.5
0;KZ75125KZT2069101999;2015-10-20;557;557;278.5;null;null;EUR;85;42.5;642;321;0.5
0;KZ75125KZT2069101999;2015-10-21;467;467;233.5;null;null;EUR;90;45;557;278.5;0.5
0;KZ75125KZT2069101999;2015-10-22;509;509;254.5;42;21;EUR;null;null;467;233.5;0.5
0;KZ75125KZT2069101999;2015-10-23;597;597;298.5;88;44;EUR;null;null;509;254.5;0.5
0;KZ75125KZT2069101999;2015-10-24;632;632;316;35;17.5;EUR;null;null;597;298.5;0.5
0;KZ75125KZT2069101999;2015-10-25;641;641;320.5;9;4.5;EUR;null;null;632;316;0.5
0;KZ75125KZT2069101999;2015-10-26;588;588;294;null;null;EUR;53;26.5;641;320.5;0.5
0;KZ75125KZT2069101999;2015-10-27;520;520;260;null;null;EUR;68;34;588;294;0.5
0;KZ75125KZT2069101999;2015-10-28;571;571;285.5;51;25.5;EUR;null;null;520;260;0.5
0;KZ75125KZT2069101999;2015-10-29;503;503;251.5;null;null;EUR;68;34;571;285.5;0.5
0;KZ75125KZT2069101999;2015-10-30;432;432;216;null;null;EUR;71;35.5;503;251.5;0.5
0;KZ75125KZT2069101999;2015-10-31;498;498;249;66;33;EUR;null;null;432;216;0.5
0;KZ75125KZT2069101999;2015-11-01;525;525;262.5;27;13.5;EUR;null;null;498;249;0.5
0;KZ75125KZT2069101999;2015-11-02;447;447;223.5;null;null;EUR;78;39;525;262.5;0.5
0;KZ75125KZT2069101999;2015-11-03;399;399;199.5;null;null;EUR;48;24;447;223.5;0.5
0;KZ75125KZT2069101999;2015-11-04;427;427;213.5;28;14;EUR;null;null;399;199.5;0.5
0;KZ75125KZT2069101999;2015-11-05;471;471;235.5;44;22;EUR;null;null;427;213.5;0.5
0;KZ75125KZT2069101999;2015-11-06;423;423;211.5;null;null;EUR;48;24;471;235.5;0.5
0;KZ75125KZT2069101999;2015-11-07;473;473;236.5;50;25;EUR;null;null;423;211.5;0.5
0;KZ75125KZT2069101999;2015-11-08;500;500;250;27;13.5;EUR;null;null;473;236.5;0.5
0;KZ75125KZT2069101999;2015-11-09;507;507;253.5;7;3.5;EUR;null;null;500;250;0.5
0;KZ75125KZT2069101999;2015-11-10;425;425;212.5;null;null;EUR;82;41;507;253.5;0.5
0;KZ75125KZT2069101999;2015-11-11;350;350;175;null;null;EUR;75;37.5;425;212.5;0.5
0;KZ75125KZT2069101999;2015-11-12;434;434;217;84;42;EUR;null;null;350;175;0.5
0;KZ75125KZT2069101999;2015-11-13;466;466;233;32;16;EUR;null;null;434;217;0.5
0;KZ75125KZT2069101999;2015-11-14;561;561;280.5;95;47.5;EUR;null;null;466;233;0.5
0;KZ75125KZT2069101999;2015-11-15;586;586;293;25;12.5;EUR;null;null;561;280.5;0.5
0;KZ75125KZT2069101999;2015-11-16;561;561;280.5;null;null;EUR;25;12.5;586;293;0.5
0;KZ75125KZT2069101999;2015-11-17;532;532;266;null;null;EUR;29;14.5;561;280.5;0.5
0;KZ75125KZT2069101999;2015-11-18;519;519;259.5;null;null;EUR;13;6.5;532;266;0.5
0;KZ75125KZT2069101999;2015-11-19;532;532;266;13;6.5;EUR;null;null;519;259.5;0.5
0;KZ75125KZT2069101999;2015-11-20;509;509;254.5;null;null;EUR;23;11.5;532;266;0.5
0;KZ75125KZT2069101999;2015-11-21;414;414;207;null;null;EUR;95;47.5;509;254.5;0.5
0;KZ75125KZT2069101999;2015-11-22;422;422;211;8;4;EUR;null;null;414;207;0.5
0;KZ75125KZT2069101999;2015-11-23;423;423;211.5;1;0.5;EUR;null;null;422;211;0.5
0;KZ75125KZT2069101999;2015-11-24;460;460;230;37;18.5;EUR;null;null;423;211.5;0.5
0;KZ75125KZT2069101999;2015-11-25;361;361;180.5;null;null;EUR;99;49.5;460;230;0.5
0;KZ75125KZT2069101999;2015-11-26;339;339;169.5;null;null;EUR;22;11;361;180.5;0.5
0;KZ75125KZT2069101999;2015-11-27;244;244;122;null;null;EUR;95;47.5;339;169.5;0.5
0;KZ75125KZT2069101999;2015-11-28;207;207;103.5;null;null;EUR;37;18.5;244;122;0.5
0;KZ75125KZT2069101999;2015-11-29;140;140;70;null;null;EUR;67;33.5;207;103.5;0.5
0;KZ75125KZT2069101999;2015-11-30;55;55;27.5;null;null;EUR;85;42.5;140;70;0.5
0;KZ75125KZT2069101999;2015-12-01;-26;-26;-13;null;null;EUR;81;40.5;55;27.5;0.5
0;KZ75125KZT2069101999;2015-12-02;56;56;28;82;41;EUR;null;null;-26;-13;0.5
0;KZ75125KZT2069101999;2015-12-03;143;143;71.5;87;43.5;EUR;null;null;56;28;0.5
0;KZ75125KZT2069101999;2015-12-04;218;218;109;75;37.5;EUR;null;null;143;71.5;0.5
0;KZ75125KZT2069101999;2015-12-05;229;229;114.5;11;5.5;EUR;null;null;218;109;0.5
0;KZ75125KZT2069101999;2015-12-06;186;186;93;null;null;EUR;43;21.5;229;114.5;0.5
0;KZ75125KZT2069101999;2015-12-07;163;163;81.5;null;null;EUR;23;11.5;186;93;0.5
0;KZ75125KZT2069101999;2015-12-08;110;110;55;null;null;EUR;53;26.5;163;81.5;0.5
0;KZ75125KZT2069101999;2015-12-09;109;109;54.5;null;null;EUR;1;0.5;110;55;0.5
0;KZ75125KZT2069101999;2015-12-10;39;39;19.5;null;null;EUR;70;35;109;54.5;0.5
0;KZ75125KZT2069101999;2015-12-11;73;73;36.5;34;17;EUR;null;null;39;19.5;0.5
0;KZ75125KZT2069101999;2015-12-12;20;20;10;null;null;EUR;53;26.5;73;36.5;0.5
0;KZ75125KZT2069101999;2015-12-13;-8;-8;-4;null;null;EUR;28;14;20;10;0.5
0;KZ75125KZT2069101999;2015-12-14;-58;-58;-29;null;null;EUR;50;25;-8;-4;0.5
0;KZ75125KZT2069101999;2015-12-15;-113;-113;-56.5;null;null;EUR;55;27.5;-58;-29;0.5
0;KZ75125KZT2069101999;2015-12-16;-183;-183;-91.5;null;null;EUR;70;35;-113;-56.5;0.5
0;KZ75125KZT2069101999;2015-12-17;-282;-282;-141;null;null;EUR;99;49.5;-183;-91.5;0.5
0;KZ75125KZT2069101999;2015-12-18;-284;-284;-142;null;null;EUR;2;1;-282;-141;0.5
0;KZ75125KZT2069101999;2015-12-19;-320;-320;-160;null;null;EUR;36;18;-284;-142;0.5
0;KZ75125KZT2069101999;2015-12-20;-290;-290;-145;30;15;EUR;null;null;-320;-160;0.5
0;KZ75125KZT2069101999;2015-12-21;-260;-260;-130;30;15;EUR;null;null;-290;-145;0.5
0;KZ75125KZT2069101999;2015-12-22;-177;-177;-88.5;83;41.5;EUR;null;null;-260;-130;0.5
0;KZ75125KZT2069101999;2015-12-23;-129;-129;-64.5;48;24;EUR;null;null;-177;-88.5;0.5
0;KZ75125KZT2069101999;2015-12-24;-157;-157;-78.5;null;null;EUR;28;14;-129;-64.5;0.5
0;KZ75125KZT2069101999;2015-12-25;-117;-117;-58.5;40;20;EUR;null;null;-157;-78.5;0.5
0;KZ75125KZT2069101999;2015-12-26;-104;-104;-52;13;6.5;EUR;null;null;-117;-58.5;0.5
0;KZ75125KZT2069101999;2015-12-27;-140;-140;-70;null;null;EUR;36;18;-104;-52;0.5
0;KZ75125KZT2069101999;2015-12-28;-231;-231;-115.5;null;null;EUR;91;45.5;-140;-70;0.5
0;KZ75125KZT2069101999;2015-12-29;-288;-288;-144;null;null;EUR;57;28.5;-231;-115.5;0.5
0;KZ75125KZT2069101999;2015-12-30;-310;-310;-155;null;null;EUR;22;11;-288;-144;0.5
0;KZ75125KZT2069101999;2015-12-31;-272;-272;-136;38;19;EUR;null;null;-310;-155;0.5
0;KZ75125KZT2069101999;2016-01-01;-342;-342;-171;null;null;EUR;70;35;-272;-136;0.5
0;KZ75125KZT2069101999;2016-01-02;-319;-319;-159.5;23;11.5;EUR;null;null;-342;-171;0.5
0;KZ75125KZT2069101999;2016-01-03;-406;-406;-203;null;null;EUR;87;43.5;-319;-159.5;0.5
0;KZ75125KZT2069101999;2016-01-04;-490;-490;-245;null;null;EUR;84;42;-406;-203;0.5
0;KZ75125KZT2069101999;2016-01-05;-402;-402;-201;88;44;EUR;null;null;-490;-245;0.5
0;KZ75125KZT2069101999;2016-01-06;-367;-367;-183.5;35;17.5;EUR;null;null;-402;-201;0.5
0;KZ75125KZT2069101999;2016-01-07;-435;-435;-217.5;null;null;EUR;68;34;-367;-183.5;0.5
0;KZ75125KZT2069101999;2016-01-08;-388;-388;-194;47;23.5;EUR;null;null;-435;-217.5;0.5
0;KZ75125KZT2069101999;2016-01-09;-357;-357;-178.5;31;15.5;EUR;null;null;-388;-194;0.5
0;KZ75125KZT2069101999;2016-01-10;-362;-362;-181;null;null;EUR;5;2.5;-357;-178.5;0.5
0;KZ75125KZT2069101999;2016-01-11;-308;-308;-154;54;27;EUR;null;null;-362;-181;0.5
0;KZ75125KZT2069101999;2016-01-12;-370;-370;-185;null;null;EUR;62;31;-308;-154;0.5
0;KZ75125KZT2069101999;2016-01-13;-328;-328;-164;42;21;EUR;null;null;-370;-185;0.5
0;KZ75125KZT2069101999;2016-01-14;-331;-331;-165.5;null;null;EUR;3;1.5;-328;-164;0.5
0;KZ75125KZT2069101999;2016-01-15;-261;-261;-130.5;70;35;EUR;null;null;-331;-165.5;0.5
0;KZ75125KZT2069101999;2016-01-16;-323;-323;-161.5;null;null;EUR;62;31;-261;-130.5;0.5
0;KZ75125KZT2069101999;2016-01-17;-326;-326;-163;null;null;EUR;3;1.5;-323;-161.5;0.5
0;KZ75125KZT2069101999;2016-01-18;-384;-384;-192;null;null;EUR;58;29;-326;-163;0.5
0;KZ75125KZT2069101999;2016-01-19;-395;-395;-197.5;null;null;EUR;11;5.5;-384;-192;0.5
0;KZ75125KZT2069101999;2016-01-20;-434;-434;-217;null;null;EUR;39;19.5;-395;-197.5;0.5
0;KZ75125KZT2069101999;2016-01-21;-476;-476;-238;null;null;EUR;42;21;-434;-217;0.5
0;KZ75125KZT2069101999;2016-01-22;-552;-552;-276;null;null;EUR;76;38;-476;-238;0.5
0;KZ75125KZT2069101999;2016-01-23;-572;-572;-286;null;null;EUR;20;10;-552;-276;0.5
0;KZ75125KZT2069101999;2016-01-24;-492;-492;-246;80;40;EUR;null;null;-572;-286;0.5
0;KZ75125KZT2069101999;2016-01-25;-451;-451;-225.5;41;20.5;EUR;null;null;-492;-246;0.5
0;KZ75125KZT2069101999;2016-01-26;-401;-401;-200.5;50;25;EUR;null;null;-451;-225.5;0.5
0;KZ75125KZT2069101999;2016-01-27;-401;-401;-200.5;null;null;EUR;0;0;-401;-200.5;0.5
0;KZ75125KZT2069101999;2016-01-28;-497;-497;-248.5;null;null;EUR;96;48;-401;-200.5;0.5
0;KZ75125KZT2069101999;2016-01-29;-582;-582;-291;null;null;EUR;85;42.5;-497;-248.5;0.5
0;KZ75125KZT2069101999;2016-01-30;-500;-500;-250;82;41;EUR;null;null;-582;-291;0.5
0;KZ75125KZT2069101999;2016-01-31;-502;-502;-251;null;null;EUR;2;1;-500;-250;0.5
0;KZ75125KZT2069101999;2016-02-01;-551;-551;-275.5;null;null;EUR;49;24.5;-502;-251;0.5
0;KZ75125KZT2069101999;2016-02-02;-529;-529;-264.5;22;11;EUR;null;null;-551;-275.5;0.5
0;KZ75125KZT2069101999;2016-02-03;-448;-448;-224;81;40.5;EUR;null;null;-529;-264.5;0.5
0;KZ75125KZT2069101999;2016-02-04;-494;-494;-247;null;null;EUR;46;23;-448;-224;0.5
0;KZ75125KZT2069101999;2016-02-05;-535;-535;-267.5;null;null;EUR;41;20.5;-494;-247;0.5
0;KZ75125KZT2069101999;2016-02-06;-473;-473;-236.5;62;31;EUR;null;null;-535;-267.5;0.5
0;KZ75125KZT2069101999;2016-02-07;-444;-444;-222;29;14.5;EUR;null;null;-473;-236.5;0.5
0;KZ75125KZT2069101999;2016-02-08;-451;-451;-225.5;null;null;EUR;7;3.5;-444;-222;0.5
0;KZ75125KZT2069101999;2016-02-09;-470;-470;-235;null;null;EUR;19;9.5;-451;-225.5;0.5
0;KZ75125KZT2069101999;2016-02-10;-470;-470;-235;null;null;EUR;0;0;-470;-235;0.5
0;KZ75125KZT2069101999;2016-02-11;-544;-544;-272;null;null;EUR;74;37;-470;-235;0.5
0;KZ75125KZT2069101999;2016-02-12;-561;-561;-280.5;null;null;EUR;17;8.5;-544;-272;0.5
0;KZ75125KZT2069101999;2016-02-13;-634;-634;-317;null;null;EUR;73;36.5;-561;-280.5;0.5
0;KZ75125KZT2069101999;2016-02-14;-624;-624;-312;10;5;EUR;null;null;-634;-317;0.5
0;KZ75125KZT2069101999;2016-02-15;-593;-593;-296.5;31;15.5;EUR;null;null;-624;-312;0.5
0;KZ75125KZT2069101999;2016-02-16;-674;-674;-337;null;null;EUR;81;40.5;-593;-296.5;0.5
0;KZ75125KZT2069101999;2016-02-17;-722;-722;-361;null;null;EUR;48;24;-674;-337;0.5
0;KZ75125KZT2069101999;2016-02-18;-751;-751;-375.5;null;null;EUR;29;14.5;-722;-361;0.5
0;KZ75125KZT2069101999;2016-02-19;-725;-725;-362.5;26;13;EUR;null;null;-751;-375.5;0.5
0;KZ75125KZT2069101999;2016-02-20;-697;-697;-348.5;28;14;EUR;null;null;-725;-362.5;0.5
0;KZ75125KZT2069101999;2016-02-21;-653;-653;-326.5;44;22;EUR;null;null;-697;-348.5;0.5
0;KZ75125KZT2069101999;2016-02-22;-566;-566;-283;87;43.5;EUR;null;null;-653;-326.5;0.5
0;KZ75125KZT2069101999;2016-02-23;-609;-609;-304.5;null;null;EUR;43;21.5;-566;-283;0.5
0;KZ75125KZT2069101999;2016-02-24;-554;-554;-277;55;27.5;EUR;null;null;-609;-304.5;0.5
0;KZ75125KZT2069101999;2016-02-25;-499;-499;-249.5;55;27.5;EUR;null;null;-554;-277;0.5
0;KZ75125KZT2069101999;2016-02-26;-560;-560;-280;null;null;EUR;61;30.5;-499;-249.5;0.5
0;KZ75125KZT2069101999;2016-02-27;-617;-617;-308.5;null;null;EUR;57;28.5;-560;-280;0.5
0;KZ75125KZT2069101999;2016-02-28;-526;-526;-263;91;45.5;EUR;null;null;-617;-308.5;0.5
0;KZ75125KZT2069101999;2016-02-29;-587;-587;-293.5;null;null;EUR;61;30.5;-526;-263;0.5
0;KZ75125KZT2069101999;2016-03-01;-579;-579;-289.5;8;4;EUR;null;null;-587;-293.5;0.5
0;KZ75125KZT2069101999;2016-03-02;-531;-531;-265.5;48;24;EUR;null;null;-579;-289.5;0.5
0;KZ75125KZT2069101999;2016-03-03;-598;-598;-299;null;null;EUR;67;33.5;-531;-265.5;0.5
0;KZ75125KZT2069101999;2016-03-04;-576;-576;-288;22;11;EUR;null;null;-598;-299;0.5
0;KZ75125KZT2069101999;2016-03-05;-567;-567;-283.5;9;4.5;EUR;null;null;-576;-288;0.5
0;KZ75125KZT2069101999;2016-03-06;-561;-561;-280.5;6;3;EUR;null;null;-567;-283.5;0.5
0;KZ75125KZT2069101999;2016-03-07;-485;-485;-242.5;76;38;EUR;null;null;-561;-280.5;0.5
0;KZ75125KZT2069101999;2016-03-08;-458;-458;-229;27;13.5;EUR;null;null;-485;-242.5;0.5
0;KZ75125KZT2069101999;2016-03-09;-363;-363;-181.5;95;47.5;EUR;null;null;-458;-229;0.5
0;KZ75125KZT2069101999;2016-03-10;-298;-298;-149;65;32.5;EUR;null;null;-363;-181.5;0.5
0;KZ75125KZT2069101999;2016-03-11;-343;-343;-171.5;null;null;EUR;45;22.5;-298;-149;0.5
0;KZ75125KZT2069101999;2016-03-12;-404;-404;-202;null;null;EUR;61;30.5;-343;-171.5;0.5
0;KZ75125KZT2069101999;2016-03-13;-449;-449;-224.5;null;null;EUR;45;22.5;-404;-202;0.5
0;KZ75125KZT2069101999;2016-03-14;-373;-373;-186.5;76;38;EUR;null;null;-449;-224.5;0.5
0;KZ75125KZT2069101999;2016-03-15;-354;-354;-177;19;9.5;EUR;null;null;-373;-186.5;0.5
0;KZ75125KZT2069101999;2016-03-16;-427;-427;-213.5;null;null;EUR;73;36.5;-354;-177;0.5
0;KZ75125KZT2069101999;2016-03-17;-350;-350;-175;77;38.5;EUR;null;null;-427;-213.5;0.5
0;KZ75125KZT2069101999;2016-03-18;-444;-444;-222;null;null;EUR;94;47;-350;-175;0.5
0;KZ75125KZT2069101999;2016-03-19;-430;-430;-215;14;7;EUR;null;null;-444;-222;0.5
0;KZ75125KZT2069101999;2016-03-20;-388;-388;-194;42;21;EUR;null;null;-430;-215;0.5
0;KZ75125KZT2069101999;2016-03-21;-383;-383;-191.5;5;2.5;EUR;null;null;-388;-194;0.5
0;KZ75125KZT2069101999;2016-03-22;-359;-359;-179.5;24;12;EUR;null;null;-383;-191.5;0.5
0;KZ75125KZT2069101999;2016-03-23;-292;-292;-146;67;33.5;EUR;null;null;-359;-179.5;0.5
0;KZ75125KZT2069101999;2016-03-24;-217;-217;-108.5;75;37.5;EUR;null;null;-292;-146;0.5
0;KZ75125KZT2069101999;2016-03-25;-278;-278;-139;null;null;EUR;61;30.5;-217;-108.5;0.5
0;KZ75125KZT2069101999;2016-03-26;-189;-189;-94.5;89;44.5;EUR;null;null;-278;-139;0.5
0;KZ75125KZT2069101999;2016-03-27;-180;-180;-90;9;4.5;EUR;null;null;-189;-94.5;0.5
0;KZ75125KZT2069101999;2016-03-28;-136;-136;-68;44;22;EUR;null;null;-180;-90;0.5
0;KZ75125KZT2069101999;2016-03-29;-56;-56;-28;80;40;EUR;null;null;-136;-68;0.5
0;KZ75125KZT2069101999;2016-03-30;9;9;4.5;65;32.5;EUR;null;null;-56;-28;0.5
0;KZ75125KZT2069101999;2016-03-31;92;92;46;83;41.5;EUR;null;null;9;4.5;0.5
0;KZ75125KZT2069101999;2016-04-01;128;128;64;36;18;EUR;null;null;92;46;0.5
0;KZ75125KZT2069101999;2016-04-02;46;46;23;null;null;EUR;82;41;128;64;0.5
0;KZ75125KZT2069101999;2016-04-03;-32;-32;-16;null;null;EUR;78;39;46;23;0.5
0;KZ75125KZT2069101999;2016-04-04;28;28;14;60;30;EUR;null;null;-32;-16;0.5
0;KZ75125KZT2069101999;2016-04-05;-37;-37;-18.5;null;null;EUR;65;32.5;28;14;0.5
0;KZ75125KZT2069101999;2016-04-06;28;28;14;65;32.5;EUR;null;null;-37;-18.5;0.5
0;KZ75125KZT2069101999;2016-04-07;103;103;51.5;75;37.5;EUR;null;null;28;14;0.5
0;KZ75125KZT2069101999;2016-04-08;82;82;41;null;null;EUR;21;10.5;103;51.5;0.5
0;KZ75125KZT2069101999;2016-04-09;63;63;31.5;null;null;EUR;19;9.5;82;41;0.5
0;KZ75125KZT2069101999;2016-04-10;111;111;55.5;48;24;EUR;null;null;63;31.5;0.5
0;KZ75125KZT2069101999;2016-04-11;114;114;57;3;1.5;EUR;null;null;111;55.5;0.5
0;KZ75125KZT2069101999;2016-04-12;157;157;78.5;43;21.5;EUR;null;null;114;57;0.5
0;KZ75125KZT2069101999;2016-04-13;90;90;45;null;null;EUR;67;33.5;157;78.5;0.5
0;KZ75125KZT2069101999;2016-04-14;137;137;68.5;47;23.5;EUR;null;null;90;45;0.5
0;KZ75125KZT2069101999;2016-04-15;221;221;110.5;84;42;EUR;null;null;137;68.5;0.5
0;KZ75125KZT2069101999;2016-04-16;136;136;68;null;null;EUR;85;42.5;221;110.5;0.5
0;KZ75125KZT2069101999;2016-04-17;55;55;27.5;null;null;EUR;81;40.5;136;68;0.5
0;KZ75125KZT2069101999;2016-04-18;86;86;43;31;15.5;EUR;null;null;55;27.5;0.5
0;KZ75125KZT2069101999;2016-04-19;115;115;57.5;29;14.5;EUR;null;null;86;43;0.5
0;KZ75125KZT2069101999;2016-04-20;39;39;19.5;null;null;EUR;76;38;115;57.5;0.5
0;KZ75125KZT2069101999;2016-04-21;100;100;50;61;30.5;EUR;null;null;39;19.5;0.5
0;KZ75125KZT2069101999;2016-04-22;153;153;76.5;53;26.5;EUR;null;null;100;50;0.5
0;KZ75125KZT2069101999;2016-04-23;159;159;79.5;6;3;EUR;null;null;153;76.5;0.5
0;KZ75125KZT2069101999;2016-04-24;160;160;80;1;0.5;EUR;null;null;159;79.5;0.5
0;KZ75125KZT2069101999;2016-04-25;254;254;127;94;47;EUR;null;null;160;80;0.5
0;KZ75125KZT2069101999;2016-04-26;175;175;87.5;null;null;EUR;79;39.5;254;127;0.5
0;KZ75125KZT2069101999;2016-04-27;198;198;99;23;11.5;EUR;null;null;175;87.5;0.5
0;KZ75125KZT2069101999;2016-04-28;212;212;106;14;7;EUR;null;null;198;99;0.5
0;KZ75125KZT2069101999;2016-04-29;279;279;139.5;67;33.5;EUR;null;null;212;106;0.5
0;KZ75125KZT2069101999;2016-04-30;341;341;170.5;62;31;EUR;null;null;279;139.5;0.5
0;KZ75125KZT2069101999;2016-05-01;433;433;216.5;92;46;EUR;null;null;341;170.5;0.5
0;KZ75125KZT2069101999;2016-05-02;353;353;176.5;null;null;EUR;80;40;433;216.5;0.5
0;KZ75125KZT2069101999;2016-05-03;342;342;171;null;null;EUR;11;5.5;353;176.5;0.5
0;KZ75125KZT2069101999;2016-05-04;278;278;139;null;null;EUR;64;32;342;171;0.5
0;KZ75125KZT2069101999;2016-05-05;326;326;163;48;24;EUR;null;null;278;139;0.5
0;KZ75125KZT2069101999;2016-05-06;276;276;138;null;null;EUR;50;25;326;163;0.5
0;KZ75125KZT2069101999;2016-05-07;362;362;181;86;43;EUR;null;null;276;138;0.5
0;KZ75125KZT2069101999;2016-05-08;322;322;161;null;null;EUR;40;20;362;181;0.5
0;KZ75125KZT2069101999;2016-05-09;391;391;195.5;69;34.5;EUR;null;null;322;161;0.5
0;KZ75125KZT2069101999;2016-05-10;379;379;189.5;null;null;EUR;12;6;391;195.5;0.5
0;KZ75125KZT2069101999;2016-05-11;432;432;216;53;26.5;EUR;null;null;379;189.5;0.5
0;KZ75125KZT2069101999;2016-05-12;402;402;201;null;null;EUR;30;15;432;216;0.5
0;KZ75125KZT2069101999;2016-05-13;461;461;230.5;59;29.5;EUR;null;null;402;201;0.5
0;KZ75125KZT2069101999;2016-05-14;444;444;222;null;null;EUR;17;8.5;461;230.5;0.5
0;KZ75125KZT2069101999;2016-05-15;531;531;265.5;87;43.5;EUR;null;null;444;222;0.5
0;KZ75125KZT2069101999;2016-05-16;627;627;313.5;96;48;EUR;null;null;531;265.5;0.5
0;KZ75125KZT2069101999;2016-05-17;568;568;284;null;null;EUR;59;29.5;627;313.5;0.5
0;KZ75125KZT2069101999;2016-05-18;591;591;295.5;23;11.5;EUR;null;null;568;284;0.5
0;KZ75125KZT2069101999;2016-05-19;524;524;262;null;null;EUR;67;33.5;591;295.5;0.5
0;KZ75125KZT2069101999;2016-05-20;524;524;262;null;null;EUR;0;0;524;262;0.5
0;KZ75125KZT2069101999;2016-05-21;552;552;276;28;14;EUR;null;null;524;262;0.5
0;KZ75125KZT2069101999;2016-05-22;461;461;230.5;null;null;EUR;91;45.5;552;276;0.5
0;KZ75125KZT2069101999;2016-05-23;435;435;217.5;null;null;EUR;26;13;461;230.5;0.5
0;KZ75125KZT2069101999;2016-05-24;461;461;230.5;26;13;EUR;null;null;435;217.5;0.5
0;KZ75125KZT2069101999;2016-05-25;373;373;186.5;null;null;EUR;88;44;461;230.5;0.5
0;KZ75125KZT2069101999;2016-05-26;377;377;188.5;4;2;EUR;null;null;373;186.5;0.5
0;KZ75125KZT2069101999;2016-05-27;354;354;177;null;null;EUR;23;11.5;377;188.5;0.5
0;KZ75125KZT2069101999;2016-05-28;438;438;219;84;42;EUR;null;null;354;177;0.5
0;KZ75125KZT2069101999;2016-05-29;535;535;267.5;97;48.5;EUR;null;null;438;219;0.5
0;KZ75125KZT2069101999;2016-05-30;463;463;231.5;null;null;EUR;72;36;535;267.5;0.5
0;KZ75125KZT2069101999;2016-05-31;541;541;270.5;78;39;EUR;null;null;463;231.5;0.5
0;KZ75125KZT2069101999;2016-06-01;523;523;261.5;null;null;EUR;18;9;541;270.5;0.5
0;KZ75125KZT2069101999;2016-06-02;469;469;234.5;null;null;EUR;54;27;523;261.5;0.5
0;KZ75125KZT2069101999;2016-06-03;445;445;222.5;null;null;EUR;24;12;469;234.5;0.5
0;KZ75125KZT2069101999;2016-06-04;370;370;185;null;null;EUR;75;37.5;445;222.5;0.5
0;KZ75125KZT2069101999;2016-06-05;402;402;201;32;16;EUR;null;null;370;185;0.5
0;KZ75125KZT2069101999;2016-06-06;405;405;202.5;3;1.5;EUR;null;null;402;201;0.5
0;KZ75125KZT2069101999;2016-06-07;432;432;216;27;13.5;EUR;null;null;405;202.5;0.5
0;KZ75125KZT2069101999;2016-06-08;483;483;241.5;51;25.5;EUR;null;null;432;216;0.5
0;KZ75125KZT2069101999;2016-06-09;430;430;215;null;null;EUR;53;26.5;483;241.5;0.5
0;KZ75125KZT2069101999;2016-06-10;494;494;247;64;32;EUR;null;null;430;215;0.5
0;KZ75125KZT2069101999;2016-06-11;414;414;207;null;null;EUR;80;40;494;247;0.5
0;KZ75125KZT2069101999;2016-06-12;455;455;227.5;41;20.5;EUR;null;null;414;207;0.5
0;KZ75125KZT2069101999;2016-06-13;414;414;207;null;null;EUR;41;20.5;455;227.5;0.5
0;KZ75125KZT2069101999;2016-06-14;445;445;222.5;31;15.5;EUR;null;null;414;207;0.5
0;KZ75125KZT2069101999;2016-06-15;368;368;184;null;null;EUR;77;38.5;445;222.5;0.5
0;KZ75125KZT2069101999;2016-06-16;317;317;158.5;null;null;EUR;51;25.5;368;184;0.5
0;KZ75125KZT2069101999;2016-06-17;338;338;169;21;10.5;EUR;null;null;317;158.5;0.5
0;KZ75125KZT2069101999;2016-06-18;375;375;187.5;37;18.5;EUR;null;null;338;169;0.5
0;KZ75125KZT2069101999;2016-06-19;306;306;153;null;null;EUR;69;34.5;375;187.5;0.5
0;KZ75125KZT2069101999;2016-06-20;396;396;198;90;45;EUR;null;null;306;153;0.5
0;KZ75125KZT2069101999;2016-06-21;482;482;241;86;43;EUR;null;null;396;198;0.5
0;KZ75125KZT2069101999;2016-06-22;507;507;253.5;25;12.5;EUR;null;null;482;241;0.5
0;KZ75125KZT2069101999;2016-06-23;526;526;263;19;9.5;EUR;null;null;507;253.5;0.5
0;KZ75125KZT2069101999;2016-06-24;558;558;279;32;16;EUR;null;null;526;263;0.5
0;KZ75125KZT2069101999;2016-06-25;564;564;282;6;3;EUR;null;null;558;279;0.5
0;KZ75125KZT2069101999;2016-06-26;626;626;313;62;31;EUR;null;null;564;282;0.5
0;KZ75125KZT2069101999;2016-06-27;534;534;267;null;null;EUR;92;46;626;313;0.5
0;KZ75125KZT2069101999;2016-06-28;477;477;238.5;null;null;EUR;57;28.5;534;267;0.5
0;KZ75125KZT2069101999;2016-06-29;389;389;194.5;null;null;EUR;88;44;477;238.5;0.5
0;KZ75125KZT2069101999;2016-06-30;421;421;210.5;32;16;EUR;null;null;389;194.5;0.5
0;KZ75125KZT2069101999;2016-07-01;366;366;183;null;null;EUR;55;27.5;421;210.5;0.5
0;KZ75125KZT2069101999;2016-07-02;372;372;186;6;3;EUR;null;null;366;183;0.5
0;KZ75125KZT2069101999;2016-07-03;380;380;190;8;4;EUR;null;null;372;186;0.5
0;KZ75125KZT2069101999;2016-07-04;349;349;174.5;null;null;EUR;31;15.5;380;190;0.5
0;KZ75125KZT2069101999;2016-07-05;355;355;177.5;6;3;EUR;null;null;349;174.5;0.5
0;KZ75125KZT2069101999;2016-07-06;438;438;219;83;41.5;EUR;null;null;355;177.5;0.5
0;KZ75125KZT2069101999;2016-07-07;450;450;225;12;6;EUR;null;null;438;219;0.5
0;KZ75125KZT2069101999;2016-07-08;445;445;222.5;null;null;EUR;5;2.5;450;225;0.5
0;KZ75125KZT2069101999;2016-07-09;452;452;226;7;3.5;EUR;null;null;445;222.5;0.5
0;KZ75125KZT2069101999;2016-07-10;526;526;263;74;37;EUR;null;null;452;226;0.5
0;KZ75125KZT2069101999;2016-07-11;431;431;215.5;null;null;EUR;95;47.5;526;263;0.5
0;KZ75125KZT2069101999;2016-07-12;501;501;250.5;70;35;EUR;null;null;431;215.5;0.5
0;KZ75125KZT2069101999;2016-07-13;478;478;239;null;null;EUR;23;11.5;501;250.5;0.5
0;KZ75125KZT2069101999;2016-07-14;406;406;203;null;null;EUR;72;36;478;239;0.5
0;KZ75125KZT2069101999;2016-07-15;495;495;247.5;89;44.5;EUR;null;null;406;203;0.5
0;KZ75125KZT2069101999;2016-07-16;460;460;230;null;null;EUR;35;17.5;495;247.5;0.5
0;KZ75125KZT2069101999;2016-07-17;496;496;248;36;18;EUR;null;null;460;230;0.5
0;KZ75125KZT2069101999;2016-07-18;543;543;271.5;47;23.5;EUR;null;null;496;248;0.5
0;KZ75125KZT2069101999;2016-07-19;498;498;249;null;null;EUR;45;22.5;543;271.5;0.5
0;KZ75125KZT2069101999;2016-07-20;580;580;290;82;41;EUR;null;null;498;249;0.5
0;KZ75125KZT2069101999;2016-07-21;490;490;245;null;null;EUR;90;45;580;290;0.5
0;KZ75125KZT2069101999;2016-07-22;393;393;196.5;null;null;EUR;97;48.5;490;245;0.5
0;KZ75125KZT2069101999;2016-07-23;436;436;218;43;21.5;EUR;null;null;393;196.5;0.5
0;KZ75125KZT2069101999;2016-07-24;414;414;207;null;null;EUR;22;11;436;218;0.5
0;KZ75125KZT2069101999;2016-07-25;464;464;232;50;25;EUR;null;null;414;207;0.5
0;KZ75125KZT2069101999;2016-07-26;473;473;236.5;9;4.5;EUR;null;null;464;232;0.5
0;KZ75125KZT2069101999;2016-07-27;388;388;194;null;null;EUR;85;42.5;473;236.5;0.5
0;KZ75125KZT2069101999;2016-07-28;318;318;159;null;null;EUR;70;35;388;194;0.5
0;KZ75125KZT2069101999;2016-07-29;342;342;171;24;12;EUR;null;null;318;159;0.5
0;KZ75125KZT2069101999;2016-07-30;252;252;126;null;null;EUR;90;45;342;171;0.5
0;KZ75125KZT2069101999;2016-07-31;212;212;106;null;null;EUR;40;20;252;126;0.5
0;KZ75125KZT2069101999;2016-08-01;145;145;72.5;null;null;EUR;67;33.5;212;106;0.5
0;KZ75125KZT2069101999;2016-08-02;63;63;31.5;null;null;EUR;82;41;145;72.5;0.5
0;KZ75125KZT2069101999;2016-08-03;102;102;51;39;19.5;EUR;null;null;63;31.5;0.5
0;KZ75125KZT2069101999;2016-08-04;126;126;63;24;12;EUR;null;null;102;51;0.5
0;KZ75125KZT2069101999;2016-08-05;89;89;44.5;null;null;EUR;37;18.5;126;63;0.5
0;KZ75125KZT2069101999;2016-08-06;25;25;12.5;null;null;EUR;64;32;89;44.5;0.5
0;KZ75125KZT2069101999;2016-08-07;53;53;26.5;28;14;EUR;null;null;25;12.5;0.5
0;KZ75125KZT2069101999;2016-08-08;-31;-31;-15.5;null;null;EUR;84;42;53;26.5;0.5
0;KZ75125KZT2069101999;2016-08-09;-108;-108;-54;null;null;EUR;77;38.5;-31;-15.5;0.5
0;KZ75125KZT2069101999;2016-08-10;-146;-146;-73;null;null;EUR;38;19;-108;-54;0.5
0;KZ75125KZT2069101999;2016-08-11;-128;-128;-64;18;9;EUR;null;null;-146;-73;0.5
0;KZ75125KZT2069101999;2016-08-12;-204;-204;-102;null;null;EUR;76;38;-128;-64;0.5
0;KZ75125KZT2069101999;2016-08-13;-282;-282;-141;null;null;EUR;78;39;-204;-102;0.5
0;KZ75125KZT2069101999;2016-08-14;-375;-375;-187.5;null;null;EUR;93;46.5;-282;-141;0.5
0;KZ75125KZT2069101999;2016-08-15;-411;-411;-205.5;null;null;EUR;36;18;-375;-187.5;0.5
0;KZ75125KZT2069101999;2016-08-16;-430;-430;-215;null;null;EUR;19;9.5;-411;-205.5;0.5
0;KZ75125KZT2069101999;2016-08-17;-351;-351;-175.5;79;39.5;EUR;null;null;-430;-215;0.5
0;KZ75125KZT2069101999;2016-08-18;-405;-405;-202.5;null;null;EUR;54;27;-351;-175.5;0.5
0;KZ75125KZT2069101999;2016-08-19;-490;-490;-245;null;null;EUR;85;42.5;-405;-202.5;0.5
0;KZ75125KZT2069101999;2016-08-20;-501;-501;-250.5;null;null;EUR;11;5.5;-490;-245;0.5
0;KZ75125KZT2069101999;2016-08-21;-463;-463;-231.5;38;19;EUR;null;null;-501;-250.5;0.5
0;KZ75125KZT2069101999;2016-08-22;-420;-420;-210;43;21.5;EUR;null;null;-463;-231.5;0.5
0;KZ75125KZT2069101999;2016-08-23;-417;-417;-208.5;3;1.5;EUR;null;null;-420;-210;0.5
0;KZ75125KZT2069101999;2016-08-24;-400;-400;-200;17;8.5;EUR;null;null;-417;-208.5;0.5
0;KZ75125KZT2069101999;2016-08-25;-343;-343;-171.5;57;28.5;EUR;null;null;-400;-200;0.5
0;KZ75125KZT2069101999;2016-08-26;-413;-413;-206.5;null;null;EUR;70;35;-343;-171.5;0.5
0;KZ75125KZT2069101999;2016-08-27;-350;-350;-175;63;31.5;EUR;null;null;-413;-206.5;0.5
0;KZ75125KZT2069101999;2016-08-28;-331;-331;-165.5;19;9.5;EUR;null;null;-350;-175;0.5
0;KZ75125KZT2069101999;2016-08-29;-385;-385;-192.5;null;null;EUR;54;27;-331;-165.5;0.5
0;KZ75125KZT2069101999;2016-08-30;-350;-350;-175;35;17.5;EUR;null;null;-385;-192.5;0.5
0;KZ75125KZT2069101999;2016-08-31;-253;-253;-126.5;97;48.5;EUR;null;null;-350;-175;0.5
0;KZ75125KZT2069101999;2016-09-01;-290;-290;-145;null;null;EUR;37;18.5;-253;-126.5;0.5
0;KZ75125KZT2069101999;2016-09-02;-365;-365;-182.5;null;null;EUR;75;37.5;-290;-145;0.5
0;KZ75125KZT2069101999;2016-09-03;-452;-452;-226;null;null;EUR;87;43.5;-365;-182.5;0.5
0;KZ75125KZT2069101999;2016-09-04;-488;-488;-244;null;null;EUR;36;18;-452;-226;0.5
0;KZ75125KZT2069101999;2016-09-05;-405;-405;-202.5;83;41.5;EUR;null;null;-488;-244;0.5
0;KZ75125KZT2069101999;2016-09-06;-346;-346;-173;59;29.5;EUR;null;null;-405;-202.5;0.5
0;KZ75125KZT2069101999;2016-09-07;-249;-249;-124.5;97;48.5;EUR;null;null;-346;-173;0.5
0;KZ75125KZT2069101999;2016-09-08;-330;-330;-165;null;null;EUR;81;40.5;-249;-124.5;0.5
0;KZ75125KZT2069101999;2016-09-09;-246;-246;-123;84;42;EUR;null;null;-330;-165;0.5
0;KZ75125KZT2069101999;2016-09-10;-157;-157;-78.5;89;44.5;EUR;null;null;-246;-123;0.5
0;KZ75125KZT2069101999;2016-09-11;-119;-119;-59.5;38;19;EUR;null;null;-157;-78.5;0.5
0;KZ75125KZT2069101999;2016-09-12;-148;-148;-74;null;null;EUR;29;14.5;-119;-59.5;0.5
0;KZ75125KZT2069101999;2016-09-13;-203;-203;-101.5;null;null;EUR;55;27.5;-148;-74;0.5
0;KZ75125KZT2069101999;2016-09-14;-187;-187;-93.5;16;8;EUR;null;null;-203;-101.5;0.5
0;KZ75125KZT2069101999;2016-09-15;-185;-185;-92.5;2;1;EUR;null;null;-187;-93.5;0.5
0;KZ75125KZT2069101999;2016-09-16;-182;-182;-91;3;1.5;EUR;null;null;-185;-92.5;0.5
0;KZ75125KZT2069101999;2016-09-17;-170;-170;-85;12;6;EUR;null;null;-182;-91;0.5
0;KZ75125KZT2069101999;2016-09-18;-232;-232;-116;null;null;EUR;62;31;-170;-85;0.5
0;KZ75125KZT2069101999;2016-09-19;-223;-223;-111.5;9;4.5;EUR;null;null;-232;-116;0.5
0;KZ75125KZT2069101999;2016-09-20;-285;-285;-142.5;null;null;EUR;62;31;-223;-111.5;0.5
0;KZ75125KZT2069101999;2016-09-21;-308;-308;-154;null;null;EUR;23;11.5;-285;-142.5;0.5
0;KZ75125KZT2069101999;2016-09-22;-372;-372;-186;null;null;EUR;64;32;-308;-154;0.5
0;KZ75125KZT2069101999;2016-09-23;-382;-382;-191;null;null;EUR;10;5;-372;-186;0.5
0;KZ75125KZT2069101999;2016-09-24;-428;-428;-214;null;null;EUR;46;23;-382;-191;0.5
0;KZ75125KZT2069101999;2016-09-25;-506;-506;-253;null;null;EUR;78;39;-428;-214;0.5
0;KZ75125KZT2069101999;2016-09-26;-418;-418;-209;88;44;EUR;null;null;-506;-253;0.5
0;KZ75125KZT2069101999;2016-09-27;-443;-443;-221.5;null;null;EUR;25;12.5;-418;-209;0.5
0;KZ75125KZT2069101999;2016-09-28;-374;-374;-187;69;34.5;EUR;null;null;-443;-221.5;0.5
0;KZ75125KZT2069101999;2016-09-29;-469;-469;-234.5;null;null;EUR;95;47.5;-374;-187;0.5
0;KZ75125KZT2069101999;2016-09-30;-496;-496;-248;null;null;EUR;27;13.5;-469;-234.5;0.5
0;KZ75125KZT2069101999;2016-10-01;-580;-580;-290;null;null;EUR;84;42;-496;-248;0.5
0;KZ75125KZT2069101999;2016-10-02;-493;-493;-246.5;87;43.5;EUR;null;null;-580;-290;0.5
0;KZ75125KZT2069101999;2016-10-03;-526;-526;-263;null;null;EUR;33;16.5;-493;-246.5;0.5
0;KZ75125KZT2069101999;2016-10-04;-466;-466;-233;60;30;EUR;null;null;-526;-263;0.5
0;KZ75125KZT2069101999;2016-10-05;-448;-448;-224;18;9;EUR;null;null;-466;-233;0.5
0;KZ75125KZT2069101999;2016-10-06;-500;-500;-250;null;null;EUR;52;26;-448;-224;0.5
0;KZ75125KZT2069101999;2016-10-07;-550;-550;-275;null;null;EUR;50;25;-500;-250;0.5
0;KZ75125KZT2069101999;2016-10-08;-503;-503;-251.5;47;23.5;EUR;null;null;-550;-275;0.5
0;KZ75125KZT2069101999;2016-10-09;-574;-574;-287;null;null;EUR;71;35.5;-503;-251.5;0.5
0;KZ75125KZT2069101999;2016-10-10;-551;-551;-275.5;23;11.5;EUR;null;null;-574;-287;0.5
0;KZ75125KZT2069101999;2016-10-11;-488;-488;-244;63;31.5;EUR;null;null;-551;-275.5;0.5
0;KZ75125KZT2069101999;2016-10-12;-526;-526;-263;null;null;EUR;38;19;-488;-244;0.5
0;KZ75125KZT2069101999;2016-10-13;-483;-483;-241.5;43;21.5;EUR;null;null;-526;-263;0.5
0;KZ75125KZT2069101999;2016-10-14;-398;-398;-199;85;42.5;EUR;null;null;-483;-241.5;0.5
0;KZ75125KZT2069101999;2016-10-15;-354;-354;-177;44;22;EUR;null;null;-398;-199;0.5
0;KZ75125KZT2069101999;2016-10-16;-445;-445;-222.5;null;null;EUR;91;45.5;-354;-177;0.5
0;KZ75125KZT2069101999;2016-10-17;-481;-481;-240.5;null;null;EUR;36;18;-445;-222.5;0.5
0;KZ75125KZT2069101999;2016-10-18;-401;-401;-200.5;80;40;EUR;null;null;-481;-240.5;0.5
0;KZ75125KZT2069101999;2016-10-19;-401;-401;-200.5;null;null;EUR;0;0;-401;-200.5;0.5
0;KZ75125KZT2069101999;2016-10-20;-335;-335;-167.5;66;33;EUR;null;null;-401;-200.5;0.5
0;KZ75125KZT2069101999;2016-10-21;-273;-273;-136.5;62;31;EUR;null;null;-335;-167.5;0.5
0;KZ75125KZT2069101999;2016-10-22;-199;-199;-99.5;74;37;EUR;null;null;-273;-136.5;0.5
0;KZ75125KZT2069101999;2016-10-23;-213;-213;-106.5;null;null;EUR;14;7;-199;-99.5;0.5
0;KZ75125KZT2069101999;2016-10-24;-295;-295;-147.5;null;null;EUR;82;41;-213;-106.5;0.5
0;KZ75125KZT2069101999;2016-10-25;-295;-295;-147.5;null;null;EUR;0;0;-295;-147.5;0.5
0;KZ75125KZT2069101999;2016-10-26;-220;-220;-110;75;37.5;EUR;null;null;-295;-147.5;0.5
0;KZ75125KZT2069101999;2016-10-27;-149;-149;-74.5;71;35.5;EUR;null;null;-220;-110;0.5
0;KZ75125KZT2069101999;2016-10-28;-123;-123;-61.5;26;13;EUR;null;null;-149;-74.5;0.5
0;KZ75125KZT2069101999;2016-10-29;-141;-141;-70.5;null;null;EUR;18;9;-123;-61.5;0.5
0;KZ75125KZT2069101999;2016-10-30;-153;-153;-76.5;null;null;EUR;12;6;-141;-70.5;0.5
0;KZ75125KZT2069101999;2016-10-31;-75;-75;-37.5;78;39;EUR;null;null;-153;-76.5;0.5
0;KZ75125KZT2069101999;2016-11-01;-60;-60;-30;15;7.5;EUR;null;null;-75;-37.5;0.5
0;KZ75125KZT2069101999;2016-11-02;-152;-152;-76;null;null;EUR;92;46;-60;-30;0.5
0;KZ75125KZT2069101999;2016-11-03;-227;-227;-113.5;null;null;EUR;75;37.5;-152;-76;0.5
0;KZ75125KZT2069101999;2016-11-04;-295;-295;-147.5;null;null;EUR;68;34;-227;-113.5;0.5
0;KZ75125KZT2069101999;2016-11-05;-234;-234;-117;61;30.5;EUR;null;null;-295;-147.5;0.5
0;KZ75125KZT2069101999;2016-11-06;-227;-227;-113.5;7;3.5;EUR;null;null;-234;-117;0.5
0;KZ75125KZT2069101999;2016-11-07;-246;-246;-123;null;null;EUR;19;9.5;-227;-113.5;0.5
0;KZ75125KZT2069101999;2016-11-08;-179;-179;-89.5;67;33.5;EUR;null;null;-246;-123;0.5
0;KZ75125KZT2069101999;2016-11-09;-226;-226;-113;null;null;EUR;47;23.5;-179;-89.5;0.5
0;KZ75125KZT2069101999;2016-11-10;-317;-317;-158.5;null;null;EUR;91;45.5;-226;-113;0.5
0;KZ75125KZT2069101999;2016-11-11;-223;-223;-111.5;94;47;EUR;null;null;-317;-158.5;0.5
0;KZ75125KZT2069101999;2016-11-12;-263;-263;-131.5;null;null;EUR;40;20;-223;-111.5;0.5
0;KZ75125KZT2069101999;2016-11-13;-292;-292;-146;null;null;EUR;29;14.5;-263;-131.5;0.5
0;KZ75125KZT2069101999;2016-11-14;-235;-235;-117.5;57;28.5;EUR;null;null;-292;-146;0.5
0;KZ75125KZT2069101999;2016-11-15;-149;-149;-74.5;86;43;EUR;null;null;-235;-117.5;0.5
0;KZ75125KZT2069101999;2016-11-16;-168;-168;-84;null;null;EUR;19;9.5;-149;-74.5;0.5
0;KZ75125KZT2069101999;2016-11-17;-222;-222;-111;null;null;EUR;54;27;-168;-84;0.5
0;KZ75125KZT2069101999;2016-11-18;-233;-233;-116.5;null;null;EUR;11;5.5;-222;-111;0.5
0;KZ75125KZT2069101999;2016-11-19;-194;-194;-97;39;19.5;EUR;null;null;-233;-116.5;0.5
0;KZ75125KZT2069101999;2016-11-20;-285;-285;-142.5;null;null;EUR;91;45.5;-194;-97;0.5
0;KZ75125KZT2069101999;2016-11-21;-257;-257;-128.5;28;14;EUR;null;null;-285;-142.5;0.5
0;KZ75125KZT2069101999;2016-11-22;-260;-260;-130;null;null;EUR;3;1.5;-257;-128.5;0.5
0;KZ75125KZT2069101999;2016-11-23;-241;-241;-120.5;19;9.5;EUR;null;null;-260;-130;0.5
0;KZ75125KZT2069101999;2016-11-24;-248;-248;-124;null;null;EUR;7;3.5;-241;-120.5;0.5
0;KZ75125KZT2069101999;2016-11-25;-300;-300;-150;null;null;EUR;52;26;-248;-124;0.5
0;KZ75125KZT2069101999;2016-11-26;-317;-317;-158.5;null;null;EUR;17;8.5;-300;-150;0.5
0;KZ75125KZT2069101999;2016-11-27;-363;-363;-181.5;null;null;EUR;46;23;-317;-158.5;0.5
0;KZ75125KZT2069101999;2016-11-28;-298;-298;-149;65;32.5;EUR;null;null;-363;-181.5;0.5
0;KZ75125KZT2069101999;2016-11-29;-201;-201;-100.5;97;48.5;EUR;null;null;-298;-149;0.5
0;KZ75125KZT2069101999;2016-11-30;-219;-219;-109.5;null;null;EUR;18;9;-201;-100.5;0.5
0;KZ75125KZT2069101999;2016-12-01;-129;-129;-64.5;90;45;EUR;null;null;-219;-109.5;0.5
0;KZ75125KZT2069101999;2016-12-02;-88;-88;-44;41;20.5;EUR;null;null;-129;-64.5;0.5
0;KZ75125KZT2069101999;2016-12-03;-101;-101;-50.5;null;null;EUR;13;6.5;-88;-44;0.5
0;KZ75125KZT2069101999;2016-12-04;-140;-140;-70;null;null;EUR;39;19.5;-101;-50.5;0.5
0;KZ75125KZT2069101999;2016-12-05;-68;-68;-34;72;36;EUR;null;null;-140;-70;0.5
0;KZ75125KZT2069101999;2016-12-06;-93;-93;-46.5;null;null;EUR;25;12.5;-68;-34;0.5
0;KZ75125KZT2069101999;2016-12-07;-180;-180;-90;null;null;EUR;87;43.5;-93;-46.5;0.5
0;KZ75125KZT2069101999;2016-12-08;-132;-132;-66;48;24;EUR;null;null;-180;-90;0.5
0;KZ75125KZT2069101999;2016-12-09;-171;-171;-85.5;null;null;EUR;39;19.5;-132;-66;0.5
0;KZ75125KZT2069101999;2016-12-10;-182;-182;-91;null;null;EUR;11;5.5;-171;-85.5;0.5
0;KZ75125KZT2069101999;2016-12-11;-120;-120;-60;62;31;EUR;null;null;-182;-91;0.5
0;KZ75125KZT2069101999;2016-12-12;-165;-165;-82.5;null;null;EUR;45;22.5;-120;-60;0.5
0;KZ75125KZT2069101999;2016-12-13;-183;-183;-91.5;null;null;EUR;18;9;-165;-82.5;0.5
0;KZ75125KZT2069101999;2016-12-14;-136;-136;-68;47;23.5;EUR;null;null;-183;-91.5;0.5
0;KZ75125KZT2069101999;2016-12-15;-158;-158;-79;null;null;EUR;22;11;-136;-68;0.5
0;KZ75125KZT2069101999;2016-12-16;-249;-249;-124.5;null;null;EUR;91;45.5;-158;-79;0.5
0;KZ75125KZT2069101999;2016-12-17;-234;-234;-117;15;7.5;EUR;null;null;-249;-124.5;0.5
0;KZ75125KZT2069101999;2016-12-18;-259;-259;-129.5;null;null;EUR;25;12.5;-234;-117;0.5
0;KZ75125KZT2069101999;2016-12-19;-299;-299;-149.5;null;null;EUR;40;20;-259;-129.5;0.5
0;KZ75125KZT2069101999;2016-12-20;-356;-356;-178;null;null;EUR;57;28.5;-299;-149.5;0.5
0;KZ75125KZT2069101999;2016-12-21;-338;-338;-169;18;9;EUR;null;null;-356;-178;0.5
0;KZ75125KZT2069101999;2016-12-22;-311;-311;-155.5;27;13.5;EUR;null;null;-338;-169;0.5
0;KZ75125KZT2069101999;2016-12-23;-367;-367;-183.5;null;null;EUR;56;28;-311;-155.5;0.5
0;KZ75125KZT2069101999;2016-12-24;-372;-372;-186;null;null;EUR;5;2.5;-367;-183.5;0.5
0;KZ75125KZT2069101999;2016-12-25;-364;-364;-182;8;4;EUR;null;null;-372;-186;0.5
0;KZ75125KZT2069101999;2016-12-26;-321;-321;-160.5;43;21.5;EUR;null;null;-364;-182;0.5
0;KZ75125KZT2069101999;2016-12-27;-360;-360;-180;null;null;EUR;39;19.5;-321;-160.5;0.5
0;KZ75125KZT2069101999;2016-12-28;-340;-340;-170;20;10;EUR;null;null;-360;-180;0.5
0;KZ75125KZT2069101999;2016-12-29;-370;-370;-185;null;null;EUR;30;15;-340;-170;0.5
0;KZ75125KZT2069101999;2016-12-30;-448;-448;-224;null;null;EUR;78;39;-370;-185;0.5
0;KZ75125KZT2069101999;2016-12-31;-471;-471;-235.5;null;null;EUR;23;11.5;-448;-224;0.5
0;KZ75125KZT2069101999;2017-01-01;-438;-438;-219;33;16.5;EUR;null;null;-471;-235.5;0.5
0;KZ75125KZT2069101999;2017-01-02;-397;-397;-198.5;41;20.5;EUR;null;null;-438;-219;0.5
0;KZ75125KZT2069101999;2017-01-03;-401;-401;-200.5;null;null;EUR;4;2;-397;-198.5;0.5
0;KZ75125KZT2069101999;2017-01-04;-477;-477;-238.5;null;null;EUR;76;38;-401;-200.5;0.5
0;KZ75125KZT2069101999;2017-01-05;-477;-477;-238.5;null;null;EUR;0;0;-477;-238.5;0.5
0;KZ75125KZT2069101999;2017-01-06;-452;-452;-226;25;12.5;EUR;null;null;-477;-238.5;0.5
0;KZ75125KZT2069101999;2017-01-07;-391;-391;-195.5;61;30.5;EUR;null;null;-452;-226;0.5
0;KZ75125KZT2069101999;2017-01-08;-481;-481;-240.5;null;null;EUR;90;45;-391;-195.5;0.5
0;KZ75125KZT2069101999;2017-01-09;-416;-416;-208;65;32.5;EUR;null;null;-481;-240.5;0.5
0;KZ75125KZT2069101999;2017-01-10;-387;-387;-193.5;29;14.5;EUR;null;null;-416;-208;0.5
0;KZ75125KZT2069101999;2017-01-11;-340;-340;-170;47;23.5;EUR;null;null;-387;-193.5;0.5
0;KZ75125KZT2069101999;2017-01-12;-331;-331;-165.5;9;4.5;EUR;null;null;-340;-170;0.5
0;KZ75125KZT2069101999;2017-01-13;-272;-272;-136;59;29.5;EUR;null;null;-331;-165.5;0.5
0;KZ75125KZT2069101999;2017-01-14;-173;-173;-86.5;99;49.5;EUR;null;null;-272;-136;0.5
0;KZ75125KZT2069101999;2017-01-15;-144;-144;-72;29;14.5;EUR;null;null;-173;-86.5;0.5
0;KZ75125KZT2069101999;2017-01-16;-161;-161;-80.5;null;null;EUR;17;8.5;-144;-72;0.5
0;KZ75125KZT2069101999;2017-01-17;-64;-64;-32;97;48.5;EUR;null;null;-161;-80.5;0.5
0;KZ75125KZT2069101999;2017-01-18;-31;-31;-15.5;33;16.5;EUR;null;null;-64;-32;0.5
0;KZ75125KZT2069101999;2017-01-19;-80;-80;-40;null;null;EUR;49;24.5;-31;-15.5;0.5
0;KZ75125KZT2069101999;2017-01-20;-73;-73;-36.5;7;3.5;EUR;null;null;-80;-40;0.5
0;KZ75125KZT2069101999;2017-01-21;-123;-123;-61.5;null;null;EUR;50;25;-73;-36.5;0.5
0;KZ75125KZT2069101999;2017-01-22;-144;-144;-72;null;null;EUR;21;10.5;-123;-61.5;0.5
0;KZ75125KZT2069101999;2017-01-23;-155;-155;-77.5;null;null;EUR;11;5.5;-144;-72;0.5
0;KZ75125KZT2069101999;2017-01-24;-96;-96;-48;59;29.5;EUR;null;null;-155;-77.5;0.5
0;KZ75125KZT2069101999;2017-01-25;-74;-74;-37;22;11;EUR;null;null;-96;-48;0.5
0;KZ75125KZT2069101999;2017-01-26;11;11;5.5;85;42.5;EUR;null;null;-74;-37;0.5
0;KZ75125KZT2069101999;2017-01-27;56;56;28;45;22.5;EUR;null;null;11;5.5;0.5
0;KZ75125KZT2069101999;2017-01-28;118;118;59;62;31;EUR;null;null;56;28;0.5
0;KZ75125KZT2069101999;2017-01-29;57;57;28.5;null;null;EUR;61;30.5;118;59;0.5
0;KZ75125KZT2069101999;2017-01-30;-40;-40;-20;null;null;EUR;97;48.5;57;28.5;0.5
0;KZ75125KZT2069101999;2017-01-31;12;12;6;52;26;EUR;null;null;-40;-20;0.5
0;KZ75125KZT2069101999;2017-02-01;37;37;18.5;25;12.5;EUR;null;null;12;6;0.5
0;KZ75125KZT2069101999;2017-02-02;110;110;55;73;36.5;EUR;null;null;37;18.5;0.5
0;KZ75125KZT2069101999;2017-02-03;120;120;60;10;5;EUR;null;null;110;55;0.5
0;KZ75125KZT2069101999;2017-02-04;131;131;65.5;11;5.5;EUR;null;null;120;60;0.5
0;KZ75125KZT2069101999;2017-02-05;181;181;90.5;50;25;EUR;null;null;131;65.5;0.5
0;KZ75125KZT2069101999;2017-02-06;248;248;124;67;33.5;EUR;null;null;181;90.5;0.5
0;KZ75125KZT2069101999;2017-02-07;205;205;102.5;null;null;EUR;43;21.5;248;124;0.5
0;KZ75125KZT2069101999;2017-02-08;161;161;80.5;null;null;EUR;44;22;205;102.5;0.5
0;KZ75125KZT2069101999;2017-02-09;119;119;59.5;null;null;EUR;42;21;161;80.5;0.5
0;KZ75125KZT2069101999;2017-02-10;65;65;32.5;null;null;EUR;54;27;119;59.5;0.5
0;KZ75125KZT2069101999;2017-02-11;27;27;13.5;null;null;EUR;38;19;65;32.5;0.5
0;KZ75125KZT2069101999;2017-02-12;117;117;58.5;90;45;EUR;null;null;27;13.5;0.5
0;KZ75125KZT2069101999;2017-02-13;207;207;103.5;90;45;EUR;null;null;117;58.5;0.5
0;KZ75125KZT2069101999;2017-02-14;191;191;95.5;null;null;EUR;16;8;207;103.5;0.5
0;KZ75125KZT2069101999;2017-02-15;141;141;70.5;null;null;EUR;50;25;191;95.5;0.5
0;KZ75125KZT2069101999;2017-02-16;83;83;41.5;null;null;EUR;58;29;141;70.5;0.5
0;KZ75125KZT2069101999;2017-02-17;163;163;81.5;80;40;EUR;null;null;83;41.5;0.5
0;KZ75125KZT2069101999;2017-02-18;133;133;66.5;null;null;EUR;30;15;163;81.5;0.5
0;KZ75125KZT2069101999;2017-02-19;200;200;100;67;33.5;EUR;null;null;133;66.5;0.5
0;KZ75125KZT2069101999;2017-02-20;227;227;113.5;27;13.5;EUR;null;null;200;100;0.5
0;KZ75125KZT2069101999;2017-02-21;188;188;94;null;null;EUR;39;19.5;227;113.5;0.5
0;KZ75125KZT2069101999;2017-02-22;242;242;121;54;27;EUR;null;null;188;94;0.5
0;KZ75125KZT2069101999;2017-02-23;323;323;161.5;81;40.5;EUR;null;null;242;121;0.5
0;KZ75125KZT2069101999;2017-02-24;357;357;178.5;34;17;EUR;null;null;323;161.5;0.5
0;KZ75125KZT2069101999;2017-02-25;332;332;166;null;null;EUR;25;12.5;357;178.5;0.5
0;KZ75125KZT2069101999;2017-02-26;291;291;145.5;null;null;EUR;41;20.5;332;166;0.5
0;KZ75125KZT2069101999;2017-02-27;303;303;151.5;12;6;EUR;null;null;291;145.5;0.5
0;KZ75125KZT2069101999;2017-02-28;326;326;163;23;11.5;EUR;null;null;303;151.5;0.5
0;KZ75125KZT2069101999;2017-03-01;316;316;158;null;null;EUR;10;5;326;163;0.5
0;KZ75125KZT2069101999;2017-03-02;238;238;119;null;null;EUR;78;39;316;158;0.5
0;KZ75125KZT2069101999;2017-03-03;207;207;103.5;null;null;EUR;31;15.5;238;119;0.5
0;KZ75125KZT2069101999;2017-03-04;112;112;56;null;null;EUR;95;47.5;207;103.5;0.5
0;KZ75125KZT2069101999;2017-03-05;87;87;43.5;null;null;EUR;25;12.5;112;56;0.5
0;KZ75125KZT2069101999;2017-03-06;98;98;49;11;5.5;EUR;null;null;87;43.5;0.5
0;KZ75125KZT2069101999;2017-03-07;153;153;76.5;55;27.5;EUR;null;null;98;49;0.5
0;KZ75125KZT2069101999;2017-03-08;193;193;96.5;40;20;EUR;null;null;153;76.5;0.5
0;KZ75125KZT2069101999;2017-03-09;287;287;143.5;94;47;EUR;null;null;193;96.5;0.5
0;KZ75125KZT2069101999;2017-03-10;374;374;187;87;43.5;EUR;null;null;287;143.5;0.5
0;KZ75125KZT2069101999;2017-03-11;401;401;200.5;27;13.5;EUR;null;null;374;187;0.5
0;KZ75125KZT2069101999;2017-03-12;410;410;205;9;4.5;EUR;null;null;401;200.5;0.5
0;KZ75125KZT2069101999;2017-03-13;328;328;164;null;null;EUR;82;41;410;205;0.5
0;KZ75125KZT2069101999;2017-03-14;332;332;166;4;2;EUR;null;null;328;164;0.5
0;KZ75125KZT2069101999;2017-03-15;331;331;165.5;null;null;EUR;1;0.5;332;166;0.5
0;KZ75125KZT2069101999;2017-03-16;378;378;189;47;23.5;EUR;null;null;331;165.5;0.5
0;KZ75125KZT2069101999;2017-03-17;429;429;214.5;51;25.5;EUR;null;null;378;189;0.5
0;KZ75125KZT2069101999;2017-03-18;429;429;214.5;null;null;EUR;0;0;429;214.5;0.5
0;KZ75125KZT2069101999;2017-03-19;516;516;258;87;43.5;EUR;null;null;429;214.5;0.5
0;KZ75125KZT2069101999;2017-03-20;426;426;213;null;null;EUR;90;45;516;258;0.5
0;KZ75125KZT2069101999;2017-03-21;496;496;248;70;35;EUR;null;null;426;213;0.5
0;KZ75125KZT2069101999;2017-03-22;434;434;217;null;null;EUR;62;31;496;248;0.5
0;KZ75125KZT2069101999;2017-03-23;346;346;173;null;null;EUR;88;44;434;217;0.5
0;KZ75125KZT2069101999;2017-03-24;400;400;200;54;27;EUR;null;null;346;173;0.5
0;KZ75125KZT2069101999;2017-03-25;346;346;173;null;null;EUR;54;27;400;200;0.5
0;KZ75125KZT2069101999;2017-03-26;270;270;135;null;null;EUR;76;38;346;173;0.5
0;KZ75125KZT2069101999;2017-03-27;198;198;99;null;null;EUR;72;36;270;135;0.5
0;KZ75125KZT2069101999;2017-03-28;137;137;68.5;null;null;EUR;61;30.5;198;99;0.5
0;KZ75125KZT2069101999;2017-03-29;45;45;22.5;null;null;EUR;92;46;137;68.5;0.5
0;KZ75125KZT2069101999;2017-03-30;25;25;12.5;null;null;EUR;20;10;45;22.5;0.5
0;KZ75125KZT2069101999;2017-03-31;59;59;29.5;34;17;EUR;null;null;25;12.5;0.5
0;KZ75125KZT2069101999;2017-04-01;79;79;39.5;20;10;EUR;null;null;59;29.5;0.5
0;KZ75125KZT2069101999;2017-04-02;82;82;41;3;1.5;EUR;null;null;79;39.5;0.5
0;KZ75125KZT2069101999;2017-04-03;59;59;29.5;null;null;EUR;23;11.5;82;41;0.5
0;KZ75125KZT2069101999;2017-04-04;-26;-26;-13;null;null;EUR;85;42.5;59;29.5;0.5
0;KZ75125KZT2069101999;2017-04-05;10;10;5;36;18;EUR;null;null;-26;-13;0.5
0;KZ75125KZT2069101999;2017-04-06;66;66;33;56;28;EUR;null;null;10;5;0.5
0;KZ75125KZT2069101999;2017-04-07;147;147;73.5;81;40.5;EUR;null;null;66;33;0.5
0;KZ75125KZT2069101999;2017-04-08;93;93;46.5;null;null;EUR;54;27;147;73.5;0.5
0;KZ75125KZT2069101999;2017-04-09;70;70;35;null;null;EUR;23;11.5;93;46.5;0.5
0;KZ75125KZT2069101999;2017-04-10;124;124;62;54;27;EUR;null;null;70;35;0.5
0;KZ75125KZT2069101999;2017-04-11;30;30;15;null;null;EUR;94;47;124;62;0.5
0;KZ75125KZT2069101999;2017-04-12;-26;-26;-13;null;null;EUR;56;28;30;15;0.5
0;KZ75125KZT2069101999;2017-04-13;-15;-15;-7.5;11;5.5;EUR;null;null;-26;-13;0.5
0;KZ75125KZT2069101999;2017-04-14;-19;-19;-9.5;null;null;EUR;4;2;-15;-7.5;0.5
0;KZ75125KZT2069101999;2017-04-15;74;74;37;93;46.5;EUR;null;null;-19;-9.5;0.5
0;KZ75125KZT2069101999;2017-04-16;12;12;6;null;null;EUR;62;31;74;37;0.5
0;KZ75125KZT2069101999;2017-04-17;-28;-28;-14;null;null;EUR;40;20;12;6;0.5
0;KZ75125KZT2069101999;2017-04-18;-116;-116;-58;null;null;EUR;88;44;-28;-14;0.5
0;KZ75125KZT2069101999;2017-04-19;-35;-35;-17.5;81;40.5;EUR;null;null;-116;-58;0.5
0;KZ75125KZT2069101999;2017-04-20;-96;-96;-48;null;null;EUR;61;30.5;-35;-17.5;0.5
0;KZ75125KZT2069101999;2017-04-21;-139;-139;-69.5;null;null;EUR;43;21.5;-96;-48;0.5
0;KZ75125KZT2069101999;2017-04-22;-223;-223;-111.5;null;null;EUR;84;42;-139;-69.5;0.5
0;KZ75125KZT2069101999;2017-04-23;-267;-267;-133.5;null;null;EUR;44;22;-223;-111.5;0.5
0;KZ75125KZT2069101999;2017-04-24;-290;-290;-145;null;null;EUR;23;11.5;-267;-133.5;0.5
0;KZ75125KZT2069101999;2017-04-25;-290;-290;-145;null;null;EUR;0;0;-290;-145;0.5
0;KZ75125KZT2069101999;2017-04-26;-258;-258;-129;32;16;EUR;null;null;-290;-145;0.5
0;KZ75125KZT2069101999;2017-04-27;-258;-258;-129;null;null;EUR;0;0;-258;-129;0.5
0;KZ75125KZT2069101999;2017-04-28;-230;-230;-115;28;14;EUR;null;null;-258;-129;0.5
0;KZ75125KZT2069101999;2017-04-29;-251;-251;-125.5;null;null;EUR;21;10.5;-230;-115;0.5
0;KZ75125KZT2069101999;2017-04-30;-233;-233;-116.5;18;9;EUR;null;null;-251;-125.5;0.5
0;KZ75125KZT2069101999;2017-05-01;-233;-233;-116.5;null;null;EUR;0;0;-233;-116.5;0.5
0;KZ75125KZT2069101999;2017-05-02;-149;-149;-74.5;84;42;EUR;null;null;-233;-116.5;0.5
0;KZ75125KZT2069101999;2017-05-03;-102;-102;-51;47;23.5;EUR;null;null;-149;-74.5;0.5
0;KZ75125KZT2069101999;2017-05-04;-54;-54;-27;48;24;EUR;null;null;-102;-51;0.5
0;KZ75125KZT2069101999;2017-05-05;-2;-2;-1;52;26;EUR;null;null;-54;-27;0.5
0;KZ75125KZT2069101999;2017-05-06;-40;-40;-20;null;null;EUR;38;19;-2;-1;0.5
0;KZ75125KZT2069101999;2017-05-07;11;11;5.5;51;25.5;EUR;null;null;-40;-20;0.5
0;KZ75125KZT2069101999;2017-05-08;3;3;1.5;null;null;EUR;8;4;11;5.5;0.5
0;KZ75125KZT2069101999;2017-05-09;38;38;19;35;17.5;EUR;null;null;3;1.5;0.5
0;KZ75125KZT2069101999;2017-05-10;69;69;34.5;31;15.5;EUR;null;null;38;19;0.5
0;KZ75125KZT2069101999;2017-05-11;42;42;21;null;null;EUR;27;13.5;69;34.5;0.5
0;KZ75125KZT2069101999;2017-05-12;49;49;24.5;7;3.5;EUR;null;null;42;21;0.5
0;KZ75125KZT2069101999;2017-05-13;11;11;5.5;null;null;EUR;38;19;49;24.5;0.5
0;KZ75125KZT2069101999;2017-05-14;-31;-31;-15.5;null;null;EUR;42;21;11;5.5;0.5
0;KZ75125KZT2069101999;2017-05-15;48;48;24;79;39.5;EUR;null;null;-31;-15.5;0.5
0;KZ75125KZT2069101999;2017-05-16;48;48;24;null;null;EUR;0;0;48;24;0.5
0;KZ75125KZT2069101999;2017-05-17;6;6;3;null;null;EUR;42;21;48;24;0.5
0;KZ75125KZT2069101999;2017-05-18;73;73;36.5;67;33.5;EUR;null;null;6;3;0.5
0;KZ75125KZT2069101999;2017-05-19;130;130;65;57;28.5;EUR;null;null;73;36.5;0.5
0;KZ75125KZT2069101999;2017-05-20;168;168;84;38;19;EUR;null;null;130;65;0.5
0;KZ75125KZT2069101999;2017-05-21;114;114;57;null;null;EUR;54;27;168;84;0.5
0;KZ75125KZT2069101999;2017-05-22;179;179;89.5;65;32.5;EUR;null;null;114;57;0.5
0;KZ75125KZT2069101999;2017-05-23;242;242;121;63;31.5;EUR;null;null;179;89.5;0.5
0;KZ75125KZT2069101999;2017-05-24;292;292;146;50;25;EUR;null;null;242;121;0.5
0;KZ75125KZT2069101999;2017-05-25;329;329;164.5;37;18.5;EUR;null;null;292;146;0.5
0;KZ75125KZT2069101999;2017-05-26;416;416;208;87;43.5;EUR;null;null;329;164.5;0.5
0;KZ75125KZT2069101999;2017-05-27;409;409;204.5;null;null;EUR;7;3.5;416;208;0.5
0;KZ75125KZT2069101999;2017-05-28;387;387;193.5;null;null;EUR;22;11;409;204.5;0.5
0;KZ75125KZT2069101999;2017-05-29;295;295;147.5;null;null;EUR;92;46;387;193.5;0.5
0;KZ75125KZT2069101999;2017-05-30;239;239;119.5;null;null;EUR;56;28;295;147.5;0.5
0;KZ75125KZT2069101999;2017-05-31;189;189;94.5;null;null;EUR;50;25;239;119.5;0.5
0;KZ75125KZT2069101999;2017-06-01;174;174;87;null;null;EUR;15;7.5;189;94.5;0.5
0;KZ75125KZT2069101999;2017-06-02;126;126;63;null;null;EUR;48;24;174;87;0.5
0;KZ75125KZT2069101999;2017-06-03;181;181;90.5;55;27.5;EUR;null;null;126;63;0.5
0;KZ75125KZT2069101999;2017-06-04;264;264;132;83;41.5;EUR;null;null;181;90.5;0.5
0;KZ75125KZT2069101999;2017-06-05;217;217;108.5;null;null;EUR;47;23.5;264;132;0.5
0;KZ75125KZT2069101999;2017-06-06;226;226;113;9;4.5;EUR;null;null;217;108.5;0.5
0;KZ75125KZT2069101999;2017-06-07;225;225;112.5;null;null;EUR;1;0.5;226;113;0.5
0;KZ75125KZT2069101999;2017-06-08;207;207;103.5;null;null;EUR;18;9;225;112.5;0.5
0;KZ75125KZT2069101999;2017-06-09;227;227;113.5;20;10;EUR;null;null;207;103.5;0.5
0;KZ75125KZT2069101999;2017-06-10;224;224;112;null;null;EUR;3;1.5;227;113.5;0.5
0;KZ75125KZT2069101999;2017-06-11;201;201;100.5;null;null;EUR;23;11.5;224;112;0.5
0;KZ75125KZT2069101999;2017-06-12;201;201;100.5;null;null;EUR;0;0;201;100.5;0.5
0;KZ75125KZT2069101100;2015-05-11;85;85;85;null;null;KZT;15;15;100;100;1
0;KZ75125KZT2069101100;2015-05-12;110;110;110;25;25;KZT;null;null;85;85;1
0;KZ75125KZT2069101100;2015-05-13;39;39;39;null;null;KZT;71;71;110;110;1
0;KZ75125KZT2069101100;2015-05-14;46;46;46;7;7;KZT;null;null;39;39;1
0;KZ75125KZT2069101100;2015-05-15;73;73;73;27;27;KZT;null;null;46;46;1
0;KZ75125KZT2069101100;2015-05-16;124;124;124;51;51;KZT;null;null;73;73;1
0;KZ75125KZT2069101100;2015-05-17;83;83;83;null;null;KZT;41;41;124;124;1
0;KZ75125KZT2069101100;2015-05-18;165;165;165;82;82;KZT;null;null;83;83;1
0;KZ75125KZT2069101100;2015-05-19;248;248;248;83;83;KZT;null;null;165;165;1
0;KZ75125KZT2069101100;2015-05-20;193;193;193;null;null;KZT;55;55;248;248;1
0;KZ75125KZT2069101100;2015-05-21;286;286;286;93;93;KZT;null;null;193;193;1
0;KZ75125KZT2069101100;2015-05-22;355;355;355;69;69;KZT;null;null;286;286;1
0;KZ75125KZT2069101100;2015-05-23;297;297;297;null;null;KZT;58;58;355;355;1
0;KZ75125KZT2069101100;2015-05-24;334;334;334;37;37;KZT;null;null;297;297;1
0;KZ75125KZT2069101100;2015-05-25;271;271;271;null;null;KZT;63;63;334;334;1
0;KZ75125KZT2069101100;2015-05-26;274;274;274;3;3;KZT;null;null;271;271;1
0;KZ75125KZT2069101100;2015-05-27;283;283;283;9;9;KZT;null;null;274;274;1
0;KZ75125KZT2069101100;2015-05-28;186;186;186;null;null;KZT;97;97;283;283;1
0;KZ75125KZT2069101100;2015-05-29;242;242;242;56;56;KZT;null;null;186;186;1
0;KZ75125KZT2069101100;2015-05-30;281;281;281;39;39;KZT;null;null;242;242;1
0;KZ75125KZT2069101100;2015-05-31;293;293;293;12;12;KZT;null;null;281;281;1
0;KZ75125KZT2069101100;2015-06-01;218;218;218;null;null;KZT;75;75;293;293;1
0;KZ75125KZT2069101100;2015-06-02;120;120;120;null;null;KZT;98;98;218;218;1
0;KZ75125KZT2069101100;2015-06-03;48;48;48;null;null;KZT;72;72;120;120;1
0;KZ75125KZT2069101100;2015-06-04;127;127;127;79;79;KZT;null;null;48;48;1
0;KZ75125KZT2069101100;2015-06-05;154;154;154;27;27;KZT;null;null;127;127;1
0;KZ75125KZT2069101100;2015-06-06;177;177;177;23;23;KZT;null;null;154;154;1
0;KZ75125KZT2069101100;2015-06-07;95;95;95;null;null;KZT;82;82;177;177;1
0;KZ75125KZT2069101100;2015-06-08;84;84;84;null;null;KZT;11;11;95;95;1
0;KZ75125KZT2069101100;2015-06-09;37;37;37;null;null;KZT;47;47;84;84;1
0;KZ75125KZT2069101100;2015-06-10;-38;-38;-38;null;null;KZT;75;75;37;37;1
0;KZ75125KZT2069101100;2015-06-11;32;32;32;70;70;KZT;null;null;-38;-38;1
0;KZ75125KZT2069101100;2015-06-12;108;108;108;76;76;KZT;null;null;32;32;1
0;KZ75125KZT2069101100;2015-06-13;79;79;79;null;null;KZT;29;29;108;108;1
0;KZ75125KZT2069101100;2015-06-14;102;102;102;23;23;KZT;null;null;79;79;1
0;KZ75125KZT2069101100;2015-06-15;159;159;159;57;57;KZT;null;null;102;102;1
0;KZ75125KZT2069101100;2015-06-16;176;176;176;17;17;KZT;null;null;159;159;1
0;KZ75125KZT2069101100;2015-06-17;173;173;173;null;null;KZT;3;3;176;176;1
0;KZ75125KZT2069101100;2015-06-18;267;267;267;94;94;KZT;null;null;173;173;1
0;KZ75125KZT2069101100;2015-06-19;334;334;334;67;67;KZT;null;null;267;267;1
0;KZ75125KZT2069101100;2015-06-20;285;285;285;null;null;KZT;49;49;334;334;1
0;KZ75125KZT2069101100;2015-06-21;292;292;292;7;7;KZT;null;null;285;285;1
0;KZ75125KZT2069101100;2015-06-22;362;362;362;70;70;KZT;null;null;292;292;1
0;KZ75125KZT2069101100;2015-06-23;400;400;400;38;38;KZT;null;null;362;362;1
0;KZ75125KZT2069101100;2015-06-24;496;496;496;96;96;KZT;null;null;400;400;1
0;KZ75125KZT2069101100;2015-06-25;561;561;561;65;65;KZT;null;null;496;496;1
0;KZ75125KZT2069101100;2015-06-26;538;538;538;null;null;KZT;23;23;561;561;1
0;KZ75125KZT2069101100;2015-06-27;529;529;529;null;null;KZT;9;9;538;538;1
0;KZ75125KZT2069101100;2015-06-28;603;603;603;74;74;KZT;null;null;529;529;1
0;KZ75125KZT2069101100;2015-06-29;586;586;586;null;null;KZT;17;17;603;603;1
0;KZ75125KZT2069101100;2015-06-30;595;595;595;9;9;KZT;null;null;586;586;1
0;KZ75125KZT2069101100;2015-07-01;543;543;543;null;null;KZT;52;52;595;595;1
0;KZ75125KZT2069101100;2015-07-02;464;464;464;null;null;KZT;79;79;543;543;1
0;KZ75125KZT2069101100;2015-07-03;415;415;415;null;null;KZT;49;49;464;464;1
0;KZ75125KZT2069101100;2015-07-04;423;423;423;8;8;KZT;null;null;415;415;1
0;KZ75125KZT2069101100;2015-07-05;325;325;325;null;null;KZT;98;98;423;423;1
0;KZ75125KZT2069101100;2015-07-06;357;357;357;32;32;KZT;null;null;325;325;1
0;KZ75125KZT2069101100;2015-07-07;437;437;437;80;80;KZT;null;null;357;357;1
0;KZ75125KZT2069101100;2015-07-08;475;475;475;38;38;KZT;null;null;437;437;1
0;KZ75125KZT2069101100;2015-07-09;567;567;567;92;92;KZT;null;null;475;475;1
0;KZ75125KZT2069101100;2015-07-10;643;643;643;76;76;KZT;null;null;567;567;1
0;KZ75125KZT2069101100;2015-07-11;548;548;548;null;null;KZT;95;95;643;643;1
0;KZ75125KZT2069101100;2015-07-12;476;476;476;null;null;KZT;72;72;548;548;1
0;KZ75125KZT2069101100;2015-07-13;562;562;562;86;86;KZT;null;null;476;476;1
0;KZ75125KZT2069101100;2015-07-14;565;565;565;3;3;KZT;null;null;562;562;1
0;KZ75125KZT2069101100;2015-07-15;569;569;569;4;4;KZT;null;null;565;565;1
0;KZ75125KZT2069101100;2015-07-16;648;648;648;79;79;KZT;null;null;569;569;1
0;KZ75125KZT2069101100;2015-07-17;652;652;652;4;4;KZT;null;null;648;648;1
0;KZ75125KZT2069101100;2015-07-18;596;596;596;null;null;KZT;56;56;652;652;1
0;KZ75125KZT2069101100;2015-07-19;686;686;686;90;90;KZT;null;null;596;596;1
0;KZ75125KZT2069101100;2015-07-20;649;649;649;null;null;KZT;37;37;686;686;1
0;KZ75125KZT2069101100;2015-07-21;610;610;610;null;null;KZT;39;39;649;649;1
0;KZ75125KZT2069101100;2015-07-22;638;638;638;28;28;KZT;null;null;610;610;1
0;KZ75125KZT2069101100;2015-07-23;669;669;669;31;31;KZT;null;null;638;638;1
0;KZ75125KZT2069101100;2015-07-24;755;755;755;86;86;KZT;null;null;669;669;1
0;KZ75125KZT2069101100;2015-07-25;810;810;810;55;55;KZT;null;null;755;755;1
0;KZ75125KZT2069101100;2015-07-26;729;729;729;null;null;KZT;81;81;810;810;1
0;KZ75125KZT2069101100;2015-07-27;694;694;694;null;null;KZT;35;35;729;729;1
0;KZ75125KZT2069101100;2015-07-28;672;672;672;null;null;KZT;22;22;694;694;1
0;KZ75125KZT2069101100;2015-07-29;759;759;759;87;87;KZT;null;null;672;672;1
0;KZ75125KZT2069101100;2015-07-30;682;682;682;null;null;KZT;77;77;759;759;1
0;KZ75125KZT2069101100;2015-07-31;718;718;718;36;36;KZT;null;null;682;682;1
0;KZ75125KZT2069101100;2015-08-01;700;700;700;null;null;KZT;18;18;718;718;1
0;KZ75125KZT2069101100;2015-08-02;750;750;750;50;50;KZT;null;null;700;700;1
0;KZ75125KZT2069101100;2015-08-03;799;799;799;49;49;KZT;null;null;750;750;1
0;KZ75125KZT2069101100;2015-08-04;833;833;833;34;34;KZT;null;null;799;799;1
0;KZ75125KZT2069101100;2015-08-05;834;834;834;1;1;KZT;null;null;833;833;1
0;KZ75125KZT2069101100;2015-08-06;834;834;834;null;null;KZT;0;0;834;834;1
0;KZ75125KZT2069101100;2015-08-07;840;840;840;6;6;KZT;null;null;834;834;1
0;KZ75125KZT2069101100;2015-08-08;890;890;890;50;50;KZT;null;null;840;840;1
0;KZ75125KZT2069101100;2015-08-09;884;884;884;null;null;KZT;6;6;890;890;1
0;KZ75125KZT2069101100;2015-08-10;897;897;897;13;13;KZT;null;null;884;884;1
0;KZ75125KZT2069101100;2015-08-11;888;888;888;null;null;KZT;9;9;897;897;1
0;KZ75125KZT2069101100;2015-08-12;955;955;955;67;67;KZT;null;null;888;888;1
0;KZ75125KZT2069101100;2015-08-13;976;976;976;21;21;KZT;null;null;955;955;1
0;KZ75125KZT2069101100;2015-08-14;943;943;943;null;null;KZT;33;33;976;976;1
0;KZ75125KZT2069101100;2015-08-15;874;874;874;null;null;KZT;69;69;943;943;1
0;KZ75125KZT2069101100;2015-08-16;823;823;823;null;null;KZT;51;51;874;874;1
0;KZ75125KZT2069101100;2015-08-17;824;824;824;1;1;KZT;null;null;823;823;1
0;KZ75125KZT2069101100;2015-08-18;859;859;859;35;35;KZT;null;null;824;824;1
0;KZ75125KZT2069101100;2015-08-19;920;920;920;61;61;KZT;null;null;859;859;1
0;KZ75125KZT2069101100;2015-08-20;990;990;990;70;70;KZT;null;null;920;920;1
0;KZ75125KZT2069101100;2015-08-21;981;981;981;null;null;KZT;9;9;990;990;1
0;KZ75125KZT2069101100;2015-08-22;1080;1080;1080;99;99;KZT;null;null;981;981;1
0;KZ75125KZT2069101100;2015-08-23;1148;1148;1148;68;68;KZT;null;null;1080;1080;1
0;KZ75125KZT2069101100;2015-08-24;1072;1072;1072;null;null;KZT;76;76;1148;1148;1
0;KZ75125KZT2069101100;2015-08-25;1020;1020;1020;null;null;KZT;52;52;1072;1072;1
0;KZ75125KZT2069101100;2015-08-26;1115;1115;1115;95;95;KZT;null;null;1020;1020;1
0;KZ75125KZT2069101100;2015-08-27;1136;1136;1136;21;21;KZT;null;null;1115;1115;1
0;KZ75125KZT2069101100;2015-08-28;1166;1166;1166;30;30;KZT;null;null;1136;1136;1
0;KZ75125KZT2069101100;2015-08-29;1188;1188;1188;22;22;KZT;null;null;1166;1166;1
0;KZ75125KZT2069101100;2015-08-30;1223;1223;1223;35;35;KZT;null;null;1188;1188;1
0;KZ75125KZT2069101100;2015-08-31;1270;1270;1270;47;47;KZT;null;null;1223;1223;1
0;KZ75125KZT2069101100;2015-09-01;1319;1319;1319;49;49;KZT;null;null;1270;1270;1
0;KZ75125KZT2069101100;2015-09-02;1338;1338;1338;19;19;KZT;null;null;1319;1319;1
0;KZ75125KZT2069101100;2015-09-03;1365;1365;1365;27;27;KZT;null;null;1338;1338;1
0;KZ75125KZT2069101100;2015-09-04;1406;1406;1406;41;41;KZT;null;null;1365;1365;1
0;KZ75125KZT2069101100;2015-09-05;1452;1452;1452;46;46;KZT;null;null;1406;1406;1
0;KZ75125KZT2069101100;2015-09-06;1458;1458;1458;6;6;KZT;null;null;1452;1452;1
0;KZ75125KZT2069101100;2015-09-07;1543;1543;1543;85;85;KZT;null;null;1458;1458;1
0;KZ75125KZT2069101100;2015-09-08;1532;1532;1532;null;null;KZT;11;11;1543;1543;1
0;KZ75125KZT2069101100;2015-09-09;1624;1624;1624;92;92;KZT;null;null;1532;1532;1
0;KZ75125KZT2069101100;2015-09-10;1601;1601;1601;null;null;KZT;23;23;1624;1624;1
0;KZ75125KZT2069101100;2015-09-11;1644;1644;1644;43;43;KZT;null;null;1601;1601;1
0;KZ75125KZT2069101100;2015-09-12;1634;1634;1634;null;null;KZT;10;10;1644;1644;1
0;KZ75125KZT2069101100;2015-09-13;1550;1550;1550;null;null;KZT;84;84;1634;1634;1
0;KZ75125KZT2069101100;2015-09-14;1498;1498;1498;null;null;KZT;52;52;1550;1550;1
0;KZ75125KZT2069101100;2015-09-15;1499;1499;1499;1;1;KZT;null;null;1498;1498;1
0;KZ75125KZT2069101100;2015-09-16;1429;1429;1429;null;null;KZT;70;70;1499;1499;1
0;KZ75125KZT2069101100;2015-09-17;1396;1396;1396;null;null;KZT;33;33;1429;1429;1
0;KZ75125KZT2069101100;2015-09-18;1419;1419;1419;23;23;KZT;null;null;1396;1396;1
0;KZ75125KZT2069101100;2015-09-19;1505;1505;1505;86;86;KZT;null;null;1419;1419;1
0;KZ75125KZT2069101100;2015-09-20;1508;1508;1508;3;3;KZT;null;null;1505;1505;1
0;KZ75125KZT2069101100;2015-09-21;1429;1429;1429;null;null;KZT;79;79;1508;1508;1
0;KZ75125KZT2069101100;2015-09-22;1363;1363;1363;null;null;KZT;66;66;1429;1429;1
0;KZ75125KZT2069101100;2015-09-23;1305;1305;1305;null;null;KZT;58;58;1363;1363;1
0;KZ75125KZT2069101100;2015-09-24;1216;1216;1216;null;null;KZT;89;89;1305;1305;1
0;KZ75125KZT2069101100;2015-09-25;1307;1307;1307;91;91;KZT;null;null;1216;1216;1
0;KZ75125KZT2069101100;2015-09-26;1395;1395;1395;88;88;KZT;null;null;1307;1307;1
0;KZ75125KZT2069101100;2015-09-27;1315;1315;1315;null;null;KZT;80;80;1395;1395;1
0;KZ75125KZT2069101100;2015-09-28;1299;1299;1299;null;null;KZT;16;16;1315;1315;1
0;KZ75125KZT2069101100;2015-09-29;1289;1289;1289;null;null;KZT;10;10;1299;1299;1
0;KZ75125KZT2069101100;2015-09-30;1243;1243;1243;null;null;KZT;46;46;1289;1289;1
0;KZ75125KZT2069101100;2015-10-01;1323;1323;1323;80;80;KZT;null;null;1243;1243;1
0;KZ75125KZT2069101100;2015-10-02;1403;1403;1403;80;80;KZT;null;null;1323;1323;1
0;KZ75125KZT2069101100;2015-10-03;1363;1363;1363;null;null;KZT;40;40;1403;1403;1
0;KZ75125KZT2069101100;2015-10-04;1382;1382;1382;19;19;KZT;null;null;1363;1363;1
0;KZ75125KZT2069101100;2015-10-05;1308;1308;1308;null;null;KZT;74;74;1382;1382;1
0;KZ75125KZT2069101100;2015-10-06;1367;1367;1367;59;59;KZT;null;null;1308;1308;1
0;KZ75125KZT2069101100;2015-10-07;1418;1418;1418;51;51;KZT;null;null;1367;1367;1
0;KZ75125KZT2069101100;2015-10-08;1384;1384;1384;null;null;KZT;34;34;1418;1418;1
0;KZ75125KZT2069101100;2015-10-09;1336;1336;1336;null;null;KZT;48;48;1384;1384;1
0;KZ75125KZT2069101100;2015-10-10;1351;1351;1351;15;15;KZT;null;null;1336;1336;1
0;KZ75125KZT2069101100;2015-10-11;1404;1404;1404;53;53;KZT;null;null;1351;1351;1
0;KZ75125KZT2069101100;2015-10-12;1464;1464;1464;60;60;KZT;null;null;1404;1404;1
0;KZ75125KZT2069101100;2015-10-13;1500;1500;1500;36;36;KZT;null;null;1464;1464;1
0;KZ75125KZT2069101100;2015-10-14;1473;1473;1473;null;null;KZT;27;27;1500;1500;1
0;KZ75125KZT2069101100;2015-10-15;1551;1551;1551;78;78;KZT;null;null;1473;1473;1
0;KZ75125KZT2069101100;2015-10-16;1479;1479;1479;null;null;KZT;72;72;1551;1551;1
0;KZ75125KZT2069101100;2015-10-17;1552;1552;1552;73;73;KZT;null;null;1479;1479;1
0;KZ75125KZT2069101100;2015-10-18;1649;1649;1649;97;97;KZT;null;null;1552;1552;1
0;KZ75125KZT2069101100;2015-10-19;1594;1594;1594;null;null;KZT;55;55;1649;1649;1
0;KZ75125KZT2069101100;2015-10-20;1604;1604;1604;10;10;KZT;null;null;1594;1594;1
0;KZ75125KZT2069101100;2015-10-21;1651;1651;1651;47;47;KZT;null;null;1604;1604;1
0;KZ75125KZT2069101100;2015-10-22;1579;1579;1579;null;null;KZT;72;72;1651;1651;1
0;KZ75125KZT2069101100;2015-10-23;1514;1514;1514;null;null;KZT;65;65;1579;1579;1
0;KZ75125KZT2069101100;2015-10-24;1424;1424;1424;null;null;KZT;90;90;1514;1514;1
0;KZ75125KZT2069101100;2015-10-25;1460;1460;1460;36;36;KZT;null;null;1424;1424;1
0;KZ75125KZT2069101100;2015-10-26;1518;1518;1518;58;58;KZT;null;null;1460;1460;1
0;KZ75125KZT2069101100;2015-10-27;1507;1507;1507;null;null;KZT;11;11;1518;1518;1
0;KZ75125KZT2069101100;2015-10-28;1449;1449;1449;null;null;KZT;58;58;1507;1507;1
0;KZ75125KZT2069101100;2015-10-29;1488;1488;1488;39;39;KZT;null;null;1449;1449;1
0;KZ75125KZT2069101100;2015-10-30;1446;1446;1446;null;null;KZT;42;42;1488;1488;1
0;KZ75125KZT2069101100;2015-10-31;1461;1461;1461;15;15;KZT;null;null;1446;1446;1
0;KZ75125KZT2069101100;2015-11-01;1540;1540;1540;79;79;KZT;null;null;1461;1461;1
0;KZ75125KZT2069101100;2015-11-02;1444;1444;1444;null;null;KZT;96;96;1540;1540;1
0;KZ75125KZT2069101100;2015-11-03;1468;1468;1468;24;24;KZT;null;null;1444;1444;1
0;KZ75125KZT2069101100;2015-11-04;1426;1426;1426;null;null;KZT;42;42;1468;1468;1
0;KZ75125KZT2069101100;2015-11-05;1384;1384;1384;null;null;KZT;42;42;1426;1426;1
0;KZ75125KZT2069101100;2015-11-06;1465;1465;1465;81;81;KZT;null;null;1384;1384;1
0;KZ75125KZT2069101100;2015-11-07;1521;1521;1521;56;56;KZT;null;null;1465;1465;1
0;KZ75125KZT2069101100;2015-11-08;1618;1618;1618;97;97;KZT;null;null;1521;1521;1
0;KZ75125KZT2069101100;2015-11-09;1614;1614;1614;null;null;KZT;4;4;1618;1618;1
0;KZ75125KZT2069101100;2015-11-10;1625;1625;1625;11;11;KZT;null;null;1614;1614;1
0;KZ75125KZT2069101100;2015-11-11;1693;1693;1693;68;68;KZT;null;null;1625;1625;1
0;KZ75125KZT2069101100;2015-11-12;1632;1632;1632;null;null;KZT;61;61;1693;1693;1
0;KZ75125KZT2069101100;2015-11-13;1625;1625;1625;null;null;KZT;7;7;1632;1632;1
0;KZ75125KZT2069101100;2015-11-14;1638;1638;1638;13;13;KZT;null;null;1625;1625;1
0;KZ75125KZT2069101100;2015-11-15;1651;1651;1651;13;13;KZT;null;null;1638;1638;1
0;KZ75125KZT2069101100;2015-11-16;1743;1743;1743;92;92;KZT;null;null;1651;1651;1
0;KZ75125KZT2069101100;2015-11-17;1833;1833;1833;90;90;KZT;null;null;1743;1743;1
0;KZ75125KZT2069101100;2015-11-18;1746;1746;1746;null;null;KZT;87;87;1833;1833;1
0;KZ75125KZT2069101100;2015-11-19;1666;1666;1666;null;null;KZT;80;80;1746;1746;1
0;KZ75125KZT2069101100;2015-11-20;1586;1586;1586;null;null;KZT;80;80;1666;1666;1
0;KZ75125KZT2069101100;2015-11-21;1604;1604;1604;18;18;KZT;null;null;1586;1586;1
0;KZ75125KZT2069101100;2015-11-22;1600;1600;1600;null;null;KZT;4;4;1604;1604;1
0;KZ75125KZT2069101100;2015-11-23;1513;1513;1513;null;null;KZT;87;87;1600;1600;1
0;KZ75125KZT2069101100;2015-11-24;1537;1537;1537;24;24;KZT;null;null;1513;1513;1
0;KZ75125KZT2069101100;2015-11-25;1623;1623;1623;86;86;KZT;null;null;1537;1537;1
0;KZ75125KZT2069101100;2015-11-26;1674;1674;1674;51;51;KZT;null;null;1623;1623;1
0;KZ75125KZT2069101100;2015-11-27;1588;1588;1588;null;null;KZT;86;86;1674;1674;1
0;KZ75125KZT2069101100;2015-11-28;1489;1489;1489;null;null;KZT;99;99;1588;1588;1
0;KZ75125KZT2069101100;2015-11-29;1445;1445;1445;null;null;KZT;44;44;1489;1489;1
0;KZ75125KZT2069101100;2015-11-30;1370;1370;1370;null;null;KZT;75;75;1445;1445;1
0;KZ75125KZT2069101100;2015-12-01;1302;1302;1302;null;null;KZT;68;68;1370;1370;1
0;KZ75125KZT2069101100;2015-12-02;1307;1307;1307;5;5;KZT;null;null;1302;1302;1
0;KZ75125KZT2069101100;2015-12-03;1225;1225;1225;null;null;KZT;82;82;1307;1307;1
0;KZ75125KZT2069101100;2015-12-04;1240;1240;1240;15;15;KZT;null;null;1225;1225;1
0;KZ75125KZT2069101100;2015-12-05;1190;1190;1190;null;null;KZT;50;50;1240;1240;1
0;KZ75125KZT2069101100;2015-12-06;1234;1234;1234;44;44;KZT;null;null;1190;1190;1
0;KZ75125KZT2069101100;2015-12-07;1204;1204;1204;null;null;KZT;30;30;1234;1234;1
0;KZ75125KZT2069101100;2015-12-08;1297;1297;1297;93;93;KZT;null;null;1204;1204;1
0;KZ75125KZT2069101100;2015-12-09;1394;1394;1394;97;97;KZT;null;null;1297;1297;1
0;KZ75125KZT2069101100;2015-12-10;1444;1444;1444;50;50;KZT;null;null;1394;1394;1
0;KZ75125KZT2069101100;2015-12-11;1444;1444;1444;null;null;KZT;0;0;1444;1444;1
0;KZ75125KZT2069101100;2015-12-12;1502;1502;1502;58;58;KZT;null;null;1444;1444;1
0;KZ75125KZT2069101100;2015-12-13;1537;1537;1537;35;35;KZT;null;null;1502;1502;1
0;KZ75125KZT2069101100;2015-12-14;1562;1562;1562;25;25;KZT;null;null;1537;1537;1
0;KZ75125KZT2069101100;2015-12-15;1504;1504;1504;null;null;KZT;58;58;1562;1562;1
0;KZ75125KZT2069101100;2015-12-16;1407;1407;1407;null;null;KZT;97;97;1504;1504;1
0;KZ75125KZT2069101100;2015-12-17;1349;1349;1349;null;null;KZT;58;58;1407;1407;1
0;KZ75125KZT2069101100;2015-12-18;1348;1348;1348;null;null;KZT;1;1;1349;1349;1
0;KZ75125KZT2069101100;2015-12-19;1292;1292;1292;null;null;KZT;56;56;1348;1348;1
0;KZ75125KZT2069101100;2015-12-20;1310;1310;1310;18;18;KZT;null;null;1292;1292;1
0;KZ75125KZT2069101100;2015-12-21;1395;1395;1395;85;85;KZT;null;null;1310;1310;1
0;KZ75125KZT2069101100;2015-12-22;1353;1353;1353;null;null;KZT;42;42;1395;1395;1
0;KZ75125KZT2069101100;2015-12-23;1450;1450;1450;97;97;KZT;null;null;1353;1353;1
0;KZ75125KZT2069101100;2015-12-24;1351;1351;1351;null;null;KZT;99;99;1450;1450;1
0;KZ75125KZT2069101100;2015-12-25;1356;1356;1356;5;5;KZT;null;null;1351;1351;1
0;KZ75125KZT2069101100;2015-12-26;1437;1437;1437;81;81;KZT;null;null;1356;1356;1
0;KZ75125KZT2069101100;2015-12-27;1458;1458;1458;21;21;KZT;null;null;1437;1437;1
0;KZ75125KZT2069101100;2015-12-28;1509;1509;1509;51;51;KZT;null;null;1458;1458;1
0;KZ75125KZT2069101100;2015-12-29;1556;1556;1556;47;47;KZT;null;null;1509;1509;1
0;KZ75125KZT2069101100;2015-12-30;1545;1545;1545;null;null;KZT;11;11;1556;1556;1
0;KZ75125KZT2069101100;2015-12-31;1609;1609;1609;64;64;KZT;null;null;1545;1545;1
0;KZ75125KZT2069101100;2016-01-01;1663;1663;1663;54;54;KZT;null;null;1609;1609;1
0;KZ75125KZT2069101100;2016-01-02;1698;1698;1698;35;35;KZT;null;null;1663;1663;1
0;KZ75125KZT2069101100;2016-01-03;1604;1604;1604;null;null;KZT;94;94;1698;1698;1
0;KZ75125KZT2069101100;2016-01-04;1600;1600;1600;null;null;KZT;4;4;1604;1604;1
0;KZ75125KZT2069101100;2016-01-05;1594;1594;1594;null;null;KZT;6;6;1600;1600;1
0;KZ75125KZT2069101100;2016-01-06;1525;1525;1525;null;null;KZT;69;69;1594;1594;1
0;KZ75125KZT2069101100;2016-01-07;1561;1561;1561;36;36;KZT;null;null;1525;1525;1
0;KZ75125KZT2069101100;2016-01-08;1642;1642;1642;81;81;KZT;null;null;1561;1561;1
0;KZ75125KZT2069101100;2016-01-09;1676;1676;1676;34;34;KZT;null;null;1642;1642;1
0;KZ75125KZT2069101100;2016-01-10;1608;1608;1608;null;null;KZT;68;68;1676;1676;1
0;KZ75125KZT2069101100;2016-01-11;1688;1688;1688;80;80;KZT;null;null;1608;1608;1
0;KZ75125KZT2069101100;2016-01-12;1623;1623;1623;null;null;KZT;65;65;1688;1688;1
0;KZ75125KZT2069101100;2016-01-13;1682;1682;1682;59;59;KZT;null;null;1623;1623;1
0;KZ75125KZT2069101100;2016-01-14;1587;1587;1587;null;null;KZT;95;95;1682;1682;1
0;KZ75125KZT2069101100;2016-01-15;1620;1620;1620;33;33;KZT;null;null;1587;1587;1
0;KZ75125KZT2069101100;2016-01-16;1707;1707;1707;87;87;KZT;null;null;1620;1620;1
0;KZ75125KZT2069101100;2016-01-17;1622;1622;1622;null;null;KZT;85;85;1707;1707;1
0;KZ75125KZT2069101100;2016-01-18;1598;1598;1598;null;null;KZT;24;24;1622;1622;1
0;KZ75125KZT2069101100;2016-01-19;1586;1586;1586;null;null;KZT;12;12;1598;1598;1
0;KZ75125KZT2069101100;2016-01-20;1685;1685;1685;99;99;KZT;null;null;1586;1586;1
0;KZ75125KZT2069101100;2016-01-21;1701;1701;1701;16;16;KZT;null;null;1685;1685;1
0;KZ75125KZT2069101100;2016-01-22;1653;1653;1653;null;null;KZT;48;48;1701;1701;1
0;KZ75125KZT2069101100;2016-01-23;1736;1736;1736;83;83;KZT;null;null;1653;1653;1
0;KZ75125KZT2069101100;2016-01-24;1681;1681;1681;null;null;KZT;55;55;1736;1736;1
0;KZ75125KZT2069101100;2016-01-25;1642;1642;1642;null;null;KZT;39;39;1681;1681;1
0;KZ75125KZT2069101100;2016-01-26;1555;1555;1555;null;null;KZT;87;87;1642;1642;1
0;KZ75125KZT2069101100;2016-01-27;1543;1543;1543;null;null;KZT;12;12;1555;1555;1
0;KZ75125KZT2069101100;2016-01-28;1587;1587;1587;44;44;KZT;null;null;1543;1543;1
0;KZ75125KZT2069101100;2016-01-29;1609;1609;1609;22;22;KZT;null;null;1587;1587;1
0;KZ75125KZT2069101100;2016-01-30;1541;1541;1541;null;null;KZT;68;68;1609;1609;1
0;KZ75125KZT2069101100;2016-01-31;1526;1526;1526;null;null;KZT;15;15;1541;1541;1
0;KZ75125KZT2069101100;2016-02-01;1533;1533;1533;7;7;KZT;null;null;1526;1526;1
0;KZ75125KZT2069101100;2016-02-02;1561;1561;1561;28;28;KZT;null;null;1533;1533;1
0;KZ75125KZT2069101100;2016-02-03;1462;1462;1462;null;null;KZT;99;99;1561;1561;1
0;KZ75125KZT2069101100;2016-02-04;1537;1537;1537;75;75;KZT;null;null;1462;1462;1
0;KZ75125KZT2069101100;2016-02-05;1442;1442;1442;null;null;KZT;95;95;1537;1537;1
0;KZ75125KZT2069101100;2016-02-06;1408;1408;1408;null;null;KZT;34;34;1442;1442;1
0;KZ75125KZT2069101100;2016-02-07;1444;1444;1444;36;36;KZT;null;null;1408;1408;1
0;KZ75125KZT2069101100;2016-02-08;1457;1457;1457;13;13;KZT;null;null;1444;1444;1
0;KZ75125KZT2069101100;2016-02-09;1448;1448;1448;null;null;KZT;9;9;1457;1457;1
0;KZ75125KZT2069101100;2016-02-10;1378;1378;1378;null;null;KZT;70;70;1448;1448;1
0;KZ75125KZT2069101100;2016-02-11;1391;1391;1391;13;13;KZT;null;null;1378;1378;1
0;KZ75125KZT2069101100;2016-02-12;1387;1387;1387;null;null;KZT;4;4;1391;1391;1
0;KZ75125KZT2069101100;2016-02-13;1302;1302;1302;null;null;KZT;85;85;1387;1387;1
0;KZ75125KZT2069101100;2016-02-14;1312;1312;1312;10;10;KZT;null;null;1302;1302;1
0;KZ75125KZT2069101100;2016-02-15;1334;1334;1334;22;22;KZT;null;null;1312;1312;1
0;KZ75125KZT2069101100;2016-02-16;1274;1274;1274;null;null;KZT;60;60;1334;1334;1
0;KZ75125KZT2069101100;2016-02-17;1340;1340;1340;66;66;KZT;null;null;1274;1274;1
0;KZ75125KZT2069101100;2016-02-18;1318;1318;1318;null;null;KZT;22;22;1340;1340;1
0;KZ75125KZT2069101100;2016-02-19;1330;1330;1330;12;12;KZT;null;null;1318;1318;1
0;KZ75125KZT2069101100;2016-02-20;1428;1428;1428;98;98;KZT;null;null;1330;1330;1
0;KZ75125KZT2069101100;2016-02-21;1477;1477;1477;49;49;KZT;null;null;1428;1428;1
0;KZ75125KZT2069101100;2016-02-22;1552;1552;1552;75;75;KZT;null;null;1477;1477;1
0;KZ75125KZT2069101100;2016-02-23;1612;1612;1612;60;60;KZT;null;null;1552;1552;1
0;KZ75125KZT2069101100;2016-02-24;1674;1674;1674;62;62;KZT;null;null;1612;1612;1
0;KZ75125KZT2069101100;2016-02-25;1689;1689;1689;15;15;KZT;null;null;1674;1674;1
0;KZ75125KZT2069101100;2016-02-26;1692;1692;1692;3;3;KZT;null;null;1689;1689;1
0;KZ75125KZT2069101100;2016-02-27;1646;1646;1646;null;null;KZT;46;46;1692;1692;1
0;KZ75125KZT2069101100;2016-02-28;1718;1718;1718;72;72;KZT;null;null;1646;1646;1
0;KZ75125KZT2069101100;2016-02-29;1816;1816;1816;98;98;KZT;null;null;1718;1718;1
0;KZ75125KZT2069101100;2016-03-01;1861;1861;1861;45;45;KZT;null;null;1816;1816;1
0;KZ75125KZT2069101100;2016-03-02;1773;1773;1773;null;null;KZT;88;88;1861;1861;1
0;KZ75125KZT2069101100;2016-03-03;1701;1701;1701;null;null;KZT;72;72;1773;1773;1
0;KZ75125KZT2069101100;2016-03-04;1792;1792;1792;91;91;KZT;null;null;1701;1701;1
0;KZ75125KZT2069101100;2016-03-05;1720;1720;1720;null;null;KZT;72;72;1792;1792;1
0;KZ75125KZT2069101100;2016-03-06;1788;1788;1788;68;68;KZT;null;null;1720;1720;1
0;KZ75125KZT2069101100;2016-03-07;1709;1709;1709;null;null;KZT;79;79;1788;1788;1
0;KZ75125KZT2069101100;2016-03-08;1701;1701;1701;null;null;KZT;8;8;1709;1709;1
0;KZ75125KZT2069101100;2016-03-09;1658;1658;1658;null;null;KZT;43;43;1701;1701;1
0;KZ75125KZT2069101100;2016-03-10;1632;1632;1632;null;null;KZT;26;26;1658;1658;1
0;KZ75125KZT2069101100;2016-03-11;1660;1660;1660;28;28;KZT;null;null;1632;1632;1
0;KZ75125KZT2069101100;2016-03-12;1759;1759;1759;99;99;KZT;null;null;1660;1660;1
0;KZ75125KZT2069101100;2016-03-13;1828;1828;1828;69;69;KZT;null;null;1759;1759;1
0;KZ75125KZT2069101100;2016-03-14;1804;1804;1804;null;null;KZT;24;24;1828;1828;1
0;KZ75125KZT2069101100;2016-03-15;1830;1830;1830;26;26;KZT;null;null;1804;1804;1
0;KZ75125KZT2069101100;2016-03-16;1811;1811;1811;null;null;KZT;19;19;1830;1830;1
0;KZ75125KZT2069101100;2016-03-17;1848;1848;1848;37;37;KZT;null;null;1811;1811;1
0;KZ75125KZT2069101100;2016-03-18;1844;1844;1844;null;null;KZT;4;4;1848;1848;1
0;KZ75125KZT2069101100;2016-03-19;1888;1888;1888;44;44;KZT;null;null;1844;1844;1
0;KZ75125KZT2069101100;2016-03-20;1950;1950;1950;62;62;KZT;null;null;1888;1888;1
0;KZ75125KZT2069101100;2016-03-21;1972;1972;1972;22;22;KZT;null;null;1950;1950;1
0;KZ75125KZT2069101100;2016-03-22;1927;1927;1927;null;null;KZT;45;45;1972;1972;1
0;KZ75125KZT2069101100;2016-03-23;1896;1896;1896;null;null;KZT;31;31;1927;1927;1
0;KZ75125KZT2069101100;2016-03-24;1882;1882;1882;null;null;KZT;14;14;1896;1896;1
0;KZ75125KZT2069101100;2016-03-25;1853;1853;1853;null;null;KZT;29;29;1882;1882;1
0;KZ75125KZT2069101100;2016-03-26;1756;1756;1756;null;null;KZT;97;97;1853;1853;1
0;KZ75125KZT2069101100;2016-03-27;1780;1780;1780;24;24;KZT;null;null;1756;1756;1
0;KZ75125KZT2069101100;2016-03-28;1856;1856;1856;76;76;KZT;null;null;1780;1780;1
0;KZ75125KZT2069101100;2016-03-29;1786;1786;1786;null;null;KZT;70;70;1856;1856;1
0;KZ75125KZT2069101100;2016-03-30;1839;1839;1839;53;53;KZT;null;null;1786;1786;1
0;KZ75125KZT2069101100;2016-03-31;1866;1866;1866;27;27;KZT;null;null;1839;1839;1
0;KZ75125KZT2069101100;2016-04-01;1888;1888;1888;22;22;KZT;null;null;1866;1866;1
0;KZ75125KZT2069101100;2016-04-02;1817;1817;1817;null;null;KZT;71;71;1888;1888;1
0;KZ75125KZT2069101100;2016-04-03;1856;1856;1856;39;39;KZT;null;null;1817;1817;1
0;KZ75125KZT2069101100;2016-04-04;1816;1816;1816;null;null;KZT;40;40;1856;1856;1
0;KZ75125KZT2069101100;2016-04-05;1829;1829;1829;13;13;KZT;null;null;1816;1816;1
0;KZ75125KZT2069101100;2016-04-06;1741;1741;1741;null;null;KZT;88;88;1829;1829;1
0;KZ75125KZT2069101100;2016-04-07;1791;1791;1791;50;50;KZT;null;null;1741;1741;1
0;KZ75125KZT2069101100;2016-04-08;1752;1752;1752;null;null;KZT;39;39;1791;1791;1
0;KZ75125KZT2069101100;2016-04-09;1668;1668;1668;null;null;KZT;84;84;1752;1752;1
0;KZ75125KZT2069101100;2016-04-10;1737;1737;1737;69;69;KZT;null;null;1668;1668;1
0;KZ75125KZT2069101100;2016-04-11;1708;1708;1708;null;null;KZT;29;29;1737;1737;1
0;KZ75125KZT2069101100;2016-04-12;1769;1769;1769;61;61;KZT;null;null;1708;1708;1
0;KZ75125KZT2069101100;2016-04-13;1759;1759;1759;null;null;KZT;10;10;1769;1769;1
0;KZ75125KZT2069101100;2016-04-14;1745;1745;1745;null;null;KZT;14;14;1759;1759;1
0;KZ75125KZT2069101100;2016-04-15;1691;1691;1691;null;null;KZT;54;54;1745;1745;1
0;KZ75125KZT2069101100;2016-04-16;1756;1756;1756;65;65;KZT;null;null;1691;1691;1
0;KZ75125KZT2069101100;2016-04-17;1664;1664;1664;null;null;KZT;92;92;1756;1756;1
0;KZ75125KZT2069101100;2016-04-18;1611;1611;1611;null;null;KZT;53;53;1664;1664;1
0;KZ75125KZT2069101100;2016-04-19;1650;1650;1650;39;39;KZT;null;null;1611;1611;1
0;KZ75125KZT2069101100;2016-04-20;1741;1741;1741;91;91;KZT;null;null;1650;1650;1
0;KZ75125KZT2069101100;2016-04-21;1695;1695;1695;null;null;KZT;46;46;1741;1741;1
0;KZ75125KZT2069101100;2016-04-22;1604;1604;1604;null;null;KZT;91;91;1695;1695;1
0;KZ75125KZT2069101100;2016-04-23;1700;1700;1700;96;96;KZT;null;null;1604;1604;1
0;KZ75125KZT2069101100;2016-04-24;1729;1729;1729;29;29;KZT;null;null;1700;1700;1
0;KZ75125KZT2069101100;2016-04-25;1810;1810;1810;81;81;KZT;null;null;1729;1729;1
0;KZ75125KZT2069101100;2016-04-26;1804;1804;1804;null;null;KZT;6;6;1810;1810;1
0;KZ75125KZT2069101100;2016-04-27;1736;1736;1736;null;null;KZT;68;68;1804;1804;1
0;KZ75125KZT2069101100;2016-04-28;1684;1684;1684;null;null;KZT;52;52;1736;1736;1
0;KZ75125KZT2069101100;2016-04-29;1694;1694;1694;10;10;KZT;null;null;1684;1684;1
0;KZ75125KZT2069101100;2016-04-30;1697;1697;1697;3;3;KZT;null;null;1694;1694;1
0;KZ75125KZT2069101100;2016-05-01;1684;1684;1684;null;null;KZT;13;13;1697;1697;1
0;KZ75125KZT2069101100;2016-05-02;1750;1750;1750;66;66;KZT;null;null;1684;1684;1
0;KZ75125KZT2069101100;2016-05-03;1843;1843;1843;93;93;KZT;null;null;1750;1750;1
0;KZ75125KZT2069101100;2016-05-04;1917;1917;1917;74;74;KZT;null;null;1843;1843;1
0;KZ75125KZT2069101100;2016-05-05;1867;1867;1867;null;null;KZT;50;50;1917;1917;1
0;KZ75125KZT2069101100;2016-05-06;1831;1831;1831;null;null;KZT;36;36;1867;1867;1
0;KZ75125KZT2069101100;2016-05-07;1760;1760;1760;null;null;KZT;71;71;1831;1831;1
0;KZ75125KZT2069101100;2016-05-08;1847;1847;1847;87;87;KZT;null;null;1760;1760;1
0;KZ75125KZT2069101100;2016-05-09;1881;1881;1881;34;34;KZT;null;null;1847;1847;1
0;KZ75125KZT2069101100;2016-05-10;1831;1831;1831;null;null;KZT;50;50;1881;1881;1
0;KZ75125KZT2069101100;2016-05-11;1872;1872;1872;41;41;KZT;null;null;1831;1831;1
0;KZ75125KZT2069101100;2016-05-12;1801;1801;1801;null;null;KZT;71;71;1872;1872;1
0;KZ75125KZT2069101100;2016-05-13;1725;1725;1725;null;null;KZT;76;76;1801;1801;1
0;KZ75125KZT2069101100;2016-05-14;1744;1744;1744;19;19;KZT;null;null;1725;1725;1
0;KZ75125KZT2069101100;2016-05-15;1702;1702;1702;null;null;KZT;42;42;1744;1744;1
0;KZ75125KZT2069101100;2016-05-16;1766;1766;1766;64;64;KZT;null;null;1702;1702;1
0;KZ75125KZT2069101100;2016-05-17;1688;1688;1688;null;null;KZT;78;78;1766;1766;1
0;KZ75125KZT2069101100;2016-05-18;1636;1636;1636;null;null;KZT;52;52;1688;1688;1
0;KZ75125KZT2069101100;2016-05-19;1704;1704;1704;68;68;KZT;null;null;1636;1636;1
0;KZ75125KZT2069101100;2016-05-20;1725;1725;1725;21;21;KZT;null;null;1704;1704;1
0;KZ75125KZT2069101100;2016-05-21;1711;1711;1711;null;null;KZT;14;14;1725;1725;1
0;KZ75125KZT2069101100;2016-05-22;1738;1738;1738;27;27;KZT;null;null;1711;1711;1
0;KZ75125KZT2069101100;2016-05-23;1640;1640;1640;null;null;KZT;98;98;1738;1738;1
0;KZ75125KZT2069101100;2016-05-24;1652;1652;1652;12;12;KZT;null;null;1640;1640;1
0;KZ75125KZT2069101100;2016-05-25;1612;1612;1612;null;null;KZT;40;40;1652;1652;1
0;KZ75125KZT2069101100;2016-05-26;1566;1566;1566;null;null;KZT;46;46;1612;1612;1
0;KZ75125KZT2069101100;2016-05-27;1574;1574;1574;8;8;KZT;null;null;1566;1566;1
0;KZ75125KZT2069101100;2016-05-28;1497;1497;1497;null;null;KZT;77;77;1574;1574;1
0;KZ75125KZT2069101100;2016-05-29;1529;1529;1529;32;32;KZT;null;null;1497;1497;1
0;KZ75125KZT2069101100;2016-05-30;1514;1514;1514;null;null;KZT;15;15;1529;1529;1
0;KZ75125KZT2069101100;2016-05-31;1586;1586;1586;72;72;KZT;null;null;1514;1514;1
0;KZ75125KZT2069101100;2016-06-01;1588;1588;1588;2;2;KZT;null;null;1586;1586;1
0;KZ75125KZT2069101100;2016-06-02;1666;1666;1666;78;78;KZT;null;null;1588;1588;1
0;KZ75125KZT2069101100;2016-06-03;1597;1597;1597;null;null;KZT;69;69;1666;1666;1
0;KZ75125KZT2069101100;2016-06-04;1605;1605;1605;8;8;KZT;null;null;1597;1597;1
0;KZ75125KZT2069101100;2016-06-05;1618;1618;1618;13;13;KZT;null;null;1605;1605;1
0;KZ75125KZT2069101100;2016-06-06;1602;1602;1602;null;null;KZT;16;16;1618;1618;1
0;KZ75125KZT2069101100;2016-06-07;1659;1659;1659;57;57;KZT;null;null;1602;1602;1
0;KZ75125KZT2069101100;2016-06-08;1627;1627;1627;null;null;KZT;32;32;1659;1659;1
0;KZ75125KZT2069101100;2016-06-09;1633;1633;1633;6;6;KZT;null;null;1627;1627;1
0;KZ75125KZT2069101100;2016-06-10;1678;1678;1678;45;45;KZT;null;null;1633;1633;1
0;KZ75125KZT2069101100;2016-06-11;1732;1732;1732;54;54;KZT;null;null;1678;1678;1
0;KZ75125KZT2069101100;2016-06-12;1827;1827;1827;95;95;KZT;null;null;1732;1732;1
0;KZ75125KZT2069101100;2016-06-13;1794;1794;1794;null;null;KZT;33;33;1827;1827;1
0;KZ75125KZT2069101100;2016-06-14;1776;1776;1776;null;null;KZT;18;18;1794;1794;1
0;KZ75125KZT2069101100;2016-06-15;1772;1772;1772;null;null;KZT;4;4;1776;1776;1
0;KZ75125KZT2069101100;2016-06-16;1766;1766;1766;null;null;KZT;6;6;1772;1772;1
0;KZ75125KZT2069101100;2016-06-17;1788;1788;1788;22;22;KZT;null;null;1766;1766;1
0;KZ75125KZT2069101100;2016-06-18;1780;1780;1780;null;null;KZT;8;8;1788;1788;1
0;KZ75125KZT2069101100;2016-06-19;1769;1769;1769;null;null;KZT;11;11;1780;1780;1
0;KZ75125KZT2069101100;2016-06-20;1714;1714;1714;null;null;KZT;55;55;1769;1769;1
0;KZ75125KZT2069101100;2016-06-21;1796;1796;1796;82;82;KZT;null;null;1714;1714;1
0;KZ75125KZT2069101100;2016-06-22;1729;1729;1729;null;null;KZT;67;67;1796;1796;1
0;KZ75125KZT2069101100;2016-06-23;1753;1753;1753;24;24;KZT;null;null;1729;1729;1
0;KZ75125KZT2069101100;2016-06-24;1750;1750;1750;null;null;KZT;3;3;1753;1753;1
0;KZ75125KZT2069101100;2016-06-25;1803;1803;1803;53;53;KZT;null;null;1750;1750;1
0;KZ75125KZT2069101100;2016-06-26;1779;1779;1779;null;null;KZT;24;24;1803;1803;1
0;KZ75125KZT2069101100;2016-06-27;1736;1736;1736;null;null;KZT;43;43;1779;1779;1
0;KZ75125KZT2069101100;2016-06-28;1655;1655;1655;null;null;KZT;81;81;1736;1736;1
0;KZ75125KZT2069101100;2016-06-29;1685;1685;1685;30;30;KZT;null;null;1655;1655;1
0;KZ75125KZT2069101100;2016-06-30;1715;1715;1715;30;30;KZT;null;null;1685;1685;1
0;KZ75125KZT2069101100;2016-07-01;1756;1756;1756;41;41;KZT;null;null;1715;1715;1
0;KZ75125KZT2069101100;2016-07-02;1753;1753;1753;null;null;KZT;3;3;1756;1756;1
0;KZ75125KZT2069101100;2016-07-03;1762;1762;1762;9;9;KZT;null;null;1753;1753;1
0;KZ75125KZT2069101100;2016-07-04;1712;1712;1712;null;null;KZT;50;50;1762;1762;1
0;KZ75125KZT2069101100;2016-07-05;1668;1668;1668;null;null;KZT;44;44;1712;1712;1
0;KZ75125KZT2069101100;2016-07-06;1593;1593;1593;null;null;KZT;75;75;1668;1668;1
0;KZ75125KZT2069101100;2016-07-07;1571;1571;1571;null;null;KZT;22;22;1593;1593;1
0;KZ75125KZT2069101100;2016-07-08;1542;1542;1542;null;null;KZT;29;29;1571;1571;1
0;KZ75125KZT2069101100;2016-07-09;1478;1478;1478;null;null;KZT;64;64;1542;1542;1
0;KZ75125KZT2069101100;2016-07-10;1481;1481;1481;3;3;KZT;null;null;1478;1478;1
0;KZ75125KZT2069101100;2016-07-11;1512;1512;1512;31;31;KZT;null;null;1481;1481;1
0;KZ75125KZT2069101100;2016-07-12;1466;1466;1466;null;null;KZT;46;46;1512;1512;1
0;KZ75125KZT2069101100;2016-07-13;1540;1540;1540;74;74;KZT;null;null;1466;1466;1
0;KZ75125KZT2069101100;2016-07-14;1597;1597;1597;57;57;KZT;null;null;1540;1540;1
0;KZ75125KZT2069101100;2016-07-15;1560;1560;1560;null;null;KZT;37;37;1597;1597;1
0;KZ75125KZT2069101100;2016-07-16;1552;1552;1552;null;null;KZT;8;8;1560;1560;1
0;KZ75125KZT2069101100;2016-07-17;1521;1521;1521;null;null;KZT;31;31;1552;1552;1
0;KZ75125KZT2069101100;2016-07-18;1535;1535;1535;14;14;KZT;null;null;1521;1521;1
0;KZ75125KZT2069101100;2016-07-19;1555;1555;1555;20;20;KZT;null;null;1535;1535;1
0;KZ75125KZT2069101100;2016-07-20;1560;1560;1560;5;5;KZT;null;null;1555;1555;1
0;KZ75125KZT2069101100;2016-07-21;1530;1530;1530;null;null;KZT;30;30;1560;1560;1
0;KZ75125KZT2069101100;2016-07-22;1618;1618;1618;88;88;KZT;null;null;1530;1530;1
0;KZ75125KZT2069101100;2016-07-23;1598;1598;1598;null;null;KZT;20;20;1618;1618;1
0;KZ75125KZT2069101100;2016-07-24;1547;1547;1547;null;null;KZT;51;51;1598;1598;1
0;KZ75125KZT2069101100;2016-07-25;1495;1495;1495;null;null;KZT;52;52;1547;1547;1
0;KZ75125KZT2069101100;2016-07-26;1446;1446;1446;null;null;KZT;49;49;1495;1495;1
0;KZ75125KZT2069101100;2016-07-27;1431;1431;1431;null;null;KZT;15;15;1446;1446;1
0;KZ75125KZT2069101100;2016-07-28;1448;1448;1448;17;17;KZT;null;null;1431;1431;1
0;KZ75125KZT2069101100;2016-07-29;1389;1389;1389;null;null;KZT;59;59;1448;1448;1
0;KZ75125KZT2069101100;2016-07-30;1450;1450;1450;61;61;KZT;null;null;1389;1389;1
0;KZ75125KZT2069101100;2016-07-31;1398;1398;1398;null;null;KZT;52;52;1450;1450;1
0;KZ75125KZT2069101100;2016-08-01;1461;1461;1461;63;63;KZT;null;null;1398;1398;1
0;KZ75125KZT2069101100;2016-08-02;1471;1471;1471;10;10;KZT;null;null;1461;1461;1
0;KZ75125KZT2069101100;2016-08-03;1420;1420;1420;null;null;KZT;51;51;1471;1471;1
0;KZ75125KZT2069101100;2016-08-04;1479;1479;1479;59;59;KZT;null;null;1420;1420;1
0;KZ75125KZT2069101100;2016-08-05;1389;1389;1389;null;null;KZT;90;90;1479;1479;1
0;KZ75125KZT2069101100;2016-08-06;1366;1366;1366;null;null;KZT;23;23;1389;1389;1
0;KZ75125KZT2069101100;2016-08-07;1310;1310;1310;null;null;KZT;56;56;1366;1366;1
0;KZ75125KZT2069101100;2016-08-08;1236;1236;1236;null;null;KZT;74;74;1310;1310;1
0;KZ75125KZT2069101100;2016-08-09;1291;1291;1291;55;55;KZT;null;null;1236;1236;1
0;KZ75125KZT2069101100;2016-08-10;1350;1350;1350;59;59;KZT;null;null;1291;1291;1
0;KZ75125KZT2069101100;2016-08-11;1423;1423;1423;73;73;KZT;null;null;1350;1350;1
0;KZ75125KZT2069101100;2016-08-12;1357;1357;1357;null;null;KZT;66;66;1423;1423;1
0;KZ75125KZT2069101100;2016-08-13;1291;1291;1291;null;null;KZT;66;66;1357;1357;1
0;KZ75125KZT2069101100;2016-08-14;1207;1207;1207;null;null;KZT;84;84;1291;1291;1
0;KZ75125KZT2069101100;2016-08-15;1124;1124;1124;null;null;KZT;83;83;1207;1207;1
0;KZ75125KZT2069101100;2016-08-16;1153;1153;1153;29;29;KZT;null;null;1124;1124;1
0;KZ75125KZT2069101100;2016-08-17;1137;1137;1137;null;null;KZT;16;16;1153;1153;1
0;KZ75125KZT2069101100;2016-08-18;1098;1098;1098;null;null;KZT;39;39;1137;1137;1
0;KZ75125KZT2069101100;2016-08-19;1040;1040;1040;null;null;KZT;58;58;1098;1098;1
0;KZ75125KZT2069101100;2016-08-20;1078;1078;1078;38;38;KZT;null;null;1040;1040;1
0;KZ75125KZT2069101100;2016-08-21;1174;1174;1174;96;96;KZT;null;null;1078;1078;1
0;KZ75125KZT2069101100;2016-08-22;1146;1146;1146;null;null;KZT;28;28;1174;1174;1
0;KZ75125KZT2069101100;2016-08-23;1085;1085;1085;null;null;KZT;61;61;1146;1146;1
0;KZ75125KZT2069101100;2016-08-24;1032;1032;1032;null;null;KZT;53;53;1085;1085;1
0;KZ75125KZT2069101100;2016-08-25;1053;1053;1053;21;21;KZT;null;null;1032;1032;1
0;KZ75125KZT2069101100;2016-08-26;1119;1119;1119;66;66;KZT;null;null;1053;1053;1
0;KZ75125KZT2069101100;2016-08-27;1159;1159;1159;40;40;KZT;null;null;1119;1119;1
0;KZ75125KZT2069101100;2016-08-28;1075;1075;1075;null;null;KZT;84;84;1159;1159;1
0;KZ75125KZT2069101100;2016-08-29;1064;1064;1064;null;null;KZT;11;11;1075;1075;1
0;KZ75125KZT2069101100;2016-08-30;1157;1157;1157;93;93;KZT;null;null;1064;1064;1
0;KZ75125KZT2069101100;2016-08-31;1219;1219;1219;62;62;KZT;null;null;1157;1157;1
0;KZ75125KZT2069101100;2016-09-01;1201;1201;1201;null;null;KZT;18;18;1219;1219;1
0;KZ75125KZT2069101100;2016-09-02;1193;1193;1193;null;null;KZT;8;8;1201;1201;1
0;KZ75125KZT2069101100;2016-09-03;1238;1238;1238;45;45;KZT;null;null;1193;1193;1
0;KZ75125KZT2069101100;2016-09-04;1177;1177;1177;null;null;KZT;61;61;1238;1238;1
0;KZ75125KZT2069101100;2016-09-05;1207;1207;1207;30;30;KZT;null;null;1177;1177;1
0;KZ75125KZT2069101100;2016-09-06;1212;1212;1212;5;5;KZT;null;null;1207;1207;1
0;KZ75125KZT2069101100;2016-09-07;1304;1304;1304;92;92;KZT;null;null;1212;1212;1
0;KZ75125KZT2069101100;2016-09-08;1354;1354;1354;50;50;KZT;null;null;1304;1304;1
0;KZ75125KZT2069101100;2016-09-09;1370;1370;1370;16;16;KZT;null;null;1354;1354;1
0;KZ75125KZT2069101100;2016-09-10;1344;1344;1344;null;null;KZT;26;26;1370;1370;1
0;KZ75125KZT2069101100;2016-09-11;1442;1442;1442;98;98;KZT;null;null;1344;1344;1
0;KZ75125KZT2069101100;2016-09-12;1484;1484;1484;42;42;KZT;null;null;1442;1442;1
0;KZ75125KZT2069101100;2016-09-13;1443;1443;1443;null;null;KZT;41;41;1484;1484;1
0;KZ75125KZT2069101100;2016-09-14;1416;1416;1416;null;null;KZT;27;27;1443;1443;1
0;KZ75125KZT2069101100;2016-09-15;1327;1327;1327;null;null;KZT;89;89;1416;1416;1
0;KZ75125KZT2069101100;2016-09-16;1393;1393;1393;66;66;KZT;null;null;1327;1327;1
0;KZ75125KZT2069101100;2016-09-17;1447;1447;1447;54;54;KZT;null;null;1393;1393;1
0;KZ75125KZT2069101100;2016-09-18;1362;1362;1362;null;null;KZT;85;85;1447;1447;1
0;KZ75125KZT2069101100;2016-09-19;1402;1402;1402;40;40;KZT;null;null;1362;1362;1
0;KZ75125KZT2069101100;2016-09-20;1432;1432;1432;30;30;KZT;null;null;1402;1402;1
0;KZ75125KZT2069101100;2016-09-21;1524;1524;1524;92;92;KZT;null;null;1432;1432;1
0;KZ75125KZT2069101100;2016-09-22;1574;1574;1574;50;50;KZT;null;null;1524;1524;1
0;KZ75125KZT2069101100;2016-09-23;1636;1636;1636;62;62;KZT;null;null;1574;1574;1
0;KZ75125KZT2069101100;2016-09-24;1709;1709;1709;73;73;KZT;null;null;1636;1636;1
0;KZ75125KZT2069101100;2016-09-25;1713;1713;1713;4;4;KZT;null;null;1709;1709;1
0;KZ75125KZT2069101100;2016-09-26;1779;1779;1779;66;66;KZT;null;null;1713;1713;1
0;KZ75125KZT2069101100;2016-09-27;1802;1802;1802;23;23;KZT;null;null;1779;1779;1
0;KZ75125KZT2069101100;2016-09-28;1704;1704;1704;null;null;KZT;98;98;1802;1802;1
0;KZ75125KZT2069101100;2016-09-29;1605;1605;1605;null;null;KZT;99;99;1704;1704;1
0;KZ75125KZT2069101100;2016-09-30;1655;1655;1655;50;50;KZT;null;null;1605;1605;1
0;KZ75125KZT2069101100;2016-10-01;1594;1594;1594;null;null;KZT;61;61;1655;1655;1
0;KZ75125KZT2069101100;2016-10-02;1641;1641;1641;47;47;KZT;null;null;1594;1594;1
0;KZ75125KZT2069101100;2016-10-03;1713;1713;1713;72;72;KZT;null;null;1641;1641;1
0;KZ75125KZT2069101100;2016-10-04;1777;1777;1777;64;64;KZT;null;null;1713;1713;1
0;KZ75125KZT2069101100;2016-10-05;1868;1868;1868;91;91;KZT;null;null;1777;1777;1
0;KZ75125KZT2069101100;2016-10-06;1934;1934;1934;66;66;KZT;null;null;1868;1868;1
0;KZ75125KZT2069101100;2016-10-07;1927;1927;1927;null;null;KZT;7;7;1934;1934;1
0;KZ75125KZT2069101100;2016-10-08;1847;1847;1847;null;null;KZT;80;80;1927;1927;1
0;KZ75125KZT2069101100;2016-10-09;1922;1922;1922;75;75;KZT;null;null;1847;1847;1
0;KZ75125KZT2069101100;2016-10-10;1825;1825;1825;null;null;KZT;97;97;1922;1922;1
0;KZ75125KZT2069101100;2016-10-11;1769;1769;1769;null;null;KZT;56;56;1825;1825;1
0;KZ75125KZT2069101100;2016-10-12;1748;1748;1748;null;null;KZT;21;21;1769;1769;1
0;KZ75125KZT2069101100;2016-10-13;1772;1772;1772;24;24;KZT;null;null;1748;1748;1
0;KZ75125KZT2069101100;2016-10-14;1697;1697;1697;null;null;KZT;75;75;1772;1772;1
0;KZ75125KZT2069101100;2016-10-15;1626;1626;1626;null;null;KZT;71;71;1697;1697;1
0;KZ75125KZT2069101100;2016-10-16;1655;1655;1655;29;29;KZT;null;null;1626;1626;1
0;KZ75125KZT2069101100;2016-10-17;1650;1650;1650;null;null;KZT;5;5;1655;1655;1
0;KZ75125KZT2069101100;2016-10-18;1608;1608;1608;null;null;KZT;42;42;1650;1650;1
0;KZ75125KZT2069101100;2016-10-19;1598;1598;1598;null;null;KZT;10;10;1608;1608;1
0;KZ75125KZT2069101100;2016-10-20;1654;1654;1654;56;56;KZT;null;null;1598;1598;1
0;KZ75125KZT2069101100;2016-10-21;1630;1630;1630;null;null;KZT;24;24;1654;1654;1
0;KZ75125KZT2069101100;2016-10-22;1685;1685;1685;55;55;KZT;null;null;1630;1630;1
0;KZ75125KZT2069101100;2016-10-23;1591;1591;1591;null;null;KZT;94;94;1685;1685;1
0;KZ75125KZT2069101100;2016-10-24;1522;1522;1522;null;null;KZT;69;69;1591;1591;1
0;KZ75125KZT2069101100;2016-10-25;1554;1554;1554;32;32;KZT;null;null;1522;1522;1
0;KZ75125KZT2069101100;2016-10-26;1489;1489;1489;null;null;KZT;65;65;1554;1554;1
0;KZ75125KZT2069101100;2016-10-27;1496;1496;1496;7;7;KZT;null;null;1489;1489;1
0;KZ75125KZT2069101100;2016-10-28;1470;1470;1470;null;null;KZT;26;26;1496;1496;1
0;KZ75125KZT2069101100;2016-10-29;1523;1523;1523;53;53;KZT;null;null;1470;1470;1
0;KZ75125KZT2069101100;2016-10-30;1493;1493;1493;null;null;KZT;30;30;1523;1523;1
0;KZ75125KZT2069101100;2016-10-31;1462;1462;1462;null;null;KZT;31;31;1493;1493;1
0;KZ75125KZT2069101100;2016-11-01;1374;1374;1374;null;null;KZT;88;88;1462;1462;1
0;KZ75125KZT2069101100;2016-11-02;1403;1403;1403;29;29;KZT;null;null;1374;1374;1
0;KZ75125KZT2069101100;2016-11-03;1418;1418;1418;15;15;KZT;null;null;1403;1403;1
0;KZ75125KZT2069101100;2016-11-04;1431;1431;1431;13;13;KZT;null;null;1418;1418;1
0;KZ75125KZT2069101100;2016-11-05;1467;1467;1467;36;36;KZT;null;null;1431;1431;1
0;KZ75125KZT2069101100;2016-11-06;1532;1532;1532;65;65;KZT;null;null;1467;1467;1
0;KZ75125KZT2069101100;2016-11-07;1569;1569;1569;37;37;KZT;null;null;1532;1532;1
0;KZ75125KZT2069101100;2016-11-08;1570;1570;1570;1;1;KZT;null;null;1569;1569;1
0;KZ75125KZT2069101100;2016-11-09;1484;1484;1484;null;null;KZT;86;86;1570;1570;1
0;KZ75125KZT2069101100;2016-11-10;1510;1510;1510;26;26;KZT;null;null;1484;1484;1
0;KZ75125KZT2069101100;2016-11-11;1570;1570;1570;60;60;KZT;null;null;1510;1510;1
0;KZ75125KZT2069101100;2016-11-12;1669;1669;1669;99;99;KZT;null;null;1570;1570;1
0;KZ75125KZT2069101100;2016-11-13;1693;1693;1693;24;24;KZT;null;null;1669;1669;1
0;KZ75125KZT2069101100;2016-11-14;1744;1744;1744;51;51;KZT;null;null;1693;1693;1
0;KZ75125KZT2069101100;2016-11-15;1795;1795;1795;51;51;KZT;null;null;1744;1744;1
0;KZ75125KZT2069101100;2016-11-16;1795;1795;1795;null;null;KZT;0;0;1795;1795;1
0;KZ75125KZT2069101100;2016-11-17;1838;1838;1838;43;43;KZT;null;null;1795;1795;1
0;KZ75125KZT2069101100;2016-11-18;1767;1767;1767;null;null;KZT;71;71;1838;1838;1
0;KZ75125KZT2069101100;2016-11-19;1762;1762;1762;null;null;KZT;5;5;1767;1767;1
0;KZ75125KZT2069101100;2016-11-20;1746;1746;1746;null;null;KZT;16;16;1762;1762;1
0;KZ75125KZT2069101100;2016-11-21;1781;1781;1781;35;35;KZT;null;null;1746;1746;1
0;KZ75125KZT2069101100;2016-11-22;1719;1719;1719;null;null;KZT;62;62;1781;1781;1
0;KZ75125KZT2069101100;2016-11-23;1658;1658;1658;null;null;KZT;61;61;1719;1719;1
0;KZ75125KZT2069101100;2016-11-24;1681;1681;1681;23;23;KZT;null;null;1658;1658;1
0;KZ75125KZT2069101100;2016-11-25;1627;1627;1627;null;null;KZT;54;54;1681;1681;1
0;KZ75125KZT2069101100;2016-11-26;1603;1603;1603;null;null;KZT;24;24;1627;1627;1
0;KZ75125KZT2069101100;2016-11-27;1580;1580;1580;null;null;KZT;23;23;1603;1603;1
0;KZ75125KZT2069101100;2016-11-28;1529;1529;1529;null;null;KZT;51;51;1580;1580;1
0;KZ75125KZT2069101100;2016-11-29;1443;1443;1443;null;null;KZT;86;86;1529;1529;1
0;KZ75125KZT2069101100;2016-11-30;1490;1490;1490;47;47;KZT;null;null;1443;1443;1
0;KZ75125KZT2069101100;2016-12-01;1464;1464;1464;null;null;KZT;26;26;1490;1490;1
0;KZ75125KZT2069101100;2016-12-02;1473;1473;1473;9;9;KZT;null;null;1464;1464;1
0;KZ75125KZT2069101100;2016-12-03;1430;1430;1430;null;null;KZT;43;43;1473;1473;1
0;KZ75125KZT2069101100;2016-12-04;1331;1331;1331;null;null;KZT;99;99;1430;1430;1
0;KZ75125KZT2069101100;2016-12-05;1395;1395;1395;64;64;KZT;null;null;1331;1331;1
0;KZ75125KZT2069101100;2016-12-06;1306;1306;1306;null;null;KZT;89;89;1395;1395;1
0;KZ75125KZT2069101100;2016-12-07;1236;1236;1236;null;null;KZT;70;70;1306;1306;1
0;KZ75125KZT2069101100;2016-12-08;1319;1319;1319;83;83;KZT;null;null;1236;1236;1
0;KZ75125KZT2069101100;2016-12-09;1229;1229;1229;null;null;KZT;90;90;1319;1319;1
0;KZ75125KZT2069101100;2016-12-10;1170;1170;1170;null;null;KZT;59;59;1229;1229;1
0;KZ75125KZT2069101100;2016-12-11;1192;1192;1192;22;22;KZT;null;null;1170;1170;1
0;KZ75125KZT2069101100;2016-12-12;1286;1286;1286;94;94;KZT;null;null;1192;1192;1
0;KZ75125KZT2069101100;2016-12-13;1366;1366;1366;80;80;KZT;null;null;1286;1286;1
0;KZ75125KZT2069101100;2016-12-14;1379;1379;1379;13;13;KZT;null;null;1366;1366;1
0;KZ75125KZT2069101100;2016-12-15;1367;1367;1367;null;null;KZT;12;12;1379;1379;1
0;KZ75125KZT2069101100;2016-12-16;1393;1393;1393;26;26;KZT;null;null;1367;1367;1
0;KZ75125KZT2069101100;2016-12-17;1480;1480;1480;87;87;KZT;null;null;1393;1393;1
0;KZ75125KZT2069101100;2016-12-18;1555;1555;1555;75;75;KZT;null;null;1480;1480;1
0;KZ75125KZT2069101100;2016-12-19;1549;1549;1549;null;null;KZT;6;6;1555;1555;1
0;KZ75125KZT2069101100;2016-12-20;1518;1518;1518;null;null;KZT;31;31;1549;1549;1
0;KZ75125KZT2069101100;2016-12-21;1604;1604;1604;86;86;KZT;null;null;1518;1518;1
0;KZ75125KZT2069101100;2016-12-22;1581;1581;1581;null;null;KZT;23;23;1604;1604;1
0;KZ75125KZT2069101100;2016-12-23;1505;1505;1505;null;null;KZT;76;76;1581;1581;1
0;KZ75125KZT2069101100;2016-12-24;1563;1563;1563;58;58;KZT;null;null;1505;1505;1
0;KZ75125KZT2069101100;2016-12-25;1592;1592;1592;29;29;KZT;null;null;1563;1563;1
0;KZ75125KZT2069101100;2016-12-26;1586;1586;1586;null;null;KZT;6;6;1592;1592;1
0;KZ75125KZT2069101100;2016-12-27;1558;1558;1558;null;null;KZT;28;28;1586;1586;1
0;KZ75125KZT2069101100;2016-12-28;1489;1489;1489;null;null;KZT;69;69;1558;1558;1
0;KZ75125KZT2069101100;2016-12-29;1577;1577;1577;88;88;KZT;null;null;1489;1489;1
0;KZ75125KZT2069101100;2016-12-30;1483;1483;1483;null;null;KZT;94;94;1577;1577;1
0;KZ75125KZT2069101100;2016-12-31;1570;1570;1570;87;87;KZT;null;null;1483;1483;1
0;KZ75125KZT2069101100;2017-01-01;1639;1639;1639;69;69;KZT;null;null;1570;1570;1
0;KZ75125KZT2069101100;2017-01-02;1720;1720;1720;81;81;KZT;null;null;1639;1639;1
0;KZ75125KZT2069101100;2017-01-03;1817;1817;1817;97;97;KZT;null;null;1720;1720;1
0;KZ75125KZT2069101100;2017-01-04;1851;1851;1851;34;34;KZT;null;null;1817;1817;1
0;KZ75125KZT2069101100;2017-01-05;1912;1912;1912;61;61;KZT;null;null;1851;1851;1
0;KZ75125KZT2069101100;2017-01-06;1976;1976;1976;64;64;KZT;null;null;1912;1912;1
0;KZ75125KZT2069101100;2017-01-07;2071;2071;2071;95;95;KZT;null;null;1976;1976;1
0;KZ75125KZT2069101100;2017-01-08;2121;2121;2121;50;50;KZT;null;null;2071;2071;1
0;KZ75125KZT2069101100;2017-01-09;2063;2063;2063;null;null;KZT;58;58;2121;2121;1
0;KZ75125KZT2069101100;2017-01-10;1969;1969;1969;null;null;KZT;94;94;2063;2063;1
0;KZ75125KZT2069101100;2017-01-11;1988;1988;1988;19;19;KZT;null;null;1969;1969;1
0;KZ75125KZT2069101100;2017-01-12;1896;1896;1896;null;null;KZT;92;92;1988;1988;1
0;KZ75125KZT2069101100;2017-01-13;1924;1924;1924;28;28;KZT;null;null;1896;1896;1
0;KZ75125KZT2069101100;2017-01-14;1971;1971;1971;47;47;KZT;null;null;1924;1924;1
0;KZ75125KZT2069101100;2017-01-15;1987;1987;1987;16;16;KZT;null;null;1971;1971;1
0;KZ75125KZT2069101100;2017-01-16;1932;1932;1932;null;null;KZT;55;55;1987;1987;1
0;KZ75125KZT2069101100;2017-01-17;2003;2003;2003;71;71;KZT;null;null;1932;1932;1
0;KZ75125KZT2069101100;2017-01-18;1904;1904;1904;null;null;KZT;99;99;2003;2003;1
0;KZ75125KZT2069101100;2017-01-19;1956;1956;1956;52;52;KZT;null;null;1904;1904;1
0;KZ75125KZT2069101100;2017-01-20;1963;1963;1963;7;7;KZT;null;null;1956;1956;1
0;KZ75125KZT2069101100;2017-01-21;1957;1957;1957;null;null;KZT;6;6;1963;1963;1
0;KZ75125KZT2069101100;2017-01-22;2004;2004;2004;47;47;KZT;null;null;1957;1957;1
0;KZ75125KZT2069101100;2017-01-23;1939;1939;1939;null;null;KZT;65;65;2004;2004;1
0;KZ75125KZT2069101100;2017-01-24;1920;1920;1920;null;null;KZT;19;19;1939;1939;1
0;KZ75125KZT2069101100;2017-01-25;1950;1950;1950;30;30;KZT;null;null;1920;1920;1
0;KZ75125KZT2069101100;2017-01-26;1986;1986;1986;36;36;KZT;null;null;1950;1950;1
0;KZ75125KZT2069101100;2017-01-27;1960;1960;1960;null;null;KZT;26;26;1986;1986;1
0;KZ75125KZT2069101100;2017-01-28;1888;1888;1888;null;null;KZT;72;72;1960;1960;1
0;KZ75125KZT2069101100;2017-01-29;1850;1850;1850;null;null;KZT;38;38;1888;1888;1
0;KZ75125KZT2069101100;2017-01-30;1901;1901;1901;51;51;KZT;null;null;1850;1850;1
0;KZ75125KZT2069101100;2017-01-31;1950;1950;1950;49;49;KZT;null;null;1901;1901;1
0;KZ75125KZT2069101100;2017-02-01;1885;1885;1885;null;null;KZT;65;65;1950;1950;1
0;KZ75125KZT2069101100;2017-02-02;1809;1809;1809;null;null;KZT;76;76;1885;1885;1
0;KZ75125KZT2069101100;2017-02-03;1899;1899;1899;90;90;KZT;null;null;1809;1809;1
0;KZ75125KZT2069101100;2017-02-04;1982;1982;1982;83;83;KZT;null;null;1899;1899;1
0;KZ75125KZT2069101100;2017-02-05;2073;2073;2073;91;91;KZT;null;null;1982;1982;1
0;KZ75125KZT2069101100;2017-02-06;2123;2123;2123;50;50;KZT;null;null;2073;2073;1
0;KZ75125KZT2069101100;2017-02-07;2108;2108;2108;null;null;KZT;15;15;2123;2123;1
0;KZ75125KZT2069101100;2017-02-08;2199;2199;2199;91;91;KZT;null;null;2108;2108;1
0;KZ75125KZT2069101100;2017-02-09;2256;2256;2256;57;57;KZT;null;null;2199;2199;1
0;KZ75125KZT2069101100;2017-02-10;2300;2300;2300;44;44;KZT;null;null;2256;2256;1
0;KZ75125KZT2069101100;2017-02-11;2366;2366;2366;66;66;KZT;null;null;2300;2300;1
0;KZ75125KZT2069101100;2017-02-12;2283;2283;2283;null;null;KZT;83;83;2366;2366;1
0;KZ75125KZT2069101100;2017-02-13;2231;2231;2231;null;null;KZT;52;52;2283;2283;1
0;KZ75125KZT2069101100;2017-02-14;2225;2225;2225;null;null;KZT;6;6;2231;2231;1
0;KZ75125KZT2069101100;2017-02-15;2191;2191;2191;null;null;KZT;34;34;2225;2225;1
0;KZ75125KZT2069101100;2017-02-16;2167;2167;2167;null;null;KZT;24;24;2191;2191;1
0;KZ75125KZT2069101100;2017-02-17;2074;2074;2074;null;null;KZT;93;93;2167;2167;1
0;KZ75125KZT2069101100;2017-02-18;2151;2151;2151;77;77;KZT;null;null;2074;2074;1
0;KZ75125KZT2069101100;2017-02-19;2229;2229;2229;78;78;KZT;null;null;2151;2151;1
0;KZ75125KZT2069101100;2017-02-20;2167;2167;2167;null;null;KZT;62;62;2229;2229;1
0;KZ75125KZT2069101100;2017-02-21;2085;2085;2085;null;null;KZT;82;82;2167;2167;1
0;KZ75125KZT2069101100;2017-02-22;2157;2157;2157;72;72;KZT;null;null;2085;2085;1
0;KZ75125KZT2069101100;2017-02-23;2199;2199;2199;42;42;KZT;null;null;2157;2157;1
0;KZ75125KZT2069101100;2017-02-24;2140;2140;2140;null;null;KZT;59;59;2199;2199;1
0;KZ75125KZT2069101100;2017-02-25;2179;2179;2179;39;39;KZT;null;null;2140;2140;1
0;KZ75125KZT2069101100;2017-02-26;2143;2143;2143;null;null;KZT;36;36;2179;2179;1
0;KZ75125KZT2069101100;2017-02-27;2150;2150;2150;7;7;KZT;null;null;2143;2143;1
0;KZ75125KZT2069101100;2017-02-28;2158;2158;2158;8;8;KZT;null;null;2150;2150;1
0;KZ75125KZT2069101100;2017-03-01;2146;2146;2146;null;null;KZT;12;12;2158;2158;1
0;KZ75125KZT2069101100;2017-03-02;2244;2244;2244;98;98;KZT;null;null;2146;2146;1
0;KZ75125KZT2069101100;2017-03-03;2294;2294;2294;50;50;KZT;null;null;2244;2244;1
0;KZ75125KZT2069101100;2017-03-04;2380;2380;2380;86;86;KZT;null;null;2294;2294;1
0;KZ75125KZT2069101100;2017-03-05;2357;2357;2357;null;null;KZT;23;23;2380;2380;1
0;KZ75125KZT2069101100;2017-03-06;2329;2329;2329;null;null;KZT;28;28;2357;2357;1
0;KZ75125KZT2069101100;2017-03-07;2402;2402;2402;73;73;KZT;null;null;2329;2329;1
0;KZ75125KZT2069101100;2017-03-08;2422;2422;2422;20;20;KZT;null;null;2402;2402;1
0;KZ75125KZT2069101100;2017-03-09;2473;2473;2473;51;51;KZT;null;null;2422;2422;1
0;KZ75125KZT2069101100;2017-03-10;2401;2401;2401;null;null;KZT;72;72;2473;2473;1
0;KZ75125KZT2069101100;2017-03-11;2465;2465;2465;64;64;KZT;null;null;2401;2401;1
0;KZ75125KZT2069101100;2017-03-12;2492;2492;2492;27;27;KZT;null;null;2465;2465;1
0;KZ75125KZT2069101100;2017-03-13;2561;2561;2561;69;69;KZT;null;null;2492;2492;1
0;KZ75125KZT2069101100;2017-03-14;2544;2544;2544;null;null;KZT;17;17;2561;2561;1
0;KZ75125KZT2069101100;2017-03-15;2499;2499;2499;null;null;KZT;45;45;2544;2544;1
0;KZ75125KZT2069101100;2017-03-16;2472;2472;2472;null;null;KZT;27;27;2499;2499;1
0;KZ75125KZT2069101100;2017-03-17;2458;2458;2458;null;null;KZT;14;14;2472;2472;1
0;KZ75125KZT2069101100;2017-03-18;2485;2485;2485;27;27;KZT;null;null;2458;2458;1
0;KZ75125KZT2069101100;2017-03-19;2478;2478;2478;null;null;KZT;7;7;2485;2485;1
0;KZ75125KZT2069101100;2017-03-20;2544;2544;2544;66;66;KZT;null;null;2478;2478;1
0;KZ75125KZT2069101100;2017-03-21;2531;2531;2531;null;null;KZT;13;13;2544;2544;1
0;KZ75125KZT2069101100;2017-03-22;2572;2572;2572;41;41;KZT;null;null;2531;2531;1
0;KZ75125KZT2069101100;2017-03-23;2473;2473;2473;null;null;KZT;99;99;2572;2572;1
0;KZ75125KZT2069101100;2017-03-24;2475;2475;2475;2;2;KZT;null;null;2473;2473;1
0;KZ75125KZT2069101100;2017-03-25;2549;2549;2549;74;74;KZT;null;null;2475;2475;1
0;KZ75125KZT2069101100;2017-03-26;2640;2640;2640;91;91;KZT;null;null;2549;2549;1
0;KZ75125KZT2069101100;2017-03-27;2731;2731;2731;91;91;KZT;null;null;2640;2640;1
0;KZ75125KZT2069101100;2017-03-28;2664;2664;2664;null;null;KZT;67;67;2731;2731;1
0;KZ75125KZT2069101100;2017-03-29;2614;2614;2614;null;null;KZT;50;50;2664;2664;1
0;KZ75125KZT2069101100;2017-03-30;2701;2701;2701;87;87;KZT;null;null;2614;2614;1
0;KZ75125KZT2069101100;2017-03-31;2662;2662;2662;null;null;KZT;39;39;2701;2701;1
0;KZ75125KZT2069101100;2017-04-01;2612;2612;2612;null;null;KZT;50;50;2662;2662;1
0;KZ75125KZT2069101100;2017-04-02;2674;2674;2674;62;62;KZT;null;null;2612;2612;1
0;KZ75125KZT2069101100;2017-04-03;2591;2591;2591;null;null;KZT;83;83;2674;2674;1
0;KZ75125KZT2069101100;2017-04-04;2628;2628;2628;37;37;KZT;null;null;2591;2591;1
0;KZ75125KZT2069101100;2017-04-05;2595;2595;2595;null;null;KZT;33;33;2628;2628;1
0;KZ75125KZT2069101100;2017-04-06;2524;2524;2524;null;null;KZT;71;71;2595;2595;1
0;KZ75125KZT2069101100;2017-04-07;2521;2521;2521;null;null;KZT;3;3;2524;2524;1
0;KZ75125KZT2069101100;2017-04-08;2588;2588;2588;67;67;KZT;null;null;2521;2521;1
0;KZ75125KZT2069101100;2017-04-09;2636;2636;2636;48;48;KZT;null;null;2588;2588;1
0;KZ75125KZT2069101100;2017-04-10;2590;2590;2590;null;null;KZT;46;46;2636;2636;1
0;KZ75125KZT2069101100;2017-04-11;2612;2612;2612;22;22;KZT;null;null;2590;2590;1
0;KZ75125KZT2069101100;2017-04-12;2650;2650;2650;38;38;KZT;null;null;2612;2612;1
0;KZ75125KZT2069101100;2017-04-13;2745;2745;2745;95;95;KZT;null;null;2650;2650;1
0;KZ75125KZT2069101100;2017-04-14;2783;2783;2783;38;38;KZT;null;null;2745;2745;1
0;KZ75125KZT2069101100;2017-04-15;2747;2747;2747;null;null;KZT;36;36;2783;2783;1
0;KZ75125KZT2069101100;2017-04-16;2758;2758;2758;11;11;KZT;null;null;2747;2747;1
0;KZ75125KZT2069101100;2017-04-17;2796;2796;2796;38;38;KZT;null;null;2758;2758;1
0;KZ75125KZT2069101100;2017-04-18;2723;2723;2723;null;null;KZT;73;73;2796;2796;1
0;KZ75125KZT2069101100;2017-04-19;2676;2676;2676;null;null;KZT;47;47;2723;2723;1
0;KZ75125KZT2069101100;2017-04-20;2604;2604;2604;null;null;KZT;72;72;2676;2676;1
0;KZ75125KZT2069101100;2017-04-21;2603;2603;2603;null;null;KZT;1;1;2604;2604;1
0;KZ75125KZT2069101100;2017-04-22;2638;2638;2638;35;35;KZT;null;null;2603;2603;1
0;KZ75125KZT2069101100;2017-04-23;2703;2703;2703;65;65;KZT;null;null;2638;2638;1
0;KZ75125KZT2069101100;2017-04-24;2654;2654;2654;null;null;KZT;49;49;2703;2703;1
0;KZ75125KZT2069101100;2017-04-25;2644;2644;2644;null;null;KZT;10;10;2654;2654;1
0;KZ75125KZT2069101100;2017-04-26;2645;2645;2645;1;1;KZT;null;null;2644;2644;1
0;KZ75125KZT2069101100;2017-04-27;2671;2671;2671;26;26;KZT;null;null;2645;2645;1
0;KZ75125KZT2069101100;2017-04-28;2686;2686;2686;15;15;KZT;null;null;2671;2671;1
0;KZ75125KZT2069101100;2017-04-29;2777;2777;2777;91;91;KZT;null;null;2686;2686;1
0;KZ75125KZT2069101100;2017-04-30;2841;2841;2841;64;64;KZT;null;null;2777;2777;1
0;KZ75125KZT2069101100;2017-05-01;2751;2751;2751;null;null;KZT;90;90;2841;2841;1
0;KZ75125KZT2069101100;2017-05-02;2716;2716;2716;null;null;KZT;35;35;2751;2751;1
0;KZ75125KZT2069101100;2017-05-03;2736;2736;2736;20;20;KZT;null;null;2716;2716;1
0;KZ75125KZT2069101100;2017-05-04;2651;2651;2651;null;null;KZT;85;85;2736;2736;1
0;KZ75125KZT2069101100;2017-05-05;2627;2627;2627;null;null;KZT;24;24;2651;2651;1
0;KZ75125KZT2069101100;2017-05-06;2570;2570;2570;null;null;KZT;57;57;2627;2627;1
0;KZ75125KZT2069101100;2017-05-07;2600;2600;2600;30;30;KZT;null;null;2570;2570;1
0;KZ75125KZT2069101100;2017-05-08;2644;2644;2644;44;44;KZT;null;null;2600;2600;1
0;KZ75125KZT2069101100;2017-05-09;2568;2568;2568;null;null;KZT;76;76;2644;2644;1
0;KZ75125KZT2069101100;2017-05-10;2589;2589;2589;21;21;KZT;null;null;2568;2568;1
0;KZ75125KZT2069101100;2017-05-11;2515;2515;2515;null;null;KZT;74;74;2589;2589;1
0;KZ75125KZT2069101100;2017-05-12;2448;2448;2448;null;null;KZT;67;67;2515;2515;1
0;KZ75125KZT2069101100;2017-05-13;2383;2383;2383;null;null;KZT;65;65;2448;2448;1
0;KZ75125KZT2069101100;2017-05-14;2396;2396;2396;13;13;KZT;null;null;2383;2383;1
0;KZ75125KZT2069101100;2017-05-15;2469;2469;2469;73;73;KZT;null;null;2396;2396;1
0;KZ75125KZT2069101100;2017-05-16;2426;2426;2426;null;null;KZT;43;43;2469;2469;1
0;KZ75125KZT2069101100;2017-05-17;2517;2517;2517;91;91;KZT;null;null;2426;2426;1
0;KZ75125KZT2069101100;2017-05-18;2485;2485;2485;null;null;KZT;32;32;2517;2517;1
0;KZ75125KZT2069101100;2017-05-19;2454;2454;2454;null;null;KZT;31;31;2485;2485;1
0;KZ75125KZT2069101100;2017-05-20;2437;2437;2437;null;null;KZT;17;17;2454;2454;1
0;KZ75125KZT2069101100;2017-05-21;2374;2374;2374;null;null;KZT;63;63;2437;2437;1
0;KZ75125KZT2069101100;2017-05-22;2322;2322;2322;null;null;KZT;52;52;2374;2374;1
0;KZ75125KZT2069101100;2017-05-23;2416;2416;2416;94;94;KZT;null;null;2322;2322;1
0;KZ75125KZT2069101100;2017-05-24;2333;2333;2333;null;null;KZT;83;83;2416;2416;1
0;KZ75125KZT2069101100;2017-05-25;2321;2321;2321;null;null;KZT;12;12;2333;2333;1
0;KZ75125KZT2069101100;2017-05-26;2311;2311;2311;null;null;KZT;10;10;2321;2321;1
0;KZ75125KZT2069101100;2017-05-27;2280;2280;2280;null;null;KZT;31;31;2311;2311;1
0;KZ75125KZT2069101100;2017-05-28;2186;2186;2186;null;null;KZT;94;94;2280;2280;1
0;KZ75125KZT2069101100;2017-05-29;2249;2249;2249;63;63;KZT;null;null;2186;2186;1
0;KZ75125KZT2069101100;2017-05-30;2285;2285;2285;36;36;KZT;null;null;2249;2249;1
0;KZ75125KZT2069101100;2017-05-31;2363;2363;2363;78;78;KZT;null;null;2285;2285;1
0;KZ75125KZT2069101100;2017-06-01;2350;2350;2350;null;null;KZT;13;13;2363;2363;1
0;KZ75125KZT2069101100;2017-06-02;2360;2360;2360;10;10;KZT;null;null;2350;2350;1
0;KZ75125KZT2069101100;2017-06-03;2428;2428;2428;68;68;KZT;null;null;2360;2360;1
0;KZ75125KZT2069101100;2017-06-04;2469;2469;2469;41;41;KZT;null;null;2428;2428;1
0;KZ75125KZT2069101100;2017-06-05;2399;2399;2399;null;null;KZT;70;70;2469;2469;1
0;KZ75125KZT2069101100;2017-06-06;2302;2302;2302;null;null;KZT;97;97;2399;2399;1
0;KZ75125KZT2069101100;2017-06-07;2240;2240;2240;null;null;KZT;62;62;2302;2302;1
0;KZ75125KZT2069101100;2017-06-08;2250;2250;2250;10;10;KZT;null;null;2240;2240;1
0;KZ75125KZT2069101100;2017-06-09;2178;2178;2178;null;null;KZT;72;72;2250;2250;1
0;KZ75125KZT2069101100;2017-06-10;2161;2161;2161;null;null;KZT;17;17;2178;2178;1
0;KZ75125KZT2069101100;2017-06-11;2148;2148;2148;null;null;KZT;13;13;2161;2161;1
0;KZ75125KZT2069101100;2017-06-12;2159;2159;2159;11;11;KZT;null;null;2148;2148;1

